eventID,numPhotons,numReachedDown,numReachedUp,numPE,
1,1774,133,89,222,
2,5800,420,339,759,
4,5915,406,342,748,
5,5706,415,357,772,
7,5855,426,322,748,
8,1563,101,80,181,
10,5920,380,371,751,
11,543,31,40,71,
12,5851,420,308,728,
13,5846,436,339,775,
15,1458,117,80,197,
16,588,36,39,75,
17,5688,426,313,739,
18,5793,390,324,714,
20,1854,131,122,253,
21,1729,122,94,216,
25,5970,453,311,764,
26,5725,400,351,751,
27,5741,401,318,719,
28,5693,419,310,729,
29,5688,418,328,746,
30,3944,277,219,496,
34,250,19,18,37,
35,394,22,18,40,
36,5769,368,343,711,
39,2856,199,156,355,
40,2259,159,122,281,
41,2181,190,126,316,
43,5708,415,310,725,
44,5779,407,337,744,
46,859,61,44,105,
50,5910,441,311,752,
51,239,11,13,24,
52,5919,416,327,743,
53,1786,127,101,228,
54,4219,286,248,534,
55,1483,106,73,179,
56,5952,457,323,780,
57,5789,470,353,823,
58,5892,443,343,786,
59,5710,438,325,763,
60,5988,384,341,725,
61,5975,437,361,798,
62,5907,431,348,779,
63,5884,407,332,739,
64,5801,409,385,794,
66,694,56,47,103,
67,1144,92,55,147,
68,4087,281,220,501,
69,5842,471,315,786,
71,687,52,40,92,
72,5769,437,304,741,
73,5813,395,326,721,
74,365,24,22,46,
76,71,4,4,8,
77,5794,386,320,706,
79,5678,455,323,778,
80,261,19,18,37,
82,5785,439,336,775,
84,5812,448,314,762,
85,5712,448,333,781,
86,1601,117,94,211,
87,285,16,17,33,
88,1170,85,79,164,
90,5783,421,300,721,
91,5796,448,297,745,
92,1975,127,125,252,
94,5860,429,281,710,
96,948,63,52,115,
98,3572,239,181,420,
99,5749,385,349,734,
101,569,35,36,71,
102,185,19,13,32,
104,5840,452,305,757,
106,5816,403,322,725,
107,5836,420,364,784,
108,771,51,49,100,
110,1621,143,92,235,
111,5811,450,319,769,
112,5853,416,315,731,
113,921,68,46,114,
116,5943,436,353,789,
117,1471,109,88,197,
119,5879,429,379,808,
120,740,55,39,94,
122,1181,80,71,151,
123,5826,428,327,755,
124,5855,419,308,727,
126,2050,158,117,275,
127,282,20,17,37,
129,2606,195,145,340,
130,5862,387,351,738,
131,448,28,23,51,
134,5841,412,345,757,
135,269,17,16,33,
137,5807,404,325,729,
140,316,25,14,39,
141,5802,420,343,763,
143,5755,442,318,760,
144,5926,455,332,787,
145,1262,95,62,157,
146,5745,430,307,737,
147,284,18,10,28,
148,5835,401,318,719,
149,5898,415,341,756,
150,1063,66,45,111,
151,769,46,40,86,
153,5086,360,270,630,
154,5906,390,352,742,
156,5775,435,281,716,
157,5829,399,316,715,
159,315,21,13,34,
160,119,8,12,20,
162,631,54,39,93,
165,3289,247,164,411,
167,617,44,31,75,
168,5956,451,335,786,
169,1222,81,67,148,
170,5951,420,336,756,
174,5597,354,357,711,
178,2101,138,126,264,
179,5673,392,340,732,
180,5678,403,293,696,
182,383,33,19,52,
183,5883,428,306,734,
185,2211,181,108,289,
188,5835,436,329,765,
189,5690,457,328,785,
191,5770,403,335,738,
192,2086,148,114,262,
195,5677,397,321,718,
196,1329,92,64,156,
197,5880,393,346,739,
199,5659,422,311,733,
201,5652,448,280,728,
202,1306,113,73,186,
204,1282,92,71,163,
208,31,3,2,5,
209,5992,413,341,754,
213,5986,441,332,773,
214,5946,442,356,798,
215,5825,424,352,776,
217,5897,442,314,756,
218,4998,335,261,596,
219,5842,446,334,780,
220,4363,332,211,543,
221,2357,174,134,308,
224,2141,158,117,275,
228,426,27,22,49,
229,5641,437,314,751,
230,4586,351,275,626,
232,5882,385,343,728,
233,3881,261,233,494,
234,5864,401,346,747,
239,293,23,11,34,
240,99,1,7,8,
242,5688,386,319,705,
245,5793,463,298,761,
246,5831,451,345,796,
248,470,26,23,49,
249,92,4,4,8,
251,5789,425,312,737,
252,103,6,6,12,
253,5806,439,335,774,
255,183,12,17,29,
256,5786,403,328,731,
257,5955,438,326,764,
258,5670,443,324,767,
259,5879,433,354,787,
261,1180,83,77,160,
262,5845,411,340,751,
263,5966,435,366,801,
264,4082,305,212,517,
266,682,58,36,94,
267,98,8,8,16,
268,3940,329,216,545,
270,1143,67,70,137,
271,5877,447,318,765,
272,5958,437,343,780,
273,5700,430,347,777,
274,5820,437,304,741,
275,1906,142,101,243,
278,631,59,40,99,
279,5965,463,314,777,
281,1658,102,105,207,
283,455,35,34,69,
285,936,72,42,114,
290,5868,411,383,794,
291,5760,475,317,792,
292,5987,432,353,785,
293,161,9,11,20,
294,5972,420,314,734,
295,849,61,46,107,
296,5893,420,345,765,
298,245,20,26,46,
299,334,17,29,46,
300,5933,452,356,808,
301,5685,391,340,731,
302,5961,387,335,722,
303,53,3,3,6,
305,5750,441,314,755,
306,4202,284,266,550,
307,5879,393,365,758,
308,4199,287,281,568,
309,586,38,40,78,
310,1643,120,66,186,
312,5879,428,333,761,
313,5721,350,379,729,
314,5845,457,335,792,
316,5768,402,367,769,
317,1204,97,61,158,
318,5779,377,352,729,
320,5774,394,338,732,
321,5671,441,303,744,
323,5848,360,323,683,
324,1734,131,108,239,
325,465,29,18,47,
326,3083,218,195,413,
327,5842,402,348,750,
329,1174,81,62,143,
330,5695,381,364,745,
331,4161,245,253,498,
332,970,62,52,114,
333,5703,400,372,772,
336,2082,166,117,283,
337,5810,421,343,764,
338,5871,416,358,774,
339,5581,397,341,738,
340,1039,69,64,133,
341,1295,97,76,173,
342,1682,106,111,217,
344,6026,483,357,840,
345,5988,390,366,756,
347,5910,425,314,739,
349,848,82,58,140,
351,5709,391,334,725,
352,5747,393,331,724,
355,5929,414,320,734,
356,6024,421,343,764,
357,344,33,12,45,
358,495,39,32,71,
360,1371,100,72,172,
361,727,66,43,109,
362,4073,317,230,547,
363,5766,404,295,699,
364,1715,101,99,200,
365,5805,422,346,768,
366,479,29,29,58,
367,498,35,21,56,
368,5839,408,317,725,
370,5816,447,320,767,
371,426,34,18,52,
373,5740,407,348,755,
374,5710,417,338,755,
375,5949,421,330,751,
377,5734,392,328,720,
378,92,5,9,14,
379,575,47,27,74,
382,5697,409,322,731,
383,87,8,5,13,
385,5922,386,308,694,
386,700,58,31,89,
387,1162,85,72,157,
389,1788,123,101,224,
391,2438,173,134,307,
392,5741,408,337,745,
393,385,30,28,58,
395,1542,106,74,180,
396,5702,416,301,717,
397,5783,390,302,692,
398,5769,430,318,748,
399,401,35,22,57,
400,5870,413,366,779,
401,1640,132,80,212,
402,5895,405,317,722,
403,366,20,25,45,
404,5856,427,372,799,
405,5924,431,342,773,
406,5694,419,326,745,
407,865,55,48,103,
408,5835,487,309,796,
409,1043,71,63,134,
411,100,5,7,12,
412,5818,457,309,766,
414,2282,158,136,294,
415,6087,448,364,812,
418,6038,425,336,761,
419,6011,444,346,790,
421,5839,458,315,773,
422,47,6,4,10,
423,5913,426,346,772,
424,925,71,48,119,
425,5890,436,353,789,
426,5793,469,304,773,
427,65,7,5,12,
428,4135,288,201,489,
434,5705,403,303,706,
436,5868,418,332,750,
437,1925,143,92,235,
439,5772,376,317,693,
441,5693,444,337,781,
442,2010,120,113,233,
443,5782,439,334,773,
444,1701,119,97,216,
445,194,14,10,24,
446,86,9,5,14,
447,410,25,27,52,
451,5839,441,331,772,
452,5804,472,312,784,
454,983,75,69,144,
455,5754,438,334,772,
456,320,24,25,49,
458,5820,409,375,784,
460,1837,132,87,219,
461,473,46,20,66,
462,5889,444,355,799,
464,5711,423,317,740,
465,5922,440,302,742,
466,5916,419,324,743,
467,5909,409,346,755,
468,5979,466,332,798,
469,5770,406,348,754,
470,202,18,9,27,
471,217,14,22,36,
472,553,42,30,72,
475,2379,179,127,306,
479,5844,437,321,758,
480,5520,407,321,728,
481,5872,403,361,764,
482,5925,429,369,798,
483,5829,429,303,732,
484,1090,90,75,165,
485,5811,451,329,780,
488,5829,400,312,712,
490,5916,447,331,778,
491,5802,433,370,803,
493,808,57,47,104,
494,1444,101,94,195,
495,1045,81,53,134,
496,1021,73,54,127,
497,5896,441,309,750,
500,6002,447,332,779,
501,5725,479,323,802,
502,566,43,40,83,
504,5903,429,331,760,
505,5847,397,328,725,
506,412,27,22,49,
508,5887,460,322,782,
509,5854,403,339,742,
511,4518,336,289,625,
512,5877,442,365,807,
513,5905,476,325,801,
517,734,50,33,83,
518,5760,434,331,765,
519,5751,412,301,713,
520,5755,399,342,741,
522,15,1,1,2,
523,170,10,8,18,
527,5998,421,322,743,
528,2160,124,126,250,
529,799,48,38,86,
531,5625,444,299,743,
532,5956,432,338,770,
535,5918,458,359,817,
536,92,11,2,13,
537,5825,405,300,705,
539,5846,434,366,800,
540,5728,390,336,726,
541,5888,469,310,779,
542,5856,451,326,777,
544,246,21,11,32,
545,33,1,1,2,
547,5887,439,302,741,
548,1354,106,73,179,
550,5863,440,362,802,
552,5965,457,331,788,
553,5823,415,311,726,
554,771,50,48,98,
555,5746,428,350,778,
556,5862,448,357,805,
557,1641,111,112,223,
559,5962,421,337,758,
560,5892,435,343,778,
561,5778,404,343,747,
565,5720,448,292,740,
569,5797,416,330,746,
571,873,41,66,107,
572,3632,264,208,472,
573,3600,298,185,483,
574,1645,118,98,216,
575,5765,395,352,747,
577,209,9,10,19,
578,1392,99,70,169,
579,4479,315,272,587,
580,5647,439,309,748,
581,16,2,2,4,
582,5794,451,356,807,
583,5734,434,310,744,
584,5779,428,327,755,
586,438,30,22,52,
588,179,12,9,21,
591,5692,415,300,715,
592,484,30,30,60,
595,455,33,27,60,
596,5617,443,319,762,
597,696,53,47,100,
598,1089,68,56,124,
599,5719,433,334,767,
600,5725,460,346,806,
602,5663,422,312,734,
603,5801,402,347,749,
604,5725,406,306,712,
605,2032,147,119,266,
607,517,37,30,67,
608,5819,422,339,761,
609,5886,407,341,748,
612,1728,101,94,195,
613,5886,401,300,701,
614,1423,90,85,175,
615,5661,412,319,731,
617,5885,476,328,804,
618,304,16,22,38,
619,1292,92,55,147,
620,4281,318,231,549,
621,5827,380,330,710,
622,5769,438,341,779,
624,748,43,53,96,
626,5766,434,364,798,
627,1162,81,55,136,
628,6013,454,340,794,
630,5915,428,346,774,
631,336,27,20,47,
634,5949,441,326,767,
635,5730,439,303,742,
637,246,14,20,34,
638,1079,75,54,129,
639,5951,418,306,724,
641,5812,421,363,784,
643,5824,413,288,701,
650,5793,407,304,711,
651,951,51,53,104,
652,5625,386,325,711,
653,360,20,25,45,
654,5943,408,346,754,
655,5816,428,314,742,
656,5853,436,323,759,
657,5707,439,323,762,
659,1514,109,83,192,
660,5891,406,340,746,
661,641,60,41,101,
662,233,11,12,23,
663,6056,419,370,789,
664,1223,84,61,145,
665,936,70,58,128,
667,1864,141,93,234,
668,5834,416,345,761,
669,5733,439,290,729,
671,1259,89,77,166,
674,5907,432,366,798,
676,159,14,10,24,
677,135,6,8,14,
678,5959,436,338,774,
679,2088,161,105,266,
680,2415,168,143,311,
682,873,63,54,117,
687,5674,406,320,726,
690,5667,414,344,758,
691,5609,367,306,673,
692,5843,431,353,784,
694,1987,144,119,263,
695,5982,396,370,766,
696,70,2,5,7,
698,1505,119,89,208,
699,270,19,12,31,
700,648,56,32,88,
701,155,8,4,12,
702,5878,454,312,766,
706,396,29,17,46,
707,40,1,3,4,
708,5828,425,328,753,
712,1748,133,108,241,
715,5882,426,333,759,
717,447,34,34,68,
718,168,11,9,20,
721,5856,420,343,763,
722,3665,260,220,480,
725,5797,441,272,713,
726,5805,420,355,775,
727,5787,415,322,737,
728,5880,383,351,734,
729,226,15,11,26,
730,5913,451,341,792,
731,5584,392,317,709,
732,5808,404,359,763,
733,798,66,50,116,
734,307,19,19,38,
735,5899,413,333,746,
736,432,39,24,63,
737,5799,399,364,763,
738,5860,442,321,763,
740,717,45,46,91,
741,5874,387,314,701,
742,5933,433,313,746,
745,5775,434,302,736,
746,5839,374,344,718,
747,4923,358,273,631,
748,5858,441,345,786,
750,5940,419,379,798,
752,185,15,10,25,
753,5732,391,325,716,
754,5612,412,343,755,
755,6024,442,389,831,
756,5784,424,318,742,
757,1186,87,63,150,
758,5605,442,307,749,
759,1304,95,87,182,
760,5809,423,307,730,
762,5805,398,349,747,
764,45,3,1,4,
765,5636,414,326,740,
766,5882,415,342,757,
767,5858,433,324,757,
768,5977,407,347,754,
769,5824,399,354,753,
772,430,26,23,49,
774,3687,289,199,488,
775,2607,158,173,331,
776,1443,104,94,198,
777,422,35,30,65,
781,5812,429,329,758,
785,5753,384,312,696,
786,5866,458,309,767,
787,316,23,18,41,
789,12,1,2,3,
791,5773,400,336,736,
792,5800,390,313,703,
794,5853,389,342,731,
795,5765,417,316,733,
796,5901,434,317,751,
797,5875,401,331,732,
798,4273,356,233,589,
799,5992,485,336,821,
800,5847,413,313,726,
801,5881,442,336,778,
802,6025,444,362,806,
804,2148,165,114,279,
805,5753,435,275,710,
807,5740,353,329,682,
808,1173,75,82,157,
809,5805,424,325,749,
812,629,59,45,104,
813,5829,451,300,751,
816,5759,444,334,778,
821,5989,409,336,745,
822,2328,149,132,281,
823,5869,441,332,773,
824,3936,292,231,523,
826,5915,396,362,758,
827,5706,418,350,768,
831,5784,426,341,767,
832,34,5,2,7,
834,1049,71,77,148,
835,5888,419,317,736,
837,5830,398,332,730,
839,5918,398,341,739,
840,5857,417,325,742,
843,4174,284,282,566,
845,5839,417,319,736,
847,291,24,12,36,
848,846,63,51,114,
850,5999,419,316,735,
852,5794,417,359,776,
853,1284,106,85,191,
854,2331,166,140,306,
856,5859,401,363,764,
857,5661,434,309,743,
858,2726,181,187,368,
860,5860,402,335,737,
861,5638,437,317,754,
864,2284,131,132,263,
865,5706,425,340,765,
866,645,41,33,74,
867,1027,67,67,134,
869,160,6,10,16,
870,5737,407,323,730,
871,1757,109,106,215,
872,879,80,45,125,
873,905,60,65,125,
874,1779,143,105,248,
875,595,34,33,67,
877,3020,209,183,392,
880,5762,402,309,711,
882,5930,424,349,773,
883,206,16,12,28,
884,4512,324,273,597,
885,5846,434,310,744,
886,5761,428,295,723,
887,5655,414,327,741,
888,1662,148,82,230,
889,1641,122,104,226,
890,238,17,14,31,
891,3618,260,220,480,
893,5789,447,325,772,
895,5844,444,331,775,
896,5725,367,346,713,
899,5820,415,351,766,
900,5871,438,313,751,
901,5829,438,312,750,
903,5833,437,318,755,
904,5794,384,343,727,
905,797,52,48,100,
906,1699,127,96,223,
908,678,68,33,101,
910,5861,445,335,780,
911,1814,140,104,244,
912,5851,447,349,796,
915,5825,444,328,772,
917,5726,418,324,742,
919,2270,150,130,280,
920,209,12,12,24,
926,5919,449,361,810,
927,5898,435,353,788,
930,5714,415,316,731,
931,1306,100,79,179,
933,875,69,49,118,
934,3843,274,210,484,
935,5795,376,354,730,
938,5761,405,350,755,
939,571,29,33,62,
940,486,26,28,54,
941,5806,457,314,771,
942,1700,147,101,248,
943,1569,109,85,194,
944,5995,436,360,796,
947,5964,415,334,749,
948,5835,446,306,752,
949,78,2,3,5,
951,2114,153,120,273,
952,2013,145,128,273,
953,1309,95,69,164,
955,5942,460,325,785,
958,5713,425,298,723,
960,393,24,19,43,
961,5902,396,323,719,
963,1356,88,73,161,
966,5726,359,320,679,
970,1266,84,78,162,
971,5683,397,340,737,
972,1580,118,88,206,
973,203,21,10,31,
976,697,46,32,78,
977,5780,423,330,753,
978,289,21,16,37,
980,140,14,6,20,
982,5783,428,334,762,
984,5896,414,333,747,
985,5713,426,353,779,
986,593,52,36,88,
988,5789,426,324,750,
989,4930,349,289,638,
990,5864,433,314,747,
992,5705,422,309,731,
993,456,36,30,66,
994,5685,354,358,712,
995,2211,162,131,293,
996,32,2,3,5,
998,527,40,34,74,
999,5904,391,356,747,
1001,108,5,6,11,
1002,5862,421,322,743,
1003,5802,429,338,767,
1005,5721,385,339,724,
1006,141,14,4,18,
1007,2284,172,130,302,
1008,5737,404,375,779,
1009,5857,442,337,779,
1010,5818,379,345,724,
1011,5739,461,331,792,
1012,5757,406,344,750,
1014,940,61,51,112,
1016,5823,427,339,766,
1017,1529,108,84,192,
1021,5651,380,326,706,
1022,1091,80,67,147,
1024,5822,417,345,762,
1026,2365,193,148,341,
1027,366,26,17,43,
1031,147,12,11,23,
1033,1045,71,59,130,
1034,5797,425,320,745,
1035,5770,441,313,754,
1036,5847,444,317,761,
1037,5946,417,348,765,
1038,1477,110,87,197,
1039,5896,432,320,752,
1040,5807,452,308,760,
1041,1683,141,86,227,
1043,838,66,57,123,
1044,5890,415,343,758,
1045,5848,427,326,753,
1046,5818,396,341,737,
1047,5952,432,340,772,
1049,1932,155,89,244,
1050,1415,85,85,170,
1051,132,7,8,15,
1053,5858,420,346,766,
1056,701,53,37,90,
1058,5780,458,337,795,
1059,280,14,17,31,
1061,5823,401,341,742,
1062,99,9,7,16,
1063,1907,128,127,255,
1064,5999,420,337,757,
1068,2180,175,139,314,
1069,750,52,35,87,
1070,258,21,17,38,
1071,5852,422,350,772,
1072,630,42,36,78,
1074,2057,151,115,266,
1075,2569,188,161,349,
1076,1231,60,86,146,
1077,1831,129,103,232,
1078,5887,433,336,769,
1079,767,57,32,89,
1081,1726,140,90,230,
1082,589,44,25,69,
1083,5699,437,308,745,
1084,1214,77,56,133,
1085,5600,420,313,733,
1086,5814,402,312,714,
1087,5793,418,302,720,
1089,5745,437,310,747,
1091,5946,423,316,739,
1094,5679,422,326,748,
1098,5813,399,344,743,
1101,5777,432,330,762,
1105,5724,418,301,719,
1106,464,31,35,66,
1107,1774,135,91,226,
1109,5825,357,348,705,
1111,1757,126,88,214,
1112,5927,434,343,777,
1113,5607,407,328,735,
1114,4625,342,305,647,
1115,5828,404,350,754,
1116,259,24,15,39,
1118,1449,103,85,188,
1122,5740,406,348,754,
1123,2031,154,109,263,
1125,5767,401,317,718,
1126,5870,438,339,777,
1127,5868,443,358,801,
1130,773,62,50,112,
1131,5796,393,348,741,
1132,5704,448,297,745,
1135,5907,423,324,747,
1136,1604,122,85,207,
1138,4049,277,244,521,
1139,5729,382,364,746,
1141,1327,88,77,165,
1142,1584,102,81,183,
1144,5947,420,322,742,
1145,580,45,40,85,
1146,5708,433,327,760,
1147,599,44,29,73,
1148,5772,421,331,752,
1150,5864,413,351,764,
1152,5730,412,347,759,
1153,253,15,15,30,
1155,5772,386,348,734,
1156,5929,414,335,749,
1157,5876,433,316,749,
1159,401,30,29,59,
1160,5880,425,370,795,
1161,5750,424,321,745,
1162,5849,433,374,807,
1163,5716,388,338,726,
1165,5844,384,342,726,
1166,5770,425,356,781,
1167,5883,404,350,754,
1169,5813,441,307,748,
1170,5726,444,366,810,
1172,5860,417,294,711,
1173,609,45,31,76,
1174,1298,95,72,167,
1175,5719,424,349,773,
1176,5901,438,327,765,
1177,5782,396,331,727,
1178,5848,423,320,743,
1179,5871,431,336,767,
1184,5807,384,355,739,
1185,1006,56,71,127,
1186,213,15,17,32,
1187,6021,442,336,778,
1188,5902,416,368,784,
1189,5736,453,309,762,
1190,5794,438,323,761,
1192,5835,424,380,804,
1193,5741,431,319,750,
1194,341,32,19,51,
1195,5823,444,361,805,
1196,5709,402,350,752,
1197,5946,414,294,708,
1198,759,64,42,106,
1199,585,44,31,75,
1201,5887,440,325,765,
1203,910,71,51,122,
1204,314,21,22,43,
1206,5649,400,327,727,
1207,5829,392,344,736,
1209,1104,86,59,145,
1213,5825,438,363,801,
1214,1020,92,58,150,
1215,2627,195,125,320,
1216,5733,423,334,757,
1217,435,35,33,68,
1218,5723,415,315,730,
1219,5919,400,373,773,
1222,5861,459,327,786,
1226,5893,424,321,745,
1227,179,20,13,33,
1230,1394,86,84,170,
1231,1491,121,70,191,
1234,85,8,4,12,
1235,5798,449,338,787,
1236,4239,298,242,540,
1237,5859,434,340,774,
1238,269,21,15,36,
1239,1086,84,68,152,
1240,2216,162,125,287,
1241,5788,405,354,759,
1242,5830,404,328,732,
1244,1501,112,78,190,
1247,245,21,7,28,
1249,1078,79,67,146,
1250,5940,396,351,747,
1253,5755,414,332,746,
1254,5949,403,339,742,
1255,5805,426,348,774,
1257,5727,430,333,763,
1258,2553,199,147,346,
1260,5797,409,380,789,
1261,1230,112,54,166,
1262,6068,459,301,760,
1263,196,16,11,27,
1265,1157,96,61,157,
1266,5878,437,329,766,
1267,5833,420,339,759,
1268,5843,420,351,771,
1269,5908,417,345,762,
1271,1783,115,101,216,
1272,5850,437,305,742,
1274,5867,380,328,708,
1275,5776,441,343,784,
1279,368,28,18,46,
1281,5860,374,329,703,
1283,3470,214,216,430,
1284,5720,432,314,746,
1285,5793,435,326,761,
1286,698,44,37,81,
1289,5672,405,295,700,
1291,5890,423,308,731,
1292,5775,422,318,740,
1293,5805,418,337,755,
1295,5926,408,335,743,
1296,103,7,2,9,
1297,1735,128,87,215,
1299,5797,431,311,742,
1300,184,12,13,25,
1301,5675,365,304,669,
1302,5812,402,337,739,
1305,5889,424,324,748,
1307,1627,132,75,207,
1308,4600,334,244,578,
1310,1181,94,77,171,
1311,1133,71,60,131,
1313,5893,441,298,739,
1317,5914,424,348,772,
1319,5848,450,323,773,
1320,661,48,38,86,
1322,578,38,31,69,
1323,5833,426,333,759,
1325,1280,99,84,183,
1326,1238,91,72,163,
1327,100,14,4,18,
1328,5778,393,313,706,
1329,832,66,48,114,
1332,5715,416,295,711,
1333,458,31,30,61,
1334,5952,431,316,747,
1336,5903,442,364,806,
1339,5815,451,319,770,
1340,551,30,25,55,
1341,5789,427,354,781,
1342,5775,386,361,747,
1344,1379,95,74,169,
1346,5889,403,358,761,
1347,276,20,17,37,
1348,5817,397,322,719,
1353,5802,407,321,728,
1355,5870,430,288,718,
1356,2185,157,140,297,
1358,4475,317,282,599,
1359,5866,423,347,770,
1361,2822,212,167,379,
1364,1230,102,67,169,
1365,5894,441,318,759,
1368,5645,386,316,702,
1369,1717,158,106,264,
1370,5814,426,344,770,
1372,5805,423,347,770,
1373,1923,152,104,256,
1374,422,30,23,53,
1375,403,28,33,61,
1376,5864,400,323,723,
1377,6010,390,309,699,
1378,1819,142,98,240,
1379,5709,416,341,757,
1380,5924,416,323,739,
1382,5880,434,340,774,
1383,5769,395,321,716,
1384,5867,365,356,721,
1385,1465,111,76,187,
1387,5788,406,316,722,
1389,312,32,20,52,
1391,4004,283,219,502,
1392,5584,430,361,791,
1393,272,16,14,30,
1394,118,11,6,17,
1395,5916,407,332,739,
1396,5863,413,304,717,
1399,5657,397,355,752,
1402,123,13,5,18,
1404,5870,414,337,751,
1405,5833,397,352,749,
1406,5815,401,330,731,
1407,5730,419,325,744,
1408,5769,416,320,736,
1409,5818,372,358,730,
1411,2086,158,106,264,
1412,1194,80,68,148,
1413,5744,451,306,757,
1414,5960,465,346,811,
1415,5820,439,345,784,
1418,5923,438,346,784,
1421,5758,422,316,738,
1422,5937,432,351,783,
1423,5866,424,344,768,
1424,324,24,21,45,
1425,2109,156,118,274,
1426,5886,396,345,741,
1427,5852,432,319,751,
1429,5848,412,369,781,
1431,5866,445,324,769,
1432,220,23,13,36,
1434,1131,63,69,132,
1435,5950,420,358,778,
1436,5794,371,314,685,
1439,5826,416,328,744,
1441,790,48,56,104,
1442,884,67,45,112,
1443,5846,447,313,760,
1444,5884,437,332,769,
1445,800,61,46,107,
1446,2026,144,105,249,
1447,5751,448,295,743,
1450,4182,290,247,537,
1451,5921,455,361,816,
1453,777,49,34,83,
1454,4152,331,234,565,
1457,17,2,1,3,
1458,5821,426,346,772,
1460,5787,386,331,717,
1461,5878,420,331,751,
1465,5728,398,352,750,
1466,105,9,6,15,
1467,5953,439,339,778,
1471,5887,398,335,733,
1473,404,36,20,56,
1475,223,17,9,26,
1478,5893,402,352,754,
1479,5782,396,340,736,
1481,5966,414,360,774,
1483,5825,431,328,759,
1484,5846,421,357,778,
1485,2090,177,95,272,
1486,5817,430,345,775,
1487,967,75,64,139,
1490,33,5,3,8,
1491,142,12,13,25,
1495,763,60,37,97,
1499,5928,425,342,767,
1501,5553,390,341,731,
1503,283,14,16,30,
1504,5869,467,297,764,
1505,1392,92,87,179,
1507,5739,438,326,764,
1508,888,72,51,123,
1511,5816,441,351,792,
1514,5844,392,325,717,
1518,5686,408,316,724,
1519,5681,448,272,720,
1520,5827,439,351,790,
1522,5802,393,354,747,
1523,5835,450,332,782,
1524,5928,420,344,764,
1525,5838,427,326,753,
1527,5847,434,339,773,
1528,1221,88,75,163,
1529,5740,442,305,747,
1530,5761,435,347,782,
1531,5964,396,335,731,
1532,579,45,39,84,
1535,3787,258,202,460,
1536,87,7,4,11,
1537,5838,417,314,731,
1538,5731,429,321,750,
1541,5717,449,332,781,
1542,5819,455,309,764,
1543,5858,384,373,757,
1544,1410,97,78,175,
1545,1469,110,75,185,
1546,1777,150,88,238,
1547,5943,453,335,788,
1549,81,7,5,12,
1551,1469,82,88,170,
1552,5816,371,341,712,
1553,689,48,41,89,
1555,5916,409,320,729,
1557,5546,408,309,717,
1560,5741,418,339,757,
1562,5846,401,334,735,
1564,1222,85,70,155,
1565,4382,282,281,563,
1566,5681,397,320,717,
1567,5901,398,321,719,
1568,1280,90,77,167,
1569,5763,436,335,771,
1570,265,13,15,28,
1572,5725,432,334,766,
1573,5741,429,322,751,
1574,5753,379,306,685,
1575,2238,172,103,275,
1578,5867,449,355,804,
1579,5882,453,334,787,
1580,5816,395,367,762,
1582,46,4,3,7,
1583,1724,104,86,190,
1585,5844,406,325,731,
1587,5715,404,335,739,
1590,5698,424,326,750,
1591,842,64,43,107,
1593,225,20,10,30,
1594,749,52,53,105,
1595,5836,374,324,698,
1596,5784,411,324,735,
1597,5782,384,343,727,
1599,4200,279,234,513,
1600,5791,430,325,755,
1601,1291,105,67,172,
1603,5635,392,367,759,
1604,861,47,43,90,
1606,4847,342,268,610,
1607,576,44,31,75,
1609,5978,401,337,738,
1610,5785,396,339,735,
1611,1150,84,59,143,
1612,1054,71,66,137,
1615,5698,440,304,744,
1616,758,56,43,99,
1618,3765,303,176,479,
1619,5942,422,298,720,
1620,1206,86,65,151,
1622,928,55,53,108,
1624,2197,164,123,287,
1627,5725,390,301,691,
1629,5845,440,323,763,
1631,229,14,13,27,
1632,189,16,8,24,
1633,332,16,26,42,
1634,652,54,38,92,
1635,197,11,12,23,
1636,1467,98,77,175,
1637,5901,502,315,817,
1639,142,12,9,21,
1640,688,47,41,88,
1641,5787,395,354,749,
1643,617,45,42,87,
1644,514,36,27,63,
1645,5927,427,362,789,
1647,2459,155,151,306,
1649,5950,433,388,821,
1652,5807,410,329,739,
1653,464,37,30,67,
1655,5635,370,344,714,
1656,5773,456,351,807,
1657,5660,416,357,773,
1658,5872,407,311,718,
1659,373,27,19,46,
1660,1907,142,98,240,
1661,1184,91,60,151,
1662,2139,159,135,294,
1663,2541,168,133,301,
1665,5702,361,351,712,
1667,5944,400,340,740,
1669,5745,401,349,750,
1670,5600,398,334,732,
1671,58,6,1,7,
1672,1378,112,85,197,
1673,5775,419,316,735,
1675,5806,400,359,759,
1676,5678,376,360,736,
1677,5923,431,334,765,
1678,908,70,57,127,
1679,1337,81,72,153,
1681,115,13,6,19,
1682,1047,78,82,160,
1683,165,12,10,22,
1684,474,37,36,73,
1686,5710,401,353,754,
1688,1177,83,75,158,
1689,4089,306,235,541,
1691,92,6,5,11,
1693,5907,430,298,728,
1694,5768,418,339,757,
1695,1957,138,104,242,
1696,360,24,33,57,
1698,2682,193,145,338,
1700,5820,432,359,791,
1702,5815,427,342,769,
1703,5994,421,380,801,
1704,1232,85,78,163,
1706,5737,361,344,705,
1708,2302,167,129,296,
1709,5980,418,355,773,
1711,6005,437,369,806,
1712,734,56,38,94,
1713,5883,446,364,810,
1714,122,10,7,17,
1715,5966,418,350,768,
1716,3045,220,175,395,
1719,2980,236,176,412,
1720,1994,147,123,270,
1721,1311,100,76,176,
1722,5809,451,322,773,
1723,63,2,5,7,
1725,5782,445,306,751,
1726,292,16,22,38,
1727,5800,424,313,737,
1728,82,8,5,13,
1729,360,31,30,61,
1730,345,25,23,48,
1731,5904,422,297,719,
1732,5870,477,311,788,
1733,1773,106,105,211,
1734,1879,140,115,255,
1735,1587,118,80,198,
1738,5465,395,265,660,
1740,5679,473,311,784,
1741,1759,107,97,204,
1742,1806,124,115,239,
1743,5877,404,324,728,
1745,1032,84,48,132,
1746,220,17,10,27,
1747,932,56,62,118,
1748,5840,366,356,722,
1749,1287,89,69,158,
1753,34,1,2,3,
1755,5708,408,311,719,
1756,1573,99,109,208,
1757,5779,430,348,778,
1758,1689,111,102,213,
1759,1556,118,89,207,
1761,730,48,36,84,
1763,6024,414,351,765,
1764,5726,430,316,746,
1766,5774,424,383,807,
1767,5533,363,353,716,
1770,5716,391,335,726,
1771,5967,451,352,803,
1773,4781,354,273,627,
1774,5861,426,317,743,
1776,5732,453,336,789,
1777,759,57,43,100,
1778,5867,431,347,778,
1779,6049,450,346,796,
1781,621,51,38,89,
1782,2292,178,144,322,
1783,5946,447,346,793,
1784,1289,78,73,151,
1785,5967,460,332,792,
1786,1494,90,81,171,
1787,1317,107,70,177,
1792,5809,402,337,739,
1793,2154,153,156,309,
1794,1658,119,89,208,
1795,5838,441,358,799,
1796,1236,93,78,171,
1798,5867,458,349,807,
1800,71,5,5,10,
1801,5718,381,335,716,
1802,1086,82,76,158,
1804,5912,436,368,804,
1805,1687,124,92,216,
1806,5987,432,317,749,
1808,5695,442,316,758,
1809,351,27,21,48,
1811,1885,118,126,244,
1812,1410,100,85,185,
1813,705,37,45,82,
1815,5732,426,330,756,
1816,1729,141,84,225,
1817,5841,428,362,790,
1818,1496,120,82,202,
1819,899,67,43,110,
1821,5873,447,310,757,
1822,1084,65,64,129,
1823,942,59,51,110,
1824,5875,445,323,768,
1826,464,36,25,61,
1828,932,77,55,132,
1831,933,84,46,130,
1832,5649,424,322,746,
1833,1316,109,90,199,
1836,1091,90,61,151,
1838,5848,427,362,789,
1839,5765,396,330,726,
1840,5810,406,343,749,
1841,5775,414,317,731,
1842,1791,134,115,249,
1843,200,9,17,26,
1844,4387,349,263,612,
1846,1549,117,104,221,
1848,5944,426,315,741,
1849,727,49,30,79,
1851,5868,405,343,748,
1852,2132,162,108,270,
1853,5805,426,372,798,
1855,5975,436,347,783,
1856,6011,401,365,766,
1858,5726,402,351,753,
1860,724,41,49,90,
1862,5937,425,350,775,
1863,1732,112,99,211,
1864,351,25,15,40,
1865,5790,464,323,787,
1866,5858,448,342,790,
1867,225,17,12,29,
1869,1376,99,91,190,
1870,402,27,14,41,
1871,5779,465,306,771,
1875,5962,450,329,779,
1876,1125,68,63,131,
1877,4489,336,257,593,
1878,1575,108,94,202,
1879,1944,132,117,249,
1882,5969,451,323,774,
1885,2819,207,149,356,
1886,1663,134,88,222,
1887,6023,429,358,787,
1888,940,55,57,112,
1890,5826,437,298,735,
1892,5765,418,346,764,
1893,5821,442,330,772,
1895,540,43,27,70,
1896,6043,450,345,795,
1897,5852,434,330,764,
1901,565,45,26,71,
1902,1417,116,95,211,
1903,5842,433,324,757,
1904,5766,432,318,750,
1905,1308,97,68,165,
1906,5663,421,324,745,
1907,1403,104,78,182,
1908,5853,392,325,717,
1910,5838,461,312,773,
1911,5785,437,312,749,
1912,5896,406,350,756,
1913,5979,423,360,783,
1914,5698,416,327,743,
1915,1225,90,66,156,
1918,1528,117,89,206,
1921,1484,91,92,183,
1922,1574,118,93,211,
1923,5811,418,334,752,
1925,2761,212,151,363,
1926,5644,407,352,759,
1927,5741,401,340,741,
1929,5827,408,371,779,
1930,5776,381,378,759,
1931,5943,453,326,779,
1932,5905,371,338,709,
1934,1587,115,80,195,
1935,5681,405,332,737,
1937,5688,397,340,737,
1939,5764,423,319,742,
1940,4737,313,264,577,
1942,5877,417,333,750,
1943,5904,441,358,799,
1945,5962,427,297,724,
1946,1150,95,70,165,
1947,639,47,39,86,
1948,5780,439,316,755,
1952,2226,160,148,308,
1953,262,21,13,34,
1954,5825,403,317,720,
1958,5792,451,368,819,
1960,5914,459,342,801,
1961,280,24,17,41,
1962,5830,492,307,799,
1963,367,23,18,41,
1966,5797,427,349,776,
1967,1706,110,95,205,
1968,462,38,24,62,
1969,1901,134,96,230,
1971,141,15,7,22,
1972,5834,460,309,769,
1973,5757,430,316,746,
1974,5838,471,341,812,
1975,256,18,14,32,
1977,5870,343,312,655,
1978,86,7,6,13,
1979,5748,414,330,744,
1980,19,4,2,6,
1981,5962,411,331,742,
1982,1314,89,91,180,
1983,5792,420,337,757,
1984,183,12,12,24,
1985,5913,402,341,743,
1987,456,42,31,73,
1988,5802,397,329,726,
1989,1084,67,61,128,
1990,5867,398,343,741,
1991,4158,290,228,518,
1994,5938,437,356,793,
1996,1064,87,59,146,
1998,5756,367,297,664,
1999,307,17,18,35,
2000,1055,77,60,137,
2001,5757,492,272,764,
2003,56,6,2,8,
2004,5868,408,389,797,
2005,5740,439,331,770,
2006,1346,97,89,186,
2007,1884,137,108,245,
2008,639,43,34,77,
2009,5842,403,335,738,
2010,5882,435,341,776,
2011,5892,455,343,798,
2013,5827,386,307,693,
2014,5747,460,289,749,
2016,5915,373,353,726,
2019,5827,383,344,727,
2021,2138,189,108,297,
2022,5739,450,320,770,
2023,5834,413,329,742,
2025,5870,434,318,752,
2026,5850,436,315,751,
2029,1295,90,73,163,
2030,5653,378,293,671,
2031,5846,392,328,720,
2033,5928,456,347,803,
2034,5965,472,354,826,
2035,1786,122,104,226,
2037,5727,430,342,772,
2038,5768,438,335,773,
2039,392,33,22,55,
2040,5901,400,353,753,
2041,5596,447,306,753,
2042,70,6,5,11,
2044,5919,424,335,759,
2045,5746,426,351,777,
2046,5733,430,317,747,
2047,5729,411,317,728,
2049,5862,417,380,797,
2052,5725,451,337,788,
2053,5971,426,346,772,
2054,5687,420,310,730,
2055,5783,393,347,740,
2057,461,29,26,55,
2058,358,33,12,45,
2060,5841,429,358,787,
2061,1149,80,69,149,
2063,499,37,41,78,
2065,1204,90,62,152,
2066,652,45,42,87,
2069,4210,294,228,522,
2070,708,52,40,92,
2072,116,10,6,16,
2075,5895,449,374,823,
2077,5677,384,318,702,
2079,157,8,10,18,
2080,5643,400,304,704,
2081,5763,429,336,765,
2082,5867,431,308,739,
2083,5891,434,373,807,
2084,5914,380,383,763,
2086,5897,442,289,731,
2093,5830,435,322,757,
2094,5819,409,355,764,
2095,5945,393,336,729,
2096,4165,300,257,557,
2097,5896,435,317,752,
2099,6006,413,345,758,
2101,5755,404,273,677,
2102,1039,65,37,102,
2103,1077,76,61,137,
2104,2390,185,135,320,
2107,5780,386,336,722,
2109,1379,83,89,172,
2110,5837,415,321,736,
2112,5889,447,324,771,
2113,5802,432,338,770,
2115,5932,404,377,781,
2116,5747,419,296,715,
2118,5953,403,354,757,
2119,5789,429,329,758,
2120,852,64,44,108,
2125,5639,418,314,732,
2127,5937,413,330,743,
2128,292,27,20,47,
2129,5839,428,318,746,
2130,1021,72,60,132,
2131,5859,467,340,807,
2133,5788,438,306,744,
2134,5870,391,335,726,
2139,5810,423,310,733,
2141,5810,440,346,786,
2144,5777,451,333,784,
2145,1196,82,69,151,
2147,5869,436,298,734,
2148,5984,426,338,764,
2150,5837,435,345,780,
2152,5657,408,315,723,
2153,5873,444,311,755,
2154,5937,459,350,809,
2155,5860,471,305,776,
2156,72,4,2,6,
2159,134,14,7,21,
2160,321,23,19,42,
2161,2425,179,140,319,
2162,5856,417,346,763,
2163,2521,176,136,312,
2167,601,46,34,80,
2168,5883,434,350,784,
2169,1676,123,93,216,
2171,5792,435,328,763,
2172,772,63,41,104,
2173,828,61,46,107,
2175,672,47,35,82,
2177,703,64,49,113,
2178,5897,453,339,792,
2179,6021,458,330,788,
2180,700,48,47,95,
2182,124,8,11,19,
2183,5897,409,346,755,
2185,2118,163,117,280,
2188,4731,355,225,580,
2189,5751,388,292,680,
2192,1040,72,50,122,
2193,2162,170,118,288,
2194,5934,401,318,719,
2195,5812,392,337,729,
2197,177,16,10,26,
2199,5845,413,353,766,
2200,5620,400,345,745,
2202,951,59,55,114,
2203,970,71,47,118,
2204,5846,437,349,786,
2205,5916,447,357,804,
2208,1706,124,95,219,
2210,366,29,20,49,
2211,5822,422,317,739,
2213,5840,402,326,728,
2215,5888,361,402,763,
2217,2027,159,102,261,
2218,1808,111,113,224,
2219,5764,437,291,728,
2221,5925,424,335,759,
2222,656,52,38,90,
2223,969,78,52,130,
2224,5837,399,342,741,
2225,5846,469,302,771,
2226,6009,469,341,810,
2227,759,53,35,88,
2228,1679,121,114,235,
2229,5972,429,340,769,
2230,5844,409,346,755,
2232,5720,432,342,774,
2233,4440,332,241,573,
2234,5858,400,352,752,
2235,4451,317,262,579,
2236,5949,422,303,725,
2237,5727,409,331,740,
2239,775,57,50,107,
2240,5649,429,309,738,
2241,5762,445,304,749,
2243,1721,126,91,217,
2244,5815,412,330,742,
2246,5829,436,328,764,
2247,5884,417,349,766,
2248,5914,436,295,731,
2249,5948,418,307,725,
2250,167,23,3,26,
2253,922,66,51,117,
2254,5989,450,364,814,
2256,232,11,11,22,
2257,5704,408,318,726,
2258,678,44,38,82,
2259,438,29,29,58,
2260,5788,394,327,721,
2263,5834,455,304,759,
2264,5712,370,370,740,
2266,5917,411,320,731,
2269,5928,446,322,768,
2270,2230,177,119,296,
2271,5924,444,337,781,
2272,5665,392,352,744,
2274,1236,79,63,142,
2276,5922,450,351,801,
2278,5805,420,321,741,
2279,95,3,3,6,
2281,5775,438,334,772,
2283,5857,408,329,737,
2285,1734,121,115,236,
2286,5942,404,322,726,
2287,5778,428,360,788,
2288,5839,399,322,721,
2289,5891,422,365,787,
2290,5812,387,335,722,
2291,44,6,3,9,
2292,5893,486,363,849,
2293,5891,468,314,782,
2296,5727,444,294,738,
2297,1643,125,104,229,
2300,5800,405,309,714,
2301,1042,73,60,133,
2302,5974,454,337,791,
2303,5794,385,330,715,
2304,5768,395,343,738,
2306,911,71,54,125,
2307,256,17,13,30,
2308,5752,420,272,692,
2309,101,12,7,19,
2310,5674,382,311,693,
2312,93,4,7,11,
2313,5906,429,333,762,
2314,797,56,36,92,
2318,5837,400,348,748,
2319,777,55,27,82,
2321,441,50,20,70,
2323,1255,90,51,141,
2324,5887,371,340,711,
2326,367,36,16,52,
2327,5731,450,299,749,
2331,653,53,37,90,
2332,337,28,24,52,
2333,1105,81,74,155,
2334,2421,176,118,294,
2337,5872,452,320,772,
2339,469,39,27,66,
2340,5800,410,320,730,
2341,5978,433,370,803,
2344,5885,410,344,754,
2345,5864,368,353,721,
2346,5891,422,338,760,
2347,5853,425,324,749,
2348,5876,408,340,748,
2349,5951,410,329,739,
2355,5817,405,304,709,
2356,5691,400,322,722,
2358,1058,68,62,130,
2362,1927,138,117,255,
2363,5737,443,297,740,
2364,931,57,43,100,
2365,4903,345,256,601,
2366,5911,364,360,724,
2369,1464,112,82,194,
2371,5848,418,331,749,
2372,5830,403,339,742,
2374,5670,461,307,768,
2375,5908,458,325,783,
2376,212,19,11,30,
2377,5975,427,350,777,
2378,1136,70,57,127,
2379,5808,422,338,760,
2381,2226,164,104,268,
2382,5822,428,325,753,
2383,1518,117,96,213,
2384,1402,97,83,180,
2386,5907,409,333,742,
2387,5869,388,367,755,
2389,5826,439,331,770,
2390,5840,385,332,717,
2392,5927,432,323,755,
2393,5786,451,332,783,
2394,5876,411,344,755,
2395,762,53,39,92,
2396,5869,448,303,751,
2398,5708,444,334,778,
2400,5773,411,295,706,
2402,1475,99,91,190,
2403,5695,431,361,792,
2405,956,75,49,124,
2406,5769,404,336,740,
2407,5805,451,340,791,
2408,5836,477,338,815,
2409,5873,395,364,759,
2411,5946,464,301,765,
2412,93,8,9,17,
2415,592,50,39,89,
2416,1428,108,96,204,
2419,5726,436,326,762,
2420,460,28,20,48,
2421,204,15,11,26,
2423,5922,429,310,739,
2425,472,35,30,65,
2426,5886,429,303,732,
2427,261,15,15,30,
2428,5727,406,377,783,
2429,5894,430,319,749,
2430,5710,443,284,727,
2431,1421,103,78,181,
2432,5798,429,315,744,
2433,5947,389,370,759,
2434,5654,399,322,721,
2436,4269,289,231,520,
2437,182,15,13,28,
2438,5865,429,320,749,
2439,5987,443,311,754,
2440,5936,427,349,776,
2442,5683,412,300,712,
2444,234,24,16,40,
2446,1880,158,113,271,
2449,296,23,16,39,
2450,1986,158,100,258,
2453,5931,396,360,756,
2456,213,12,9,21,
2457,1533,111,89,200,
2458,5825,397,306,703,
2459,5753,444,321,765,
2460,911,51,56,107,
2461,5901,395,365,760,
2462,2119,180,102,282,
2465,157,6,11,17,
2467,5862,419,337,756,
2468,462,36,23,59,
2470,5880,423,336,759,
2471,5753,397,362,759,
2472,5702,422,307,729,
2473,272,14,15,29,
2474,5658,400,308,708,
2476,935,58,57,115,
2478,5974,434,332,766,
2480,657,54,36,90,
2482,1567,124,89,213,
2483,5621,376,303,679,
2485,778,58,41,99,
2486,5907,432,373,805,
2487,260,16,14,30,
2488,5895,437,310,747,
2490,5761,432,341,773,
2491,479,29,26,55,
2492,5804,438,324,762,
2493,1150,73,65,138,
2494,1851,137,90,227,
2495,6061,421,351,772,
2496,5830,367,342,709,
2497,1415,100,83,183,
2499,7,1,1,2,
2500,6046,449,337,786,
2501,5771,412,307,719,
2503,1719,117,95,212,
2504,1924,154,106,260,
2506,4136,285,259,544,
2507,1118,91,69,160,
2508,5767,407,314,721,
2509,1016,68,66,134,
2512,5944,440,353,793,
2513,5812,435,307,742,
2514,5835,406,373,779,
2515,5886,424,359,783,
2517,654,46,32,78,
2518,783,73,35,108,
2519,5815,399,349,748,
2520,6042,405,333,738,
2521,5874,408,339,747,
2522,1762,141,118,259,
2523,5779,412,340,752,
2527,150,14,5,19,
2528,5021,406,266,672,
2531,543,32,27,59,
2535,1808,120,100,220,
2536,5871,436,317,753,
2537,5836,394,327,721,
2538,1434,81,79,160,
2540,644,38,30,68,
2541,1665,108,96,204,
2542,5904,458,297,755,
2543,5727,436,336,772,
2544,5803,445,295,740,
2546,5805,417,334,751,
2548,6025,420,378,798,
2549,717,46,48,94,
2551,2739,177,151,328,
2552,1385,95,82,177,
2553,5997,428,317,745,
2554,5745,416,321,737,
2556,112,7,6,13,
2557,382,37,35,72,
2559,5895,349,332,681,
2560,5764,444,319,763,
2563,1522,113,87,200,
2564,5695,481,315,796,
2565,5704,410,314,724,
2566,1635,95,90,185,
2567,5859,421,328,749,
2569,5933,426,343,769,
2571,5934,459,300,759,
2573,5915,422,343,765,
2575,438,29,27,56,
2576,5860,425,323,748,
2578,4106,288,243,531,
2579,5951,445,332,777,
2580,5804,427,303,730,
2581,5879,415,322,737,
2583,5735,433,333,766,
2585,5789,424,312,736,
2587,5751,411,358,769,
2588,5835,412,316,728,
2589,5827,420,323,743,
2590,5716,426,329,755,
2591,2592,158,157,315,
2595,514,37,24,61,
2596,1563,98,72,170,
2598,5854,411,348,759,
2599,5848,422,352,774,
2600,5849,432,353,785,
2601,4645,347,247,594,
2602,843,65,47,112,
2603,103,3,10,13,
2604,1750,132,94,226,
2606,1604,117,92,209,
2610,5871,457,331,788,
2611,5941,394,347,741,
2614,5822,409,316,725,
2615,5900,431,350,781,
2616,5769,450,299,749,
2617,57,4,3,7,
2620,5808,459,344,803,
2621,5828,430,342,772,
2623,5940,451,347,798,
2629,1179,100,86,186,
2630,5756,434,326,760,
2635,743,51,40,91,
2636,5874,412,311,723,
2637,1587,144,85,229,
2639,16,2,1,3,
2640,611,44,27,71,
2641,5932,422,346,768,
2642,5827,472,330,802,
2647,5900,427,338,765,
2648,5870,434,333,767,
2649,5855,443,332,775,
2652,5784,394,353,747,
2655,237,11,17,28,
2656,5886,440,342,782,
2657,1014,66,59,125,
2660,5768,422,310,732,
2661,498,32,28,60,
2662,62,4,3,7,
2664,1896,157,108,265,
2665,2076,152,111,263,
2666,1463,106,84,190,
2668,2046,143,139,282,
2669,5964,464,325,789,
2670,5927,416,307,723,
2671,5751,423,314,737,
2672,5854,385,344,729,
2674,406,34,23,57,
2675,784,49,64,113,
2676,5894,403,334,737,
2680,5795,434,317,751,
2681,35,4,2,6,
2683,1428,99,97,196,
2684,5747,465,316,781,
2685,632,49,36,85,
2686,2336,177,137,314,
2687,624,42,33,75,
2688,1740,133,95,228,
2693,689,50,45,95,
2694,5782,399,296,695,
2695,5999,436,360,796,
2696,6033,480,333,813,
2697,5845,426,343,769,
2698,342,26,19,45,
2700,1309,93,76,169,
2701,778,46,49,95,
2702,5722,383,350,733,
2703,5853,381,314,695,
2705,5769,469,301,770,
2707,1812,128,85,213,
2708,5666,449,270,719,
2712,1036,60,57,117,
2713,5761,373,315,688,
2714,923,65,43,108,
2715,5809,397,343,740,
2716,134,6,10,16,
2717,5898,441,341,782,
2718,1943,119,123,242,
2719,5909,415,343,758,
2721,5770,423,354,777,
2722,5875,422,355,777,
2723,4657,340,263,603,
2726,5798,405,307,712,
2727,4596,330,250,580,
2728,1189,93,75,168,
2729,5756,464,291,755,
2731,5937,443,380,823,
2732,4392,304,246,550,
2736,1189,98,65,163,
2742,5853,436,324,760,
2744,61,5,3,8,
2745,5700,408,326,734,
2746,5778,388,370,758,
2747,5918,431,358,789,
2748,5900,404,317,721,
2749,1295,95,76,171,
2750,5736,408,365,773,
2751,5696,420,322,742,
2753,1124,91,74,165,
2754,5822,424,315,739,
2755,704,55,29,84,
2758,1722,107,87,194,
2759,1254,92,70,162,
2762,290,25,20,45,
2765,5808,446,313,759,
2767,1105,95,52,147,
2769,1541,109,94,203,
2770,214,17,12,29,
2772,5898,443,326,769,
2773,5532,372,328,700,
2775,2923,225,161,386,
2776,5860,456,326,782,
2777,232,15,12,27,
2778,34,3,2,5,
2780,1230,73,74,147,
2781,307,16,20,36,
2783,5792,407,344,751,
2787,5938,444,337,781,
2788,5915,424,350,774,
2789,736,41,27,68,
2790,5845,461,318,779,
2791,2378,165,120,285,
2794,5709,387,377,764,
2795,318,20,28,48,
2797,1670,114,85,199,
2798,2625,171,176,347,
2800,5969,404,342,746,
2801,4130,288,224,512,
2802,154,9,8,17,
2803,1247,121,70,191,
2804,64,3,5,8,
2805,5778,421,316,737,
2806,844,56,57,113,
2807,5814,429,303,732,
2808,511,38,29,67,
2810,1953,123,120,243,
2811,2214,161,138,299,
2814,5677,440,299,739,
2817,5741,399,367,766,
2818,1179,79,76,155,
2820,5957,428,330,758,
2821,1562,92,75,167,
2822,5693,448,327,775,
2823,5884,430,321,751,
2825,5867,433,345,778,
2826,83,3,5,8,
2827,508,40,31,71,
2829,5784,382,332,714,
2830,5787,413,350,763,
2833,898,69,53,122,
2834,310,17,24,41,
2835,232,18,16,34,
2837,5710,421,368,789,
2838,1810,127,105,232,
2839,452,29,35,64,
2840,1399,111,65,176,
2842,4025,266,249,515,
2843,5887,421,326,747,
2845,5922,389,359,748,
2846,5675,423,342,765,
2847,1987,143,104,247,
2849,2151,174,119,293,
2852,5918,422,319,741,
2853,2141,134,120,254,
2856,5767,446,340,786,
2857,810,51,63,114,
2861,5696,372,338,710,
2862,6051,450,340,790,
2863,1056,74,57,131,
2864,408,28,30,58,
2865,5887,415,380,795,
2866,5860,413,325,738,
2867,1129,68,66,134,
2868,932,71,43,114,
2870,5871,400,350,750,
2872,5811,429,342,771,
2873,5933,458,327,785,
2874,5818,416,362,778,
2876,2092,154,134,288,
2877,5852,414,326,740,
2878,5878,414,337,751,
2879,1385,91,83,174,
2882,5644,400,323,723,
2886,5782,381,351,732,
2887,1310,104,86,190,
2888,5804,395,352,747,
2889,718,58,45,103,
2890,5839,465,349,814,
2891,5805,422,331,753,
2892,5826,415,326,741,
2893,620,48,36,84,
2894,5912,449,317,766,
2895,548,46,37,83,
2897,1730,110,109,219,
2899,852,74,46,120,
2901,5872,413,336,749,
2902,5900,462,328,790,
2903,1456,109,86,195,
2904,5670,383,328,711,
2905,5767,449,333,782,
2906,1135,84,72,156,
2908,5897,450,336,786,
2910,826,52,42,94,
2911,528,34,36,70,
2912,1732,141,94,235,
2914,5656,434,343,777,
2915,5861,420,320,740,
2917,1035,72,71,143,
2918,5834,426,323,749,
2919,154,15,8,23,
2920,5914,409,357,766,
2921,5822,410,338,748,
2922,1322,89,70,159,
2924,2262,164,117,281,
2925,5779,426,364,790,
2926,5661,399,326,725,
2931,1714,116,85,201,
2932,173,13,13,26,
2935,5816,414,345,759,
2936,5879,408,348,756,
2937,5755,412,349,761,
2938,844,53,52,105,
2939,1058,76,58,134,
2944,5633,388,340,728,
2945,6007,411,347,758,
2946,5812,441,310,751,
2947,5875,453,348,801,
2950,4630,301,302,603,
2952,750,59,39,98,
2953,114,12,7,19,
2955,5754,412,312,724,
2960,5917,427,323,750,
2961,3832,282,211,493,
2962,5800,416,341,757,
2963,5699,400,291,691,
2966,6028,440,384,824,
2967,1813,131,95,226,
2969,5754,409,335,744,
2970,5738,416,314,730,
2971,5724,419,307,726,
2974,1242,96,64,160,
2976,5843,411,349,760,
2977,5750,431,315,746,
2978,199,22,8,30,
2979,332,23,20,43,
2981,5790,465,308,773,
2982,730,51,37,88,
2983,1112,66,68,134,
2984,1926,127,104,231,
2986,102,11,4,15,
2987,5696,396,294,690,
2988,695,53,38,91,
2989,5780,401,334,735,
2993,5937,445,333,778,
2994,5884,404,362,766,
2996,1262,82,70,152,
2997,5906,445,359,804,
2998,992,75,49,124,
2999,4139,294,245,539,
3000,5928,402,320,722,
3001,686,54,45,99,
3004,5844,384,315,699,
3005,5947,462,313,775,
3008,5742,420,337,757,
3010,4344,317,218,535,
3011,2231,150,111,261,
3013,25,2,1,3,
3014,1376,95,76,171,
3015,5788,422,339,761,
3020,433,21,32,53,
3021,494,34,26,60,
3022,6005,463,369,832,
3024,1440,101,89,190,
3025,5857,471,336,807,
3027,5798,409,339,748,
3028,1475,117,85,202,
3031,978,69,51,120,
3034,5723,409,301,710,
3036,1781,135,97,232,
3037,5821,350,310,660,
3038,412,30,25,55,
3040,5733,424,321,745,
3041,5925,426,333,759,
3042,1138,75,65,140,
3043,4096,288,232,520,
3044,5577,415,321,736,
3045,1640,130,99,229,
3046,5849,453,328,781,
3048,4939,370,288,658,
3049,221,15,13,28,
3050,285,21,9,30,
3051,5934,411,312,723,
3052,5741,394,304,698,
3053,5838,371,335,706,
3054,1167,83,73,156,
3055,247,14,11,25,
3057,1316,73,63,136,
3059,5897,441,325,766,
3060,5726,364,369,733,
3062,5890,428,361,789,
3064,5735,411,341,752,
3065,5795,425,341,766,
3066,4659,303,293,596,
3067,4040,274,239,513,
3068,5843,414,349,763,
3069,5919,381,377,758,
3071,5858,450,316,766,
3072,5933,437,326,763,
3074,5813,402,333,735,
3075,5806,411,334,745,
3078,5869,424,337,761,
3079,1829,118,111,229,
3083,5835,429,290,719,
3085,3424,231,225,456,
3087,5849,422,324,746,
3089,1591,108,78,186,
3090,1909,137,97,234,
3091,5873,444,330,774,
3092,5688,439,327,766,
3093,1108,83,72,155,
3096,1002,80,51,131,
3097,5818,412,324,736,
3101,1079,89,68,157,
3102,5923,423,333,756,
3103,1703,126,100,226,
3105,1598,120,99,219,
3107,5844,426,305,731,
3108,5978,459,329,788,
3109,663,54,40,94,
3112,1422,119,85,204,
3114,1786,128,96,224,
3117,140,11,4,15,
3118,2188,169,127,296,
3119,1130,88,49,137,
3120,5743,437,322,759,
3121,5518,416,286,702,
3122,2164,147,101,248,
3124,2194,142,132,274,
3126,1369,103,81,184,
3127,5803,414,331,745,
3128,447,38,12,50,
3129,2037,148,118,266,
3131,1803,136,109,245,
3133,662,36,33,69,
3134,5914,436,321,757,
3135,109,8,7,15,
3136,703,42,29,71,
3137,209,14,14,28,
3138,1502,92,103,195,
3140,368,24,27,51,
3141,5783,421,312,733,
3142,761,54,47,101,
3145,277,16,14,30,
3147,289,20,21,41,
3148,157,11,10,21,
3149,1153,94,68,162,
3151,5920,392,332,724,
3152,5885,438,338,776,
3153,5858,439,314,753,
3154,5874,437,330,767,
3156,5886,434,289,723,
3158,1478,96,70,166,
3160,147,6,5,11,
3161,5979,444,333,777,
3162,5926,454,320,774,
3163,5920,467,336,803,
3164,1316,99,90,189,
3165,1367,95,84,179,
3168,5901,444,311,755,
3170,5832,377,341,718,
3171,3958,321,183,504,
3172,2009,151,96,247,
3173,5854,455,302,757,
3174,272,19,14,33,
3177,5827,402,342,744,
3179,5806,431,350,781,
3181,5840,436,317,753,
3182,5780,427,341,768,
3183,1241,94,66,160,
3184,5862,419,321,740,
3186,1740,114,94,208,
3187,905,65,62,127,
3188,4112,285,225,510,
3189,5859,428,363,791,
3190,372,32,19,51,
3193,5799,430,358,788,
3194,5937,458,324,782,
3195,5640,457,304,761,
3197,5812,433,325,758,
3198,5822,411,319,730,
3199,5819,379,337,716,
3200,5715,394,350,744,
3202,5847,417,356,773,
3203,541,39,29,68,
3204,5865,426,321,747,
3207,5836,411,325,736,
3208,2412,177,146,323,
3209,4179,306,247,553,
3210,360,13,13,26,
3212,319,22,17,39,
3213,5704,381,329,710,
3214,5959,443,339,782,
3215,5796,456,305,761,
3216,5974,454,313,767,
3217,5751,456,353,809,
3218,5691,410,319,729,
3219,1284,105,61,166,
3220,1531,100,77,177,
3221,5744,443,341,784,
3222,5649,427,330,757,
3224,2031,154,120,274,
3226,2089,134,113,247,
3227,578,41,32,73,
3228,5705,421,334,755,
3230,2194,163,137,300,
3231,5788,420,340,760,
3235,753,57,46,103,
3238,5795,437,331,768,
3239,5726,419,353,772,
3241,5887,404,302,706,
3242,578,42,33,75,
3243,5753,407,366,773,
3244,5694,395,346,741,
3245,924,63,51,114,
3246,533,32,35,67,
3248,5857,413,308,721,
3250,5987,423,310,733,
3251,147,14,6,20,
3252,5827,452,364,816,
3253,282,18,8,26,
3254,5833,445,337,782,
3255,803,65,49,114,
3256,245,14,10,24,
3257,1606,102,97,199,
3259,5634,437,294,731,
3261,5714,418,374,792,
3262,513,33,31,64,
3265,2390,176,132,308,
3266,167,6,9,15,
3268,5951,432,312,744,
3269,5795,399,318,717,
3270,1636,123,103,226,
3273,5790,442,338,780,
3274,5874,400,304,704,
3275,947,67,48,115,
3276,601,47,34,81,
3279,5883,414,340,754,
3280,5846,439,359,798,
3281,1863,129,125,254,
3284,5875,422,323,745,
3285,64,3,5,8,
3286,5874,472,335,807,
3287,654,48,32,80,
3288,1262,90,78,168,
3289,5850,418,344,762,
3290,5871,409,350,759,
3291,2048,148,112,260,
3292,5771,413,315,728,
3293,5843,419,350,769,
3294,5632,409,355,764,
3295,5910,399,323,722,
3296,5864,412,292,704,
3297,1253,93,69,162,
3300,5676,485,286,771,
3301,5732,379,336,715,
3303,5828,452,312,764,
3306,5850,445,321,766,
3307,1185,89,70,159,
3309,4607,341,249,590,
3311,5752,431,307,738,
3313,5984,457,322,779,
3316,5939,434,318,752,
3317,5702,421,268,689,
3318,5803,436,330,766,
3319,752,57,38,95,
3320,5684,464,309,773,
3321,5869,415,325,740,
3323,5697,398,342,740,
3324,602,34,36,70,
3325,5847,415,357,772,
3326,419,31,21,52,
3327,5654,398,325,723,
3328,5864,423,332,755,
3329,5810,433,344,777,
3330,5825,414,307,721,
3331,88,6,4,10,
3332,937,62,46,108,
3333,5736,407,321,728,
3334,504,47,27,74,
3335,1306,71,74,145,
3336,5761,444,306,750,
3337,5749,391,340,731,
3338,1969,132,106,238,
3339,2389,181,140,321,
3340,928,74,44,118,
3342,5645,489,302,791,
3345,4536,287,265,552,
3346,5976,473,335,808,
3347,5928,459,351,810,
3349,1579,121,95,216,
3350,1676,123,99,222,
3352,1738,141,105,246,
3353,5835,409,356,765,
3355,5853,400,334,734,
3356,5671,411,308,719,
3361,5727,403,336,739,
3363,5866,406,375,781,
3364,5751,440,312,752,
3365,5841,421,308,729,
3366,1286,100,74,174,
3368,769,49,40,89,
3369,1278,99,86,185,
3370,159,13,10,23,
3372,1504,109,70,179,
3373,2554,180,129,309,
3376,5995,440,319,759,
3378,5781,379,371,750,
3380,823,59,42,101,
3381,5826,430,329,759,
3383,185,11,6,17,
3384,1678,134,99,233,
3385,5964,376,385,761,
3386,517,39,33,72,
3389,195,10,7,17,
3393,134,7,6,13,
3394,5992,503,314,817,
3395,5841,366,350,716,
3396,5700,391,324,715,
3397,1404,112,93,205,
3399,1733,118,91,209,
3400,329,21,15,36,
3401,5841,444,330,774,
3402,303,22,15,37,
3403,5882,447,386,833,
3404,5960,401,365,766,
3406,5771,422,345,767,
3407,2364,166,149,315,
3409,5824,429,354,783,
3410,5758,428,367,795,
3412,2026,157,100,257,
3413,5714,418,281,699,
3414,2173,177,118,295,
3415,2138,173,107,280,
3416,4582,317,268,585,
3420,1509,119,72,191,
3421,2186,150,134,284,
3423,5839,444,358,802,
3424,5813,414,336,750,
3428,1360,86,66,152,
3429,1843,139,104,243,
3430,811,60,35,95,
3432,5692,399,319,718,
3435,458,36,28,64,
3436,900,65,45,110,
3438,6012,429,336,765,
3439,1472,109,72,181,
3440,5789,434,304,738,
3442,5786,409,330,739,
3443,269,9,14,23,
3444,99,3,9,12,
3445,5869,408,329,737,
3448,5843,412,335,747,
3449,577,38,41,79,
3450,5705,423,324,747,
3451,403,25,16,41,
3452,5847,378,389,767,
3453,5803,526,309,835,
3454,1585,123,78,201,
3455,5803,454,288,742,
3456,5733,392,345,737,
3458,742,45,28,73,
3459,775,59,40,99,
3460,5864,463,315,778,
3461,5692,389,359,748,
3463,149,8,6,14,
3465,5690,429,328,757,
3467,5760,410,330,740,
3468,1252,80,74,154,
3470,5935,394,378,772,
3472,508,36,24,60,
3476,1820,132,123,255,
3477,2031,150,99,249,
3478,3446,231,192,423,
3479,565,33,28,61,
3480,1488,115,94,209,
3481,4087,265,248,513,
3482,1527,112,92,204,
3484,5805,411,342,753,
3487,685,52,34,86,
3488,5662,444,296,740,
3489,1917,150,112,262,
3491,5267,369,290,659,
3492,542,27,44,71,
3493,5753,424,313,737,
3494,59,2,3,5,
3496,5800,432,319,751,
3498,1720,118,98,216,
3500,4573,345,238,583,
3502,5817,421,328,749,
3503,6035,443,375,818,
3504,5857,436,320,756,
3505,4094,294,227,521,
3506,5809,452,321,773,
3507,94,9,2,11,
3508,518,40,19,59,
3512,5932,428,319,747,
3513,5789,439,330,769,
3514,750,43,38,81,
3515,458,39,29,68,
3516,5895,442,317,759,
3517,83,8,3,11,
3518,958,72,59,131,
3520,5867,414,308,722,
3523,475,33,34,67,
3526,528,39,30,69,
3529,4388,269,282,551,
3530,5696,348,337,685,
3532,5931,431,316,747,
3533,449,36,25,61,
3534,5784,429,332,761,
3535,301,25,22,47,
3536,863,74,49,123,
3537,5775,397,326,723,
3538,5797,453,304,757,
3541,5807,429,314,743,
3542,787,58,47,105,
3546,1547,110,93,203,
3548,5623,409,331,740,
3550,5882,424,351,775,
3551,261,18,11,29,
3552,5774,422,321,743,
3553,5648,395,347,742,
3556,5746,420,331,751,
3557,5862,422,335,757,
3558,5869,418,336,754,
3559,143,12,4,16,
3560,5706,403,328,731,
3561,1305,101,76,177,
3562,741,51,29,80,
3563,3446,247,206,453,
3566,5852,390,374,764,
3568,5771,427,352,779,
3569,1129,80,54,134,
3570,5893,444,325,769,
3571,5970,441,330,771,
3572,5977,429,308,737,
3574,496,39,40,79,
3575,1433,122,75,197,
3577,381,23,26,49,
3578,5816,414,329,743,
3581,35,3,4,7,
3583,5876,417,346,763,
3585,5594,396,332,728,
3588,2316,189,104,293,
3589,5755,450,315,765,
3592,49,3,4,7,
3594,43,6,2,8,
3597,1661,127,92,219,
3598,1430,110,86,196,
3599,739,51,43,94,
3600,599,53,34,87,
3601,353,26,14,40,
3602,5877,423,324,747,
3604,5919,402,339,741,
3605,1540,99,94,193,
3608,5860,413,314,727,
3610,4039,287,251,538,
3611,5792,386,368,754,
3612,5913,411,336,747,
3613,5830,439,325,764,
3615,5821,405,321,726,
3616,5919,448,322,770,
3618,504,44,41,85,
3619,5794,423,318,741,
3621,5856,408,336,744,
3622,583,36,34,70,
3623,1776,109,82,191,
3624,5816,390,400,790,
3625,5789,461,329,790,
3627,1245,89,78,167,
3628,920,62,53,115,
3630,58,3,4,7,
3631,5867,427,310,737,
3633,89,5,5,10,
3635,5929,431,314,745,
3639,2276,191,136,327,
3640,1776,133,100,233,
3644,5913,437,338,775,
3645,5887,423,355,778,
3646,133,8,8,16,
3648,5763,431,332,763,
3649,5650,412,318,730,
3650,4224,323,225,548,
3651,309,26,14,40,
3652,94,2,6,8,
3654,5987,470,356,826,
3655,207,13,14,27,
3657,5859,411,317,728,
3658,6006,432,345,777,
3659,5840,449,329,778,
3660,392,22,13,35,
3661,257,20,12,32,
3662,6039,425,369,794,
3663,5865,442,307,749,
3665,5821,420,299,719,
3666,5733,384,327,711,
3667,2375,175,125,300,
3670,5839,393,363,756,
3671,1541,108,81,189,
3675,4365,331,273,604,
3676,3821,297,215,512,
3677,368,26,13,39,
3678,141,11,10,21,
3684,5878,422,354,776,
3685,5879,432,330,762,
3688,1518,126,99,225,
3689,5845,407,317,724,
3692,2115,162,114,276,
3693,5928,443,326,769,
3694,216,15,15,30,
3695,1178,100,69,169,
3696,1979,135,100,235,
3697,1836,141,111,252,
3698,1458,123,88,211,
3699,5802,361,353,714,
3700,1028,69,48,117,
3701,5756,424,326,750,
3702,698,60,35,95,
3703,5818,414,302,716,
3704,439,31,32,63,
3705,4174,275,245,520,
3708,232,11,15,26,
3709,59,2,3,5,
3710,1625,134,90,224,
3711,5889,411,340,751,
3714,5983,462,289,751,
3715,795,72,31,103,
3717,5897,443,325,768,
3718,5684,432,339,771,
3719,5707,441,327,768,
3723,311,31,17,48,
3725,5742,408,321,729,
3726,1321,96,76,172,
3727,5887,413,348,761,
3728,1344,90,75,165,
3730,5780,412,322,734,
3732,5738,440,306,746,
3733,505,38,20,58,
3734,5935,423,328,751,
3735,1587,108,100,208,
3736,4965,379,268,647,
3739,5833,435,325,760,
3740,40,1,2,3,
3741,5745,385,345,730,
3742,2153,149,131,280,
3745,5847,405,336,741,
3749,5932,416,373,789,
3754,5768,428,296,724,
3756,5889,428,324,752,
3757,5930,446,366,812,
3758,1148,92,74,166,
3759,5900,432,326,758,
3760,5912,393,328,721,
3762,5751,400,324,724,
3763,1190,89,54,143,
3764,5665,390,332,722,
3765,114,9,7,16,
3769,5821,461,321,782,
3770,5714,435,335,770,
3771,5795,421,339,760,
3773,5817,430,347,777,
3774,2906,193,196,389,
3775,2226,177,119,296,
3776,639,43,34,77,
3777,5769,428,301,729,
3779,5792,420,311,731,
3780,5908,431,349,780,
3781,5676,443,294,737,
3782,5783,404,313,717,
3783,4286,295,280,575,
3784,7,2,2,4,
3785,5907,426,351,777,
3786,1692,136,98,234,
3787,1363,94,77,171,
3790,4363,344,212,556,
3791,5776,429,299,728,
3792,3162,224,205,429,
3793,5959,403,353,756,
3794,5855,403,347,750,
3796,5884,447,324,771,
3797,1024,76,67,143,
3801,760,58,33,91,
3803,1774,147,79,226,
3804,5724,439,369,808,
3805,1302,79,74,153,
3806,249,17,17,34,
3808,1921,119,102,221,
3811,5868,369,338,707,
3812,5955,420,330,750,
3813,5693,404,310,714,
3816,5742,413,318,731,
3817,253,15,11,26,
3818,5789,423,330,753,
3819,5722,433,319,752,
3822,5718,459,307,766,
3823,5988,416,359,775,
3824,1201,79,57,136,
3825,2297,157,150,307,
3827,5904,445,354,799,
3828,5879,406,343,749,
3829,5887,438,375,813,
3830,2370,162,134,296,
3831,5776,379,313,692,
3833,5965,448,358,806,
3835,355,40,22,62,
3836,5852,389,351,740,
3837,5882,409,341,750,
3839,1628,101,83,184,
3840,5926,404,334,738,
3841,5892,435,335,770,
3845,4247,340,211,551,
3847,565,45,32,77,
3849,187,13,9,22,
3850,1167,88,52,140,
3851,5916,472,321,793,
3852,409,29,24,53,
3854,5862,474,332,806,
3855,1046,68,50,118,
3856,1666,115,108,223,
3857,5725,398,338,736,
3858,5745,380,324,704,
3859,6011,451,362,813,
3860,432,24,26,50,
3862,1383,113,81,194,
3863,1086,71,56,127,
3864,939,64,57,121,
3867,5709,425,322,747,
3869,5630,417,321,738,
3870,5847,440,331,771,
3871,1630,120,97,217,
3872,169,9,9,18,
3873,5919,432,353,785,
3877,5885,421,312,733,
3878,5825,455,322,777,
3879,5789,431,320,751,
3882,1443,105,92,197,
3883,275,20,18,38,
3884,1753,122,102,224,
3885,1840,145,112,257,
3886,6007,422,361,783,
3887,5842,453,338,791,
3888,384,30,32,62,
3889,5799,424,312,736,
3890,5738,406,327,733,
3892,2151,130,119,249,
3893,5751,426,356,782,
3894,476,29,26,55,
3895,97,6,7,13,
3901,2440,171,151,322,
3903,5923,378,364,742,
3907,5838,423,353,776,
3909,1609,113,103,216,
3910,5927,433,365,798,
3911,125,9,8,17,
3912,914,60,56,116,
3913,5856,437,284,721,
3915,5865,429,331,760,
3918,5799,391,351,742,
3920,5736,400,316,716,
3921,523,36,23,59,
3922,5909,407,350,757,
3923,1185,83,69,152,
3925,5734,396,355,751,
3926,2306,176,123,299,
3927,5809,431,330,761,
3928,889,63,57,120,
3929,6008,455,313,768,
3932,2247,163,135,298,
3933,5895,446,313,759,
3934,2083,158,109,267,
3935,4185,298,261,559,
3936,303,18,19,37,
3937,5828,419,313,732,
3938,970,71,59,130,
3940,5853,417,327,744,
3941,4304,301,263,564,
3943,5651,402,337,739,
3944,5615,416,305,721,
3945,5688,461,291,752,
3946,5881,416,354,770,
3947,6005,375,350,725,
3948,34,3,5,8,
3950,2198,165,117,282,
3951,5765,442,340,782,
3956,5850,432,325,757,
3959,5719,447,298,745,
3960,1209,88,70,158,
3961,5792,427,307,734,
3962,5919,413,328,741,
3964,461,27,31,58,
3965,5800,414,319,733,
3966,5627,375,309,684,
3968,5785,420,354,774,
3969,5794,406,364,770,
3971,5767,408,334,742,
3972,822,65,41,106,
3977,1349,107,83,190,
3978,5909,392,339,731,
3982,1572,116,89,205,
3986,529,36,33,69,
3987,620,33,40,73,
3989,5729,421,298,719,
3990,2160,151,124,275,
3991,5739,392,313,705,
3992,2562,194,174,368,
3994,5836,444,287,731,
3998,5784,404,347,751,
3999,5742,475,300,775,
4000,2736,177,160,337,
4003,55,6,3,9,
4007,4448,332,229,561,
4008,425,27,24,51,
4009,5694,408,344,752,
4011,5758,410,350,760,
4012,125,11,2,13,
4013,5886,410,328,738,
4014,5693,428,331,759,
4015,5668,377,332,709,
4017,4199,295,223,518,
4019,5660,428,320,748,
4023,5873,394,342,736,
4027,5790,419,288,707,
4028,121,8,4,12,
4029,5696,387,334,721,
4030,5910,399,371,770,
4031,211,15,13,28,
4036,5836,390,340,730,
4038,1662,122,96,218,
4039,5892,407,340,747,
4040,5978,415,343,758,
4041,775,63,40,103,
4042,1805,126,116,242,
4043,2557,187,158,345,
4044,5865,395,350,745,
4045,6002,453,345,798,
4047,1145,91,61,152,
4049,1863,156,91,247,
4051,5907,437,329,766,
4052,5627,444,317,761,
4053,5904,418,365,783,
4056,1117,81,64,145,
4057,5689,456,282,738,
4059,5824,407,352,759,
4064,5810,440,337,777,
4065,5793,402,335,737,
4066,297,16,21,37,
4068,5751,458,324,782,
4069,5720,377,357,734,
4070,4795,333,255,588,
4071,4145,275,293,568,
4072,5671,401,332,733,
4073,205,19,10,29,
4076,6046,437,318,755,
4077,536,38,29,67,
4078,3493,298,192,490,
4079,5760,356,317,673,
4081,5992,465,340,805,
4083,5901,486,332,818,
4085,970,66,49,115,
4086,1007,64,60,124,
4087,5770,410,333,743,
4088,1546,108,89,197,
4090,187,16,7,23,
4091,5719,416,303,719,
4092,2113,149,112,261,
4093,5867,440,314,754,
4094,5874,416,385,801,
4095,990,80,57,137,
4096,5929,435,316,751,
4098,5935,434,334,768,
4100,992,70,52,122,
4101,2125,164,134,298,
4102,5754,413,312,725,
4107,2616,204,125,329,
4110,5882,424,313,737,
4113,5985,437,322,759,
4114,5844,397,364,761,
4115,1440,105,90,195,
4116,5755,409,301,710,
4117,5798,444,355,799,
4118,5842,460,314,774,
4119,5800,410,374,784,
4120,1444,89,92,181,
4121,377,25,29,54,
4122,2391,177,153,330,
4123,5760,416,352,768,
4124,1063,80,64,144,
4125,5818,422,329,751,
4127,5941,447,330,777,
4128,1424,105,82,187,
4129,5879,413,341,754,
4130,5760,413,338,751,
4131,57,3,3,6,
4132,5845,444,352,796,
4133,5865,423,338,761,
4134,5896,425,319,744,
4136,5650,408,302,710,
4137,1738,146,104,250,
4140,5772,413,340,753,
4144,4114,304,252,556,
4145,190,11,11,22,
4147,5877,436,319,755,
4150,5820,392,340,732,
4151,1582,118,80,198,
4152,1912,144,118,262,
4153,535,46,36,82,
4154,5719,362,341,703,
4156,5882,408,361,769,
4157,745,59,34,93,
4159,5948,396,358,754,
4160,535,32,30,62,
4163,114,9,4,13,
4164,5738,399,276,675,
4166,5888,424,345,769,
4167,5911,420,308,728,
4168,5899,413,349,762,
4170,5756,421,337,758,
4171,5769,381,357,738,
4172,5784,434,357,791,
4173,50,6,1,7,
4174,773,40,46,86,
4176,5992,456,328,784,
4177,5866,432,316,748,
4179,5707,424,327,751,
4180,4112,258,250,508,
4182,1661,99,97,196,
4183,5741,402,319,721,
4184,5766,446,309,755,
4185,5878,465,367,832,
4187,5835,381,355,736,
4190,5805,404,311,715,
4193,2269,167,142,309,
4195,680,37,44,81,
4196,5545,405,275,680,
4197,1057,86,67,153,
4199,5890,425,358,783,
4200,5643,340,370,710,
4201,65,4,4,8,
4203,366,29,19,48,
4206,1097,84,56,140,
4207,1927,124,120,244,
4208,1368,112,79,191,
4209,219,11,17,28,
4210,5800,398,363,761,
4211,6005,419,349,768,
4212,3058,247,153,400,
4214,1904,153,101,254,
4216,5885,435,292,727,
4217,5735,463,331,794,
4218,5723,422,342,764,
4222,5868,391,340,731,
4224,5743,405,336,741,
4225,1465,100,76,176,
4227,97,8,4,12,
4228,5880,384,367,751,
4229,1123,70,81,151,
4230,5857,385,333,718,
4231,5778,451,344,795,
4234,2513,163,154,317,
4235,5855,389,328,717,
4236,1658,139,97,236,
4237,5968,421,318,739,
4239,706,49,43,92,
4240,985,54,53,107,
4241,5731,398,294,692,
4242,544,34,20,54,
4244,762,49,46,95,
4245,1414,101,75,176,
4246,5996,414,347,761,
4248,4354,285,245,530,
4249,1085,70,62,132,
4251,1247,101,65,166,
4252,5788,426,346,772,
4253,5707,407,339,746,
4255,5600,440,273,713,
4257,5937,429,331,760,
4258,5812,451,344,795,
4260,5751,451,345,796,
4263,5742,425,302,727,
4265,891,68,60,128,
4266,5718,448,330,778,
4267,4206,320,232,552,
4269,5716,430,323,753,
4273,5858,447,293,740,
4274,1781,99,96,195,
4275,5825,388,359,747,
4276,2201,151,126,277,
4277,188,18,5,23,
4278,5836,447,335,782,
4279,5886,455,345,800,
4280,5857,421,334,755,
4282,5880,458,336,794,
4283,6010,444,316,760,
4284,4262,273,249,522,
4285,687,44,40,84,
4287,1269,99,56,155,
4289,5800,390,348,738,
4290,2662,169,177,346,
4291,5887,422,361,783,
4292,1010,80,59,139,
4294,975,68,61,129,
4295,4703,356,270,626,
4297,93,7,1,8,
4298,5868,441,323,764,
4299,142,12,9,21,
4300,1733,113,98,211,
4301,5820,411,304,715,
4302,5960,455,319,774,
4303,5915,428,329,757,
4305,5913,432,336,768,
4306,5909,428,315,743,
4307,5802,428,333,761,
4309,5861,396,353,749,
4310,5832,465,333,798,
4311,5740,432,314,746,
4313,1643,115,112,227,
4314,3858,298,207,505,
4315,5930,417,307,724,
4316,188,11,11,22,
4317,5594,419,324,743,
4320,1489,96,89,185,
4321,302,17,19,36,
4322,1226,91,66,157,
4323,5708,418,347,765,
4324,279,26,17,43,
4325,1574,110,99,209,
4326,5881,420,363,783,
4327,4518,358,277,635,
4328,914,65,45,110,
4329,146,9,12,21,
4330,1027,96,61,157,
4333,5743,408,323,731,
4335,5928,451,350,801,
4336,318,19,15,34,
4337,5762,442,310,752,
4338,5893,447,336,783,
4339,1960,139,131,270,
4340,1096,79,61,140,
4342,1319,89,78,167,
4344,5951,428,362,790,
4345,1206,74,81,155,
4346,909,61,56,117,
4348,5835,411,326,737,
4350,5737,402,310,712,
4351,1756,115,109,224,
4352,1995,159,110,269,
4354,33,3,2,5,
4355,206,18,10,28,
4357,5819,436,315,751,
4363,1974,135,115,250,
4365,5873,426,325,751,
4366,4545,344,227,571,
4367,1839,155,90,245,
4368,447,24,27,51,
4369,443,34,38,72,
4370,303,24,12,36,
4371,5769,458,292,750,
4372,5773,432,348,780,
4373,1630,113,106,219,
4374,58,6,1,7,
4375,1550,108,87,195,
4378,5747,416,338,754,
4379,701,46,34,80,
4380,5998,431,344,775,
4382,5766,412,324,736,
4383,202,8,15,23,
4385,954,78,47,125,
4387,108,10,5,15,
4388,5901,389,316,705,
4389,1785,124,120,244,
4390,1198,82,69,151,
4391,5842,469,322,791,
4392,22,4,1,5,
4393,908,69,67,136,
4394,47,5,1,6,
4395,145,10,5,15,
4396,4321,279,260,539,
4397,1117,75,77,152,
4398,4253,331,214,545,
4400,5855,422,327,749,
4401,4529,382,230,612,
4402,824,59,49,108,
4403,6024,424,365,789,
4404,450,26,26,52,
4405,362,27,18,45,
4406,5821,421,298,719,
4410,5788,426,334,760,
4411,4220,305,235,540,
4412,4235,278,238,516,
4413,1925,131,110,241,
4414,2021,118,109,227,
4415,1710,147,96,243,
4416,5836,438,340,778,
4417,192,13,12,25,
4419,2821,217,151,368,
4420,5745,425,328,753,
4422,526,48,28,76,
4424,103,10,6,16,
4425,1418,90,80,170,
4426,285,22,20,42,
4428,5834,432,334,766,
4429,2488,182,138,320,
4430,5712,428,314,742,
4431,5905,414,315,729,
4432,5849,447,317,764,
4433,5795,412,303,715,
4434,64,8,7,15,
4435,1706,102,93,195,
4437,5896,424,312,736,
4438,5952,397,354,751,
4441,5856,470,359,829,
4442,1467,109,67,176,
4443,5861,362,359,721,
4444,5795,433,324,757,
4446,1351,107,89,196,
4448,550,51,24,75,
4449,5743,413,310,723,
4450,5795,386,325,711,
4451,242,14,16,30,
4457,5830,434,319,753,
4459,5781,401,333,734,
4461,5747,403,335,738,
4463,1803,143,113,256,
4464,1976,152,117,269,
4466,5774,418,312,730,
4467,1674,131,80,211,
4469,5914,410,357,767,
4470,987,62,58,120,
4471,2327,173,135,308,
4473,431,33,26,59,
4474,447,25,20,45,
4475,4916,386,272,658,
4478,2129,118,130,248,
4479,5778,406,352,758,
4480,4243,302,271,573,
4481,1135,85,79,164,
4482,5885,444,359,803,
4484,3948,266,225,491,
4485,5827,383,308,691,
4487,1080,84,59,143,
4488,5787,419,347,766,
4489,1616,107,84,191,
4490,5775,485,321,806,
4492,5869,440,269,709,
4494,5902,420,335,755,
4495,5836,417,296,713,
4498,200,18,9,27,
4499,4093,299,225,524,
4500,1753,126,103,229,
4501,401,20,19,39,
4503,5786,411,320,731,
4504,4964,352,272,624,
4505,5959,458,325,783,
4506,1080,90,44,134,
4508,1611,129,104,233,
4509,5620,406,346,752,
4511,129,7,8,15,
4512,5831,426,325,751,
4513,5738,393,309,702,
4515,971,60,36,96,
4516,5867,463,316,779,
4520,143,10,9,19,
4521,5895,438,317,755,
4527,1272,88,62,150,
4528,1002,71,47,118,
4529,825,56,50,106,
4531,5786,457,317,774,
4532,803,65,39,104,
4533,544,47,23,70,
4534,5716,381,330,711,
4535,1847,144,93,237,
4536,5831,461,289,750,
4537,1040,74,67,141,
4539,5808,423,331,754,
4541,66,4,7,11,
4542,3547,236,222,458,
4543,2287,155,118,273,
4547,5851,438,326,764,
4548,140,12,11,23,
4549,5898,433,343,776,
4552,5984,446,338,784,
4553,5757,429,328,757,
4556,254,17,9,26,
4560,5756,429,324,753,
4561,5880,412,344,756,
4565,1416,95,86,181,
4567,5817,429,337,766,
4568,5921,405,351,756,
4571,5655,410,314,724,
4572,740,35,37,72,
4573,120,10,6,16,
4574,5794,428,309,737,
4575,2239,159,147,306,
4580,125,9,12,21,
4581,5742,402,335,737,
4582,210,16,11,27,
4583,5780,444,301,745,
4584,5672,429,298,727,
4586,4744,343,253,596,
4588,4193,274,248,522,
4589,1929,131,123,254,
4591,5976,437,338,775,
4592,137,11,12,23,
4593,5825,391,351,742,
4595,5914,448,377,825,
4601,691,46,44,90,
4602,105,7,6,13,
4603,5887,410,385,795,
4604,399,27,28,55,
4605,5916,443,325,768,
4606,1917,133,102,235,
4607,546,42,30,72,
4608,339,24,18,42,
4610,788,54,49,103,
4611,5925,412,328,740,
4614,85,6,3,9,
4615,5611,405,306,711,
4617,965,75,50,125,
4618,5833,432,305,737,
4619,418,29,19,48,
4622,394,30,16,46,
4623,5815,413,320,733,
4624,5870,401,314,715,
4626,2380,183,147,330,
4627,610,44,35,79,
4631,5753,429,328,757,
4633,5816,395,324,719,
4634,569,46,31,77,
4637,1125,98,68,166,
4638,5894,419,316,735,
4640,5701,404,348,752,
4641,2562,178,140,318,
4642,83,5,4,9,
4643,5774,446,329,775,
4644,1707,130,88,218,
4645,1715,122,84,206,
4646,5695,411,324,735,
4649,428,27,16,43,
4652,3942,301,195,496,
4655,5932,448,344,792,
4656,2002,139,117,256,
4657,5811,389,306,695,
4658,5672,402,320,722,
4659,5966,412,354,766,
4661,954,66,70,136,
4662,161,16,9,25,
4664,671,47,33,80,
4665,5856,398,337,735,
4666,5598,400,298,698,
4667,155,9,12,21,
4668,5867,438,370,808,
4669,1814,114,116,230,
4670,5678,428,316,744,
4671,5941,453,336,789,
4673,267,15,13,28,
4674,5147,398,250,648,
4675,214,15,12,27,
4677,2367,194,105,299,
4678,5740,423,287,710,
4679,5904,425,335,760,
4680,5698,407,311,718,
4682,672,42,33,75,
4683,2041,144,109,253,
4685,307,22,16,38,
4686,2761,222,168,390,
4687,5911,426,335,761,
4689,5676,454,287,741,
4690,1247,86,85,171,
4692,5740,422,298,720,
4693,5878,377,354,731,
4695,5806,448,304,752,
4697,4278,340,226,566,
4700,972,67,62,129,
4702,370,30,31,61,
4703,348,22,17,39,
4704,5853,415,329,744,
4706,445,40,25,65,
4709,5895,407,348,755,
4710,2106,153,120,273,
4711,5930,431,331,762,
4712,1810,139,92,231,
4713,1313,104,73,177,
4714,1125,77,62,139,
4715,544,40,35,75,
4716,5843,388,311,699,
4718,5952,461,353,814,
4719,270,19,16,35,
4720,5878,401,324,725,
4721,5951,418,353,771,
4722,5740,404,329,733,
4723,960,74,45,119,
4725,3388,232,194,426,
4726,736,49,46,95,
4727,5974,425,327,752,
4730,1254,81,72,153,
4731,2342,148,157,305,
4733,3934,267,221,488,
4734,1991,139,112,251,
4735,5905,428,345,773,
4738,5727,382,330,712,
4739,1041,69,57,126,
4740,5824,413,341,754,
4742,5920,409,331,740,
4743,3326,236,184,420,
4746,710,58,44,102,
4749,1938,129,113,242,
4750,5815,402,364,766,
4751,5863,412,331,743,
4752,5894,438,351,789,
4753,965,54,61,115,
4755,5743,409,338,747,
4758,155,12,6,18,
4759,4316,344,237,581,
4760,5829,426,330,756,
4762,5903,420,332,752,
4763,5770,384,335,719,
4764,5964,410,354,764,
4765,5854,421,312,733,
4766,5877,442,336,778,
4767,5741,379,347,726,
4768,243,17,14,31,
4770,45,5,3,8,
4771,6002,441,360,801,
4772,3013,191,183,374,
4773,4033,278,209,487,
4774,1421,97,69,166,
4775,2705,222,143,365,
4778,1211,98,71,169,
4779,5766,414,312,726,
4780,5750,460,299,759,
4781,735,46,43,89,
4782,5828,396,301,697,
4783,5875,421,353,774,
4784,2168,136,146,282,
4785,230,15,16,31,
4786,5839,406,347,753,
4787,5667,411,365,776,
4788,531,35,26,61,
4789,5147,379,283,662,
4790,5942,414,335,749,
4791,5775,410,347,757,
4792,202,14,11,25,
4794,479,34,28,62,
4795,442,28,22,50,
4796,5915,437,324,761,
4800,1393,103,83,186,
4801,5656,405,333,738,
4802,290,23,12,35,
4804,5803,398,364,762,
4806,5752,397,333,730,
4810,5907,414,336,750,
4811,870,66,50,116,
4812,5723,380,321,701,
4814,5918,409,320,729,
4815,5904,432,339,771,
4816,5714,423,313,736,
4818,5735,413,338,751,
4819,175,11,7,18,
4821,5856,440,353,793,
4823,1156,87,73,160,
4826,760,71,38,109,
4827,82,2,4,6,
4828,138,14,10,24,
4829,5860,438,350,788,
4830,1483,104,101,205,
4831,5829,450,336,786,
4832,5869,442,310,752,
4833,1402,110,86,196,
4834,1042,66,61,127,
4835,4510,382,199,581,
4836,5732,408,318,726,
4838,3856,281,220,501,
4839,5816,394,330,724,
4841,348,23,15,38,
4842,2621,195,169,364,
4843,98,7,4,11,
4845,674,50,50,100,
4846,1299,91,69,160,
4850,3383,259,200,459,
4851,5754,393,335,728,
4854,5709,400,314,714,
4855,2085,165,90,255,
4856,527,48,21,69,
4857,698,58,38,96,
4858,330,17,19,36,
4860,216,16,13,29,
4861,5803,402,312,714,
4863,544,34,31,65,
4864,380,29,20,49,
4865,763,45,33,78,
4866,5841,397,307,704,
4867,5974,416,348,764,
4868,5838,444,346,790,
4870,1782,136,95,231,
4871,226,15,5,20,
4874,5838,428,333,761,
4876,2762,205,142,347,
4878,5932,458,364,822,
4880,6050,441,345,786,
4882,5738,392,353,745,
4883,5789,419,303,722,
4887,2105,163,130,293,
4891,864,48,50,98,
4892,5849,376,354,730,
4894,5891,431,305,736,
4895,1429,98,80,178,
4896,1188,78,80,158,
4897,494,33,28,61,
4900,5538,416,322,738,
4901,5771,403,319,722,
4902,5898,422,348,770,
4904,5861,425,347,772,
4905,5903,442,331,773,
4907,5794,399,315,714,
4908,1626,124,96,220,
4909,5702,481,313,794,
4911,5825,437,327,764,
4912,1614,125,100,225,
4915,662,50,36,86,
4916,403,31,26,57,
4917,5772,439,324,763,
4918,6044,439,358,797,
4922,5763,415,340,755,
4923,893,71,58,129,
4925,1076,78,67,145,
4926,1466,112,84,196,
4927,5759,402,366,768,
4928,5831,427,360,787,
4931,65,3,3,6,
4932,5841,398,349,747,
4933,1931,138,115,253,
4934,188,15,9,24,
4935,2114,152,113,265,
4937,3766,268,206,474,
4938,5883,447,301,748,
4939,2068,139,117,256,
4940,5854,500,302,802,
4941,1618,119,90,209,
4942,5919,465,337,802,
4943,1055,71,64,135,
4945,1290,91,78,169,
4946,5812,444,333,777,
4947,5120,408,282,690,
4948,848,43,45,88,
4949,962,76,73,149,
4951,5909,425,341,766,
4952,138,13,7,20,
4953,5942,424,363,787,
4954,375,24,21,45,
4956,5817,415,318,733,
4958,5714,426,333,759,
4959,1246,81,74,155,
4960,5874,458,307,765,
4961,986,60,65,125,
4962,88,5,4,9,
4963,5915,446,327,773,
4964,5781,389,358,747,
4965,5680,397,335,732,
4969,508,37,42,79,
4970,5944,443,336,779,
4971,5887,421,343,764,
4972,2222,171,120,291,
4973,5854,426,320,746,
4974,1660,131,79,210,
4975,5725,377,344,721,
4979,652,46,41,87,
4982,5839,402,348,750,
4983,5744,470,312,782,
4984,595,48,26,74,
4985,2155,164,122,286,
4987,1247,81,70,151,
4989,5869,443,334,777,
4991,5821,407,342,749,
4992,517,39,31,70,
4993,74,8,3,11,
4994,5706,460,313,773,
4998,5725,455,317,772,
5000,259,12,9,21,
5004,5908,433,303,736,
5008,5882,439,346,785,
5009,239,17,11,28,
5010,267,17,7,24,
5011,5658,372,374,746,
5012,5654,388,345,733,
5014,5831,453,346,799,
5016,5690,430,322,752,
5019,516,39,30,69,
5021,354,20,21,41,
5022,1536,119,84,203,
5024,5828,481,307,788,
5025,5689,416,323,739,
5026,2418,174,148,322,
5027,157,14,14,28,
5029,347,21,18,39,
5031,5829,437,312,749,
5032,5620,395,363,758,
5033,5767,403,335,738,
5035,2331,148,138,286,
5036,5726,404,319,723,
5038,389,20,19,39,
5039,1179,101,56,157,
5040,1796,137,117,254,
5041,5719,383,327,710,
5043,410,34,25,59,
5044,45,9,2,11,
5045,5920,410,309,719,
5046,4667,372,249,621,
5048,61,3,3,6,
5049,70,3,7,10,
5051,5801,462,316,778,
5052,5821,427,334,761,
5053,940,84,60,144,
5054,253,20,13,33,
5057,5890,451,350,801,
5058,6030,439,343,782,
5060,234,11,15,26,
5061,454,28,31,59,
5062,5963,432,353,785,
5064,2408,176,136,312,
5066,5848,397,350,747,
5068,3187,200,180,380,
5069,1846,121,115,236,
5070,5805,428,348,776,
5071,605,39,37,76,
5072,2376,154,143,297,
5074,6040,486,363,849,
5075,5945,433,363,796,
5076,884,63,52,115,
5077,5870,468,328,796,
5078,6072,460,334,794,
5082,5816,443,292,735,
5083,5801,412,312,724,
5084,1911,117,109,226,
5085,6077,435,333,768,
5086,557,35,33,68,
5087,2517,196,133,329,
5088,5858,417,298,715,
5089,1256,84,88,172,
5091,793,58,60,118,
5092,536,48,19,67,
5093,1047,83,63,146,
5094,5882,409,326,735,
5095,5717,389,289,678,
5096,655,40,36,76,
5097,29,4,3,7,
5098,5892,428,353,781,
5100,173,13,8,21,
5101,4117,323,202,525,
5102,210,16,16,32,
5104,266,18,13,31,
5105,5592,397,359,756,
5106,5617,405,338,743,
5109,5708,366,349,715,
5112,5950,476,356,832,
5113,1320,105,73,178,
5114,238,21,11,32,
5115,5731,419,277,696,
5116,5772,426,333,759,
5117,5944,459,329,788,
5118,5776,423,317,740,
5119,5806,421,353,774,
5120,97,9,5,14,
5121,5813,361,344,705,
5122,347,20,21,41,
5124,1108,77,61,138,
5125,5596,370,354,724,
5127,5931,471,323,794,
5128,831,60,45,105,
5129,4206,322,199,521,
5133,5727,445,325,770,
5135,419,35,25,60,
5136,120,8,5,13,
5137,327,17,19,36,
5138,585,56,29,85,
5139,5787,410,313,723,
5142,5853,406,290,696,
5143,5941,447,320,767,
5145,5796,444,314,758,
5147,5643,393,349,742,
5148,48,4,3,7,
5149,5893,391,355,746,
5151,552,38,42,80,
5152,1481,108,88,196,
5154,5780,391,361,752,
5155,2367,172,142,314,
5156,1133,79,68,147,
5158,188,10,16,26,
5160,1462,113,72,185,
5161,5698,436,322,758,
5162,5742,432,346,778,
5163,5879,424,324,748,
5164,34,2,1,3,
5165,551,38,43,81,
5166,365,33,19,52,
5169,1647,122,97,219,
5171,5959,409,323,732,
5172,5684,392,363,755,
5173,5872,436,304,740,
5175,147,12,7,19,
5176,324,20,14,34,
5177,5867,434,345,779,
5178,2435,187,164,351,
5179,145,8,11,19,
5181,245,17,23,40,
5182,685,41,26,67,
5185,5841,403,327,730,
5187,5676,381,292,673,
5188,324,19,18,37,
5191,4759,367,272,639,
5194,753,61,61,122,
5196,1811,150,103,253,
5198,437,36,19,55,
5199,1936,112,112,224,
5200,5832,426,335,761,
5201,1585,107,91,198,
5202,211,21,13,34,
5204,5886,430,326,756,
5205,5939,444,348,792,
5206,5997,459,333,792,
5207,5798,452,309,761,
5209,5892,419,361,780,
5211,124,5,9,14,
5215,4632,346,237,583,
5216,5845,426,341,767,
5217,5894,380,337,717,
5220,449,29,18,47,
5221,1183,83,73,156,
5222,2390,167,142,309,
5225,5746,419,322,741,
5226,5834,424,348,772,
5227,1489,117,86,203,
5229,5859,414,337,751,
5230,1049,75,66,141,
5231,5940,447,333,780,
5232,5970,400,346,746,
5233,717,45,36,81,
5234,110,8,5,13,
5237,1861,107,101,208,
5238,5869,407,333,740,
5239,5684,441,336,777,
5240,1230,91,59,150,
5241,5785,422,320,742,
5242,6002,433,302,735,
5243,536,46,24,70,
5244,5749,434,332,766,
5245,803,57,40,97,
5247,6021,426,355,781,
5248,5668,378,358,736,
5249,5851,393,335,728,
5250,5858,454,356,810,
5253,694,59,36,95,
5254,5840,397,318,715,
5256,774,62,49,111,
5258,5823,439,320,759,
5259,4838,375,281,656,
5260,6021,428,335,763,
5261,5803,411,332,743,
5263,1892,147,116,263,
5266,3823,286,242,528,
5267,979,87,50,137,
5269,6011,431,345,776,
5270,5959,406,329,735,
5272,5851,421,307,728,
5273,5928,429,333,762,
5276,5490,412,322,734,
5277,5857,452,314,766,
5278,5847,420,293,713,
5280,5800,408,323,731,
5281,37,4,3,7,
5286,5739,395,348,743,
5287,1766,107,111,218,
5288,5930,432,332,764,
5289,5028,359,318,677,
5291,138,11,14,25,
5292,5734,435,314,749,
5293,4016,328,186,514,
5294,5760,418,337,755,
5296,886,58,52,110,
5297,4127,290,240,530,
5298,5714,442,347,789,
5299,2092,160,105,265,
5300,5667,427,342,769,
5302,6014,433,316,749,
5303,839,64,47,111,
5304,2184,170,108,278,
5306,5736,404,312,716,
5307,4277,295,267,562,
5308,5823,446,331,777,
5309,5856,417,334,751,
5310,518,41,23,64,
5312,333,23,21,44,
5317,143,8,11,19,
5318,5796,426,354,780,
5319,765,49,50,99,
5321,5755,386,373,759,
5322,1669,119,93,212,
5324,5799,418,320,738,
5325,1621,120,102,222,
5326,5983,434,353,787,
5328,1282,106,80,186,
5329,5705,388,328,716,
5330,129,10,8,18,
5333,5817,391,363,754,
5334,319,25,15,40,
5335,5852,451,378,829,
5336,2178,143,134,277,
5338,5846,416,324,740,
5341,4598,343,280,623,
5342,886,68,57,125,
5343,5668,409,324,733,
5344,1684,123,90,213,
5345,5931,430,351,781,
5347,5869,393,333,726,
5349,5987,411,344,755,
5350,5836,435,302,737,
5351,4046,295,222,517,
5354,5994,445,359,804,
5355,914,58,59,117,
5356,1358,117,80,197,
5357,5971,457,334,791,
5358,5724,399,352,751,
5359,574,45,37,82,
5361,1665,118,97,215,
5362,5848,407,320,727,
5363,810,52,36,88,
5365,5882,445,314,759,
5368,5932,424,315,739,
5369,5971,441,323,764,
5371,485,26,24,50,
5372,5559,383,321,704,
5373,252,11,14,25,
5374,172,9,6,15,
5376,5805,427,356,783,
5377,5764,409,365,774,
5378,3954,294,242,536,
5380,3753,275,213,488,
5382,5976,428,361,789,
5383,5905,437,325,762,
5384,1507,96,90,186,
5385,5959,443,346,789,
5387,5888,435,340,775,
5388,5628,395,331,726,
5389,5886,510,309,819,
5390,5949,413,382,795,
5392,4574,331,264,595,
5394,5953,478,321,799,
5395,1839,126,99,225,
5396,5794,398,347,745,
5397,953,62,37,99,
5398,5782,429,309,738,
5399,5847,424,296,720,
5400,6008,417,320,737,
5401,5795,423,367,790,
5402,5609,428,330,758,
5403,5714,417,331,748,
5405,1638,130,92,222,
5406,301,22,22,44,
5407,5840,431,311,742,
5408,6053,422,362,784,
5409,1697,162,85,247,
5410,1313,87,81,168,
5411,5791,405,303,708,
5412,5900,417,330,747,
5413,2072,134,101,235,
5414,1556,127,84,211,
5415,178,12,10,22,
5416,5926,433,379,812,
5419,989,88,54,142,
5421,5676,435,300,735,
5422,855,72,35,107,
5426,763,65,39,104,
5429,492,40,28,68,
5431,5853,457,328,785,
5432,5746,409,327,736,
5435,1054,74,72,146,
5437,5797,392,380,772,
5438,5844,366,329,695,
5439,5948,419,357,776,
5440,119,10,10,20,
5441,5744,385,383,768,
5443,1377,96,78,174,
5445,3826,285,194,479,
5446,5899,406,330,736,
5447,5751,445,312,757,
5448,5914,399,341,740,
5449,5923,425,313,738,
5451,1232,92,85,177,
5452,804,69,53,122,
5453,1353,82,83,165,
5455,5908,431,315,746,
5456,5788,393,330,723,
5457,5796,421,326,747,
5459,3477,265,205,470,
5460,5869,412,308,720,
5462,5884,404,337,741,
5463,957,69,62,131,
5464,5743,434,346,780,
5466,1118,97,63,160,
5467,852,64,43,107,
5468,1417,95,86,181,
5469,714,54,40,94,
5470,5842,417,321,738,
5471,1487,106,77,183,
5476,991,72,66,138,
5477,5569,411,322,733,
5478,5648,392,355,747,
5480,813,71,51,122,
5481,5701,399,308,707,
5485,80,5,3,8,
5488,5668,410,322,732,
5489,5888,447,330,777,
5491,5782,426,355,781,
5492,5836,438,329,767,
5493,101,8,6,14,
5494,5756,456,335,791,
5495,1836,135,112,247,
5496,5937,452,346,798,
5497,1414,109,68,177,
5500,5932,438,356,794,
5501,1334,94,69,163,
5502,1993,156,136,292,
5503,1487,108,88,196,
5506,5917,458,348,806,
5507,944,69,46,115,
5508,881,63,37,100,
5509,776,58,40,98,
5510,1504,103,93,196,
5511,5968,436,338,774,
5512,5825,412,323,735,
5513,1043,82,60,142,
5515,5812,402,324,726,
5517,769,57,44,101,
5518,1529,122,75,197,
5519,3584,273,206,479,
5520,5881,398,327,725,
5521,1241,101,63,164,
5522,5869,402,319,721,
5524,340,27,27,54,
5525,5881,448,337,785,
5526,5868,385,349,734,
5528,5688,416,349,765,
5533,5747,436,316,752,
5534,375,20,21,41,
5537,1561,119,108,227,
5538,1368,109,73,182,
5539,1766,141,102,243,
5540,5766,426,337,763,
5541,201,11,12,23,
5543,3684,266,194,460,
5545,2035,160,104,264,
5547,5795,477,298,775,
5549,5819,408,329,737,
5550,4592,359,258,617,
5551,5786,459,309,768,
5552,2777,222,164,386,
5553,207,16,14,30,
5554,5861,449,372,821,
5556,457,32,21,53,
5557,2636,186,146,332,
5559,5905,420,329,749,
5560,5704,440,307,747,
5561,5753,407,345,752,
5564,5603,378,304,682,
5565,4450,364,230,594,
5566,5775,441,307,748,
5567,5889,418,359,777,
5568,5727,476,304,780,
5569,5817,428,354,782,
5570,5942,435,331,766,
5571,5998,442,311,753,
5572,6023,437,385,822,
5573,160,12,4,16,
5574,2389,168,141,309,
5575,40,2,3,5,
5578,430,42,26,68,
5579,5982,388,409,797,
5580,975,78,58,136,
5582,4913,361,270,631,
5583,522,31,29,60,
5584,185,10,20,30,
5586,1289,103,69,172,
5587,32,3,2,5,
5591,5690,427,337,764,
5592,2135,155,111,266,
5593,5688,395,347,742,
5594,5838,446,334,780,
5595,5738,400,334,734,
5596,945,73,47,120,
5597,1222,95,63,158,
5599,898,69,58,127,
5600,5881,399,325,724,
5601,506,27,35,62,
5602,5747,454,335,789,
5603,5942,448,349,797,
5604,5973,421,328,749,
5605,3704,273,227,500,
5606,577,34,32,66,
5607,4111,291,244,535,
5609,1275,81,58,139,
5610,1652,126,101,227,
5611,5945,405,323,728,
5612,5874,406,333,739,
5613,5875,415,326,741,
5614,864,61,44,105,
5615,5892,467,341,808,
5617,5955,429,375,804,
5618,813,70,55,125,
5619,5842,399,326,725,
5620,5831,387,342,729,
5622,5935,456,321,777,
5627,1617,107,81,188,
5628,5889,458,323,781,
5629,5801,396,302,698,
5630,3921,293,214,507,
5631,5865,405,353,758,
5632,5716,440,306,746,
5633,5631,448,283,731,
5635,5840,407,326,733,
5637,455,42,39,81,
5638,5744,440,292,732,
5639,904,58,57,115,
5640,5782,439,335,774,
5642,5813,404,326,730,
5643,5869,427,346,773,
5644,464,24,25,49,
5646,5812,383,352,735,
5647,40,4,2,6,
5651,1880,115,102,217,
5652,131,8,6,14,
5653,308,20,14,34,
5654,854,62,41,103,
5655,5801,416,312,728,
5656,5723,413,295,708,
5657,1649,111,79,190,
5658,4509,278,286,564,
5659,5794,404,344,748,
5660,455,36,23,59,
5661,5675,381,316,697,
5663,1538,119,94,213,
5664,5869,401,346,747,
5665,1989,140,121,261,
5667,5810,389,311,700,
5669,5920,453,312,765,
5670,5977,448,322,770,
5671,5791,370,331,701,
5672,5828,413,307,720,
5673,5792,422,327,749,
5675,1628,126,84,210,
5676,165,11,6,17,
5677,1402,98,70,168,
5678,5878,390,303,693,
5679,5829,432,338,770,
5680,5961,431,315,746,
5684,360,24,21,45,
5685,5782,439,306,745,
5686,4271,317,217,534,
5687,73,8,2,10,
5688,5898,465,340,805,
5689,5813,413,348,761,
5690,5887,413,327,740,
5691,5802,441,310,751,
5694,5834,399,301,700,
5697,5756,394,300,694,
5699,555,31,36,67,
5700,1393,105,70,175,
5702,539,40,33,73,
5704,714,59,41,100,
5705,5843,414,352,766,
5707,5705,393,330,723,
5708,5824,413,351,764,
5710,2111,155,116,271,
5711,5865,391,353,744,
5712,5979,433,344,777,
5713,1901,139,108,247,
5717,5977,407,367,774,
5718,5898,455,343,798,
5720,5771,387,305,692,
5721,5877,406,339,745,
5723,5873,418,345,763,
5724,169,12,11,23,
5725,5922,391,318,709,
5726,1507,121,69,190,
5729,2318,177,107,284,
5730,5872,448,336,784,
5731,5780,458,360,818,
5732,37,4,2,6,
5733,1835,151,106,257,
5734,448,30,26,56,
5736,5758,388,352,740,
5737,5785,401,329,730,
5738,4347,318,252,570,
5740,5872,432,331,763,
5741,36,2,2,4,
5742,364,27,16,43,
5743,5865,409,333,742,
5745,2023,154,111,265,
5746,5740,415,324,739,
5749,5731,414,330,744,
5750,2026,126,112,238,
5751,5837,426,343,769,
5752,5817,436,329,765,
5755,678,56,50,106,
5756,5275,403,250,653,
5757,5818,433,291,724,
5759,5874,455,339,794,
5760,5874,410,335,745,
5761,215,17,13,30,
5762,191,20,11,31,
5765,367,22,19,41,
5767,5795,407,341,748,
5768,932,64,53,117,
5770,5641,390,336,726,
5772,1440,119,72,191,
5774,4556,350,240,590,
5777,5694,424,329,753,
5779,5908,443,357,800,
5780,1297,99,64,163,
5782,5795,391,341,732,
5785,1459,105,83,188,
5786,303,18,18,36,
5789,5706,415,343,758,
5790,918,88,40,128,
5791,5791,422,353,775,
5793,972,78,59,137,
5794,382,27,19,46,
5795,5782,418,317,735,
5796,5784,414,300,714,
5797,5959,420,288,708,
5798,5717,433,281,714,
5799,5665,432,316,748,
5800,5764,451,331,782,
5801,5933,458,337,795,
5802,914,51,56,107,
5803,5979,417,349,766,
5804,1260,88,72,160,
5806,1419,114,78,192,
5808,5960,405,354,759,
5809,5769,439,322,761,
5810,350,29,15,44,
5811,4837,307,300,607,
5812,5662,402,342,744,
5813,5764,357,369,726,
5814,5979,464,323,787,
5816,103,8,8,16,
5817,5742,419,301,720,
5818,1225,76,58,134,
5820,5746,422,360,782,
5821,5873,434,318,752,
5822,5788,456,286,742,
5826,611,52,35,87,
5827,5850,438,340,778,
5829,667,51,32,83,
5830,5935,442,321,763,
5831,1258,76,65,141,
5832,5984,455,329,784,
5833,297,25,15,40,
5834,6026,444,314,758,
5840,121,8,4,12,
5842,258,18,13,31,
5846,1704,141,96,237,
5847,5938,420,354,774,
5850,5860,426,308,734,
5852,5901,454,316,770,
5853,79,8,3,11,
5854,5920,447,328,775,
5856,644,37,29,66,
5857,1388,105,75,180,
5860,492,35,29,64,
5861,4839,367,251,618,
5863,961,61,63,124,
5864,5644,410,321,731,
5865,5746,435,353,788,
5866,31,1,3,4,
5867,1299,113,80,193,
5868,5880,413,314,727,
5869,1147,69,61,130,
5870,626,39,44,83,
5872,5842,412,373,785,
5874,5904,471,320,791,
5875,5939,437,335,772,
5876,1636,117,93,210,
5877,1601,120,85,205,
5880,5740,452,340,792,
5881,5707,430,321,751,
5882,5726,449,297,746,
5883,140,9,10,19,
5884,5836,422,368,790,
5885,5738,444,329,773,
5886,5777,429,326,755,
5887,1429,92,90,182,
5889,1309,97,63,160,
5891,5824,393,308,701,
5892,533,30,30,60,
5893,1764,142,99,241,
5896,965,66,64,130,
5898,69,5,8,13,
5899,486,35,34,69,
5900,5975,432,355,787,
5901,5711,414,336,750,
5902,5917,454,329,783,
5903,5797,393,343,736,
5904,5858,430,302,732,
5905,5849,456,330,786,
5906,5698,371,347,718,
5908,576,35,21,56,
5909,750,65,49,114,
5914,472,33,33,66,
5917,5834,468,314,782,
5918,5906,441,328,769,
5919,3120,220,185,405,
5922,5911,432,323,755,
5924,5691,422,327,749,
5925,5771,459,312,771,
5926,5892,452,335,787,
5927,531,50,41,91,
5929,778,51,42,93,
5931,5701,412,314,726,
5932,5642,380,335,715,
5934,5937,405,334,739,
5935,473,30,31,61,
5936,5763,437,321,758,
5938,5739,414,342,756,
5939,443,34,24,58,
5940,729,58,37,95,
5941,5824,414,337,751,
5942,404,28,21,49,
5944,5834,428,306,734,
5946,4376,325,224,549,
5948,5956,397,358,755,
5949,441,34,23,57,
5950,784,57,33,90,
5952,5967,434,317,751,
5953,313,30,22,52,
5956,2377,168,134,302,
5957,5731,400,308,708,
5958,5877,418,329,747,
5959,6044,440,348,788,
5960,5646,415,360,775,
5961,1490,115,80,195,
5962,645,55,33,88,
5965,421,25,18,43,
5967,5721,399,370,769,
5972,333,24,22,46,
5973,5881,457,327,784,
5974,5766,428,322,750,
5975,139,12,12,24,
5976,615,49,41,90,
5977,5893,421,348,769,
5978,971,75,67,142,
5979,5944,431,334,765,
5981,5980,459,336,795,
5983,872,61,42,103,
5984,5980,439,301,740,
5986,538,29,33,62,
5987,5793,401,335,736,
5988,558,39,28,67,
5989,5729,410,331,741,
5991,4960,305,256,561,
5992,5883,430,315,745,
5993,5742,408,339,747,
5994,5799,455,363,818,
5995,5811,447,329,776,
6002,5976,423,327,750,
6004,498,35,32,67,
6005,1653,117,90,207,
6006,5959,411,330,741,
6008,639,45,33,78,
6011,496,29,23,52,
6014,136,9,8,17,
6016,5803,416,353,769,
6017,5865,379,333,712,
6018,5842,400,345,745,
6019,5816,415,349,764,
6021,5869,449,332,781,
6023,5689,408,340,748,
6024,1501,117,75,192,
6025,5984,440,340,780,
6026,2641,177,136,313,
6027,397,30,24,54,
6031,1387,113,58,171,
6032,5763,412,360,772,
6034,289,24,20,44,
6035,4182,280,230,510,
6037,256,22,13,35,
6038,97,8,8,16,
6040,5839,368,325,693,
6043,5898,434,334,768,
6046,1696,123,114,237,
6047,1477,100,86,186,
6048,5811,388,374,762,
6049,618,39,33,72,
6050,296,24,21,45,
6051,5727,378,377,755,
6052,590,37,28,65,
6054,5937,418,353,771,
6055,4064,318,223,541,
6058,5876,422,315,737,
6059,5799,404,313,717,
6060,959,71,38,109,
6061,3252,225,181,406,
6062,983,81,55,136,
6063,589,52,31,83,
6064,104,13,8,21,
6065,5939,433,351,784,
6066,5778,380,367,747,
6067,78,6,1,7,
6069,871,53,58,111,
6070,5892,409,339,748,
6071,1556,116,80,196,
6072,5806,433,329,762,
6074,5904,439,313,752,
6076,804,65,52,117,
6077,1133,86,79,165,
6078,5979,418,360,778,
6079,967,77,55,132,
6081,5818,398,346,744,
6082,5703,426,334,760,
6085,754,58,48,106,
6087,1624,111,85,196,
6088,827,47,41,88,
6090,784,60,36,96,
6092,4253,303,241,544,
6093,4299,268,248,516,
6096,1374,104,89,193,
6097,5739,411,331,742,
6098,88,3,2,5,
6099,5930,471,327,798,
6100,5685,427,285,712,
6101,5810,409,326,735,
6102,5817,459,349,808,
6103,5884,399,321,720,
6104,87,5,3,8,
6105,5783,408,310,718,
6106,5843,422,325,747,
6107,5710,423,298,721,
6108,202,14,9,23,
6110,1753,134,98,232,
6111,5823,416,352,768,
6112,566,34,25,59,
6114,1225,93,69,162,
6115,675,64,44,108,
6116,5866,410,331,741,
6117,5973,424,331,755,
6119,5767,435,335,770,
6120,603,51,32,83,
6121,5942,455,314,769,
6125,2149,149,125,274,
6127,4828,341,336,677,
6129,1003,60,58,118,
6130,5866,429,355,784,
6131,5836,419,346,765,
6133,482,40,22,62,
6134,5581,369,305,674,
6135,5880,400,364,764,
6136,5851,426,343,769,
6137,1742,145,106,251,
6138,5924,408,331,739,
6142,365,26,28,54,
6143,5762,392,324,716,
6145,5807,413,338,751,
6147,5826,431,312,743,
6149,5926,410,331,741,
6150,1380,97,86,183,
6151,5748,417,304,721,
6152,2047,132,103,235,
6153,5707,398,346,744,
6154,22,1,3,4,
6155,478,33,32,65,
6156,5955,415,354,769,
6157,5819,463,341,804,
6159,609,54,29,83,
6160,260,16,9,25,
6161,1717,128,97,225,
6164,1586,114,63,177,
6165,5906,450,324,774,
6166,744,68,35,103,
6167,673,62,41,103,
6168,1345,91,82,173,
6169,5958,444,356,800,
6170,5876,408,327,735,
6171,2400,186,140,326,
6173,1269,88,79,167,
6174,5968,448,325,773,
6177,1506,95,80,175,
6179,5836,414,369,783,
6180,5776,456,300,756,
6182,1775,120,105,225,
6183,4028,289,246,535,
6184,5733,397,331,728,
6186,2319,188,126,314,
6187,5854,434,328,762,
6188,5820,441,334,775,
6190,686,43,41,84,
6191,1475,109,65,174,
6194,399,37,25,62,
6196,1669,114,101,215,
6198,918,56,32,88,
6200,5864,405,362,767,
6201,168,15,15,30,
6202,5777,457,346,803,
6204,4203,298,279,577,
6206,5727,432,351,783,
6209,344,21,16,37,
6210,5946,432,339,771,
6212,5854,422,327,749,
6214,5839,399,364,763,
6215,1294,96,76,172,
6217,1414,90,76,166,
6218,853,71,49,120,
6220,3319,207,208,415,
6221,3086,207,174,381,
6222,5827,418,336,754,
6225,5915,438,327,765,
6227,5835,457,335,792,
6228,5210,410,273,683,
6229,514,35,32,67,
6230,5708,414,314,728,
6232,5867,457,317,774,
6233,660,51,32,83,
6234,5746,394,323,717,
6236,5782,390,346,736,
6237,156,14,8,22,
6238,78,6,3,9,
6239,1306,96,64,160,
6241,184,12,7,19,
6242,5859,435,324,759,
6244,5758,425,310,735,
6245,144,19,13,32,
6248,5649,407,321,728,
6249,204,22,7,29,
6250,161,13,11,24,
6255,5864,422,327,749,
6257,2296,154,145,299,
6258,313,23,18,41,
6259,1642,121,99,220,
6260,5911,400,333,733,
6261,739,53,42,95,
6263,1353,79,85,164,
6264,5916,442,353,795,
6265,5743,388,343,731,
6269,2896,209,135,344,
6270,1586,106,78,184,
6271,5914,427,326,753,
6273,5869,444,348,792,
6274,5898,389,341,730,
6275,2028,159,125,284,
6276,5692,453,343,796,
6277,728,57,55,112,
6278,151,5,6,11,
6279,5935,444,341,785,
6281,957,68,49,117,
6284,22,2,1,3,
6285,5898,455,317,772,
6287,5888,448,353,801,
6288,3105,220,173,393,
6289,1129,77,73,150,
6290,1480,116,74,190,
6291,5885,421,307,728,
6293,5947,418,351,769,
6294,5729,429,317,746,
6295,6033,438,359,797,
6296,1416,100,72,172,
6297,5557,405,350,755,
6299,5905,424,369,793,
6300,116,12,6,18,
6301,5857,464,328,792,
6303,5913,464,337,801,
6305,5819,417,338,755,
6307,5744,459,305,764,
6308,5790,403,327,730,
6309,1532,121,109,230,
6310,4373,325,245,570,
6311,5733,429,368,797,
6313,5830,435,335,770,
6314,881,44,49,93,
6317,5772,403,345,748,
6318,704,61,43,104,
6319,5760,387,352,739,
6320,6023,432,327,759,
6321,5719,393,355,748,
6322,5801,443,318,761,
6323,1519,121,85,206,
6324,1742,98,115,213,
6326,5657,423,347,770,
6327,1681,117,91,208,
6328,1672,130,112,242,
6329,5741,395,314,709,
6330,5885,395,371,766,
6331,5886,432,332,764,
6332,5888,408,314,722,
6333,5818,417,347,764,
6335,5888,423,352,775,
6337,1893,134,88,222,
6340,5719,412,315,727,
6341,5853,413,363,776,
6342,1503,104,78,182,
6343,5857,403,332,735,
6344,5829,457,311,768,
6345,588,38,38,76,
6347,531,40,27,67,
6349,1581,113,79,192,
6350,3471,260,199,459,
6352,4611,314,272,586,
6353,5751,428,321,749,
6354,5760,363,325,688,
6356,5929,455,361,816,
6357,1648,134,89,223,
6360,5694,408,322,730,
6361,214,12,9,21,
6364,6006,424,323,747,
6367,5800,414,344,758,
6368,1867,119,122,241,
6369,5762,425,330,755,
6370,681,51,33,84,
6372,5749,392,336,728,
6373,56,4,3,7,
6376,1002,58,60,118,
6377,4100,290,240,530,
6378,99,8,6,14,
6379,5843,494,312,806,
6381,5786,437,323,760,
6382,1445,100,93,193,
6384,5885,479,349,828,
6385,5830,423,305,728,
6386,238,25,9,34,
6387,1074,84,64,148,
6388,5967,421,350,771,
6390,5954,400,320,720,
6391,679,32,38,70,
6392,144,11,4,15,
6393,2508,156,156,312,
6394,475,31,15,46,
6396,5938,441,308,749,
6397,704,43,43,86,
6398,655,52,35,87,
6399,5893,405,339,744,
6401,1139,86,60,146,
6403,1220,97,66,163,
6404,779,58,44,102,
6405,608,36,37,73,
6406,5809,444,317,761,
6407,1361,98,73,171,
6408,5870,406,353,759,
6410,282,13,26,39,
6411,6007,445,349,794,
6412,5835,432,303,735,
6413,612,44,37,81,
6414,2283,163,149,312,
6415,1767,120,108,228,
6416,5705,386,283,669,
6419,1234,80,65,145,
6421,1154,84,75,159,
6422,5915,448,346,794,
6423,103,10,5,15,
6424,920,63,58,121,
6425,1291,95,70,165,
6428,4569,310,260,570,
6430,5939,414,327,741,
6431,143,13,14,27,
6432,5819,435,356,791,
6433,52,3,2,5,
6436,150,9,5,14,
6437,647,33,37,70,
6438,5793,422,349,771,
6439,1603,110,109,219,
6440,2486,187,144,331,
6441,5853,516,311,827,
6442,5727,419,322,741,
6444,6061,430,363,793,
6446,1391,133,85,218,
6447,3330,260,177,437,
6448,5938,471,318,789,
6452,5752,383,337,720,
6453,3121,242,178,420,
6454,5710,426,333,759,
6455,677,65,48,113,
6457,5715,398,346,744,
6458,5553,379,311,690,
6460,292,18,19,37,
6461,569,41,36,77,
6462,1761,122,94,216,
6465,5842,407,353,760,
6466,5848,383,365,748,
6468,4130,305,252,557,
6469,2401,182,150,332,
6471,5909,462,297,759,
6472,173,8,8,16,
6476,5908,463,314,777,
6477,5783,459,309,768,
6478,5900,448,356,804,
6479,5847,399,327,726,
6481,5858,406,328,734,
6482,5877,416,318,734,
6485,5770,449,293,742,
6487,828,65,43,108,
6489,763,54,43,97,
6490,1730,109,90,199,
6491,579,44,33,77,
6492,97,3,8,11,
6494,173,7,10,17,
6495,2416,171,136,307,
6496,5908,433,300,733,
6497,2381,185,148,333,
6499,5924,411,347,758,
6500,5846,432,349,781,
6501,63,2,5,7,
6503,5698,343,324,667,
6504,1777,121,109,230,
6505,5408,377,275,652,
6507,5720,420,321,741,
6509,5963,400,319,719,
6511,5775,435,320,755,
6512,151,10,10,20,
6513,5912,399,356,755,
6514,4175,334,230,564,
6515,741,56,57,113,
6517,5860,436,321,757,
6519,5992,435,350,785,
6521,476,42,32,74,
6523,1695,140,100,240,
6524,1499,112,98,210,
6525,531,41,28,69,
6526,906,81,49,130,
6527,5820,387,358,745,
6529,5801,417,360,777,
6531,183,13,14,27,
6532,414,28,28,56,
6534,5663,384,312,696,
6535,5915,470,321,791,
6537,5835,388,361,749,
6538,5763,432,322,754,
6539,752,61,42,103,
6542,5871,427,352,779,
6546,5912,419,324,743,
6548,5904,443,346,789,
6549,5855,397,337,734,
6550,4237,317,252,569,
6552,5654,408,290,698,
6553,5890,423,351,774,
6554,1913,144,110,254,
6555,2511,191,137,328,
6556,1190,99,60,159,
6557,1253,95,71,166,
6558,2777,179,163,342,
6559,5851,444,340,784,
6560,1545,115,70,185,
6561,5934,412,352,764,
6562,1523,96,92,188,
6564,5043,376,268,644,
6568,529,29,47,76,
6569,5776,425,304,729,
6571,5687,401,309,710,
6572,835,64,44,108,
6573,1473,102,83,185,
6574,853,56,49,105,
6577,5709,456,275,731,
6578,5803,464,345,809,
6579,5657,400,355,755,
6580,5911,437,333,770,
6582,1632,119,93,212,
6583,5791,398,351,749,
6584,145,14,10,24,
6587,46,2,1,3,
6588,5781,409,322,731,
6589,5873,425,325,750,
6590,5918,439,345,784,
6592,979,74,62,136,
6593,5741,418,322,740,
6594,4368,303,254,557,
6599,2286,176,129,305,
6601,1016,78,66,144,
6602,5778,400,326,726,
6604,1167,74,64,138,
6606,5997,475,352,827,
6607,1435,110,83,193,
6608,1817,124,112,236,
6609,6014,439,319,758,
6611,5870,440,312,752,
6612,5877,449,343,792,
6614,5858,418,310,728,
6615,5827,396,345,741,
6616,5823,436,340,776,
6618,144,10,3,13,
6619,518,36,35,71,
6620,1253,102,64,166,
6621,5784,428,329,757,
6622,5804,427,331,758,
6624,796,52,38,90,
6626,6063,431,324,755,
6630,5677,416,343,759,
6631,6047,445,345,790,
6634,5796,396,338,734,
6635,310,24,18,42,
6636,960,81,69,150,
6640,5818,452,366,818,
6641,843,56,42,98,
6644,5799,461,334,795,
6645,381,20,19,39,
6647,547,48,30,78,
6649,5872,459,353,812,
6650,5667,379,320,699,
6651,1839,132,121,253,
6652,5886,403,316,719,
6653,5762,389,349,738,
6654,4713,366,247,613,
6655,5851,426,315,741,
6658,6015,425,355,780,
6661,357,24,18,42,
6662,5864,425,346,771,
6663,5839,442,328,770,
6664,5800,444,314,758,
6665,5773,468,276,744,
6666,1200,88,62,150,
6669,5814,470,336,806,
6670,5826,377,343,720,
6671,5715,464,299,763,
6672,5680,379,306,685,
6677,358,21,24,45,
6678,280,23,7,30,
6679,5920,416,332,748,
6680,1288,111,61,172,
6681,1851,140,104,244,
6682,201,11,14,25,
6684,913,75,64,139,
6685,153,15,7,22,
6687,5865,381,337,718,
6688,587,45,33,78,
6689,5855,427,347,774,
6690,1594,132,80,212,
6693,998,68,63,131,
6694,5863,421,319,740,
6695,1003,81,53,134,
6696,5669,397,298,695,
6698,1993,122,110,232,
6699,931,68,62,130,
6701,1715,138,97,235,
6704,1353,95,64,159,
6705,5901,436,324,760,
6707,1062,79,56,135,
6709,5789,429,350,779,
6710,2334,192,153,345,
6712,409,26,25,51,
6713,5680,393,318,711,
6714,1830,131,96,227,
6715,528,31,31,62,
6716,311,25,22,47,
6717,5916,434,336,770,
6718,5727,403,297,700,
6720,1554,113,93,206,
6722,252,21,9,30,
6723,1437,108,75,183,
6725,314,38,21,59,
6727,5636,368,309,677,
6728,1786,120,102,222,
6730,5739,423,325,748,
6731,5874,410,327,737,
6732,498,31,24,55,
6733,5858,396,290,686,
6734,5899,421,342,763,
6737,5887,383,347,730,
6738,1259,92,76,168,
6740,5805,381,391,772,
6741,5894,418,339,757,
6743,4864,361,269,630,
6744,6033,439,315,754,
6746,5745,428,290,718,
6747,5858,471,341,812,
6751,5682,407,328,735,
6754,405,34,31,65,
6755,5798,386,310,696,
6756,4003,275,251,526,
6757,5926,417,361,778,
6758,4388,316,249,565,
6760,6086,468,367,835,
6761,5772,417,326,743,
6762,5842,402,299,701,
6763,5826,426,346,772,
6764,4341,265,261,526,
6766,480,27,25,52,
6767,1504,109,85,194,
6770,1278,84,77,161,
6771,5707,387,333,720,
6772,387,35,20,55,
6773,5777,390,296,686,
6774,5815,438,356,794,
6775,3254,261,186,447,
6776,5831,416,344,760,
6777,5210,376,299,675,
6779,1871,138,106,244,
6784,4041,256,223,479,
6785,5796,415,305,720,
6786,6024,453,357,810,
6789,5896,399,324,723,
6790,2921,206,170,376,
6791,2071,151,130,281,
6792,5701,429,306,735,
6794,312,26,21,47,
6795,5781,392,346,738,
6797,2699,184,164,348,
6800,5910,426,297,723,
6805,5799,409,327,736,
6806,5755,443,329,772,
6807,127,13,14,27,
6808,5896,396,326,722,
6809,5940,457,347,804,
6812,542,44,27,71,
6815,128,10,7,17,
6816,5855,420,376,796,
6818,448,27,29,56,
6820,5819,441,321,762,
6822,2049,160,121,281,
6823,168,10,10,20,
6824,5670,377,322,699,
6825,5808,415,326,741,
6826,441,35,22,57,
6827,1001,69,60,129,
6828,5720,429,334,763,
6830,1321,106,83,189,
6832,393,24,22,46,
6834,1641,139,93,232,
6835,5952,444,357,801,
6838,5732,431,311,742,
6839,5873,425,329,754,
6840,5928,427,316,743,
6841,5829,421,357,778,
6843,5844,397,329,726,
6844,291,19,14,33,
6846,466,40,41,81,
6848,849,64,44,108,
6849,5968,446,334,780,
6850,5820,400,357,757,
6854,5863,400,342,742,
6855,5923,449,299,748,
6856,5776,407,348,755,
6857,5828,437,337,774,
6858,208,12,14,26,
6859,5860,375,336,711,
6860,5797,455,335,790,
6862,503,34,37,71,
6863,490,42,28,70,
6864,48,5,3,8,
6865,5861,397,345,742,
6867,31,3,2,5,
6868,551,38,33,71,
6869,815,66,42,108,
6870,5778,404,296,700,
6873,5802,418,380,798,
6874,181,20,8,28,
6875,5760,434,305,739,
6876,5745,415,325,740,
6877,391,22,30,52,
6878,5824,401,336,737,
6879,4864,358,268,626,
6880,1074,89,59,148,
6881,5701,445,305,750,
6883,5799,439,316,755,
6884,5991,436,337,773,
6885,14,1,1,2,
6887,2705,192,143,335,
6888,1359,97,85,182,
6889,817,56,49,105,
6891,4135,269,220,489,
6892,5845,506,298,804,
6893,761,58,47,105,
6895,5660,435,274,709,
6896,604,40,43,83,
6897,997,69,62,131,
6898,5913,443,325,768,
6901,1940,146,107,253,
6902,5959,437,338,775,
6905,3124,231,202,433,
6906,5853,424,334,758,
6908,5897,460,352,812,
6909,6004,434,299,733,
6913,5739,422,339,761,
6914,5885,423,346,769,
6916,5842,448,316,764,
6917,5790,427,332,759,
6918,5896,417,298,715,
6919,5487,332,301,633,
6920,5775,440,338,778,
6922,240,15,12,27,
6923,183,24,6,30,
6924,1315,97,78,175,
6925,1477,119,87,206,
6926,5767,424,302,726,
6928,5866,372,298,670,
6929,5700,392,337,729,
6931,610,44,43,87,
6933,1563,139,74,213,
6934,5858,440,321,761,
6935,484,36,35,71,
6938,5660,421,354,775,
6939,1776,145,100,245,
6941,5760,408,325,733,
6942,883,73,46,119,
6943,68,4,3,7,
6946,1679,127,98,225,
6949,5880,422,336,758,
6950,4772,330,264,594,
6953,5882,415,353,768,
6954,5838,386,352,738,
6955,1046,62,65,127,
6956,2129,159,121,280,
6958,5817,443,331,774,
6959,250,25,14,39,
6960,1651,143,88,231,
6961,5701,441,312,753,
6963,5916,444,321,765,
6964,2565,193,136,329,
6965,5785,419,343,762,
6966,5788,414,325,739,
6971,5919,434,315,749,
6974,4071,322,212,534,
6976,1554,110,78,188,
6978,535,34,26,60,
6980,5811,411,335,746,
6981,794,53,40,93,
6982,5883,422,339,761,
6983,2678,202,125,327,
6984,1682,127,95,222,
6985,5724,457,307,764,
6986,5932,408,346,754,
6987,5883,409,345,754,
6992,5693,389,341,730,
6993,5616,415,308,723,
6996,1843,136,113,249,
6997,5858,418,347,765,
6998,1477,110,81,191,
7000,939,65,51,116,
7001,5772,434,309,743,
7002,5968,445,350,795,
7003,834,67,51,118,
7004,134,15,7,22,
7005,743,62,43,105,
7006,5940,440,327,767,
7007,5885,427,329,756,
7008,5777,424,330,754,
7009,5917,408,338,746,
7010,1687,117,93,210,
7015,6010,419,344,763,
7016,5826,428,314,742,
7018,317,31,21,52,
7019,5724,413,333,746,
7024,223,13,5,18,
7025,866,62,48,110,
7026,1606,126,105,231,
7028,5814,403,352,755,
7034,355,18,25,43,
7036,5933,434,305,739,
7039,1586,121,98,219,
7040,5920,392,359,751,
7041,453,34,21,55,
7043,936,67,47,114,
7045,5774,418,317,735,
7048,5587,400,297,697,
7049,5866,456,328,784,
7050,5794,417,325,742,
7053,5624,466,285,751,
7056,6098,483,332,815,
7057,5819,426,325,751,
7058,5949,397,361,758,
7059,206,12,15,27,
7061,5810,422,333,755,
7062,5742,397,330,727,
7063,5826,375,384,759,
7064,5880,419,380,799,
7067,5834,425,346,771,
7068,121,4,9,13,
7069,5861,446,310,756,
7070,342,22,21,43,
7071,257,18,17,35,
7072,5828,430,349,779,
7073,1669,125,91,216,
7075,5758,409,367,776,
7077,123,6,9,15,
7078,5841,436,318,754,
7079,5783,448,322,770,
7080,5928,451,328,779,
7081,5939,435,346,781,
7082,5772,463,313,776,
7084,5688,406,348,754,
7085,5780,407,337,744,
7086,5716,432,306,738,
7088,5836,436,352,788,
7090,5751,402,339,741,
7091,4755,295,305,600,
7092,5908,408,313,721,
7093,129,6,6,12,
7095,143,8,9,17,
7096,639,46,44,90,
7097,5736,450,317,767,
7099,102,7,9,16,
7100,723,52,50,102,
7101,5800,399,316,715,
7103,5926,442,359,801,
7104,148,13,11,24,
7105,721,55,35,90,
7106,2978,211,197,408,
7107,377,30,16,46,
7108,5898,431,340,771,
7109,278,19,13,32,
7110,4716,379,231,610,
7111,5920,445,352,797,
7115,40,4,3,7,
7116,4389,319,284,603,
7117,5761,396,403,799,
7119,516,40,23,63,
7120,798,61,47,108,
7121,5961,414,341,755,
7122,5244,361,307,668,
7123,785,61,52,113,
7124,4512,362,249,611,
7128,29,2,1,3,
7130,1476,123,79,202,
7131,5903,423,325,748,
7132,2024,158,106,264,
7135,5819,431,323,754,
7136,2085,162,120,282,
7137,5925,420,319,739,
7138,307,17,21,38,
7139,1547,127,78,205,
7143,5643,440,320,760,
7144,1458,99,93,192,
7145,2361,174,158,332,
7146,5725,433,337,770,
7148,2682,196,150,346,
7151,435,39,27,66,
7152,633,49,29,78,
7153,1811,163,93,256,
7161,5898,418,334,752,
7163,5896,447,311,758,
7165,5814,424,364,788,
7167,5731,414,320,734,
7168,5978,441,303,744,
7169,367,14,26,40,
7170,5928,420,354,774,
7171,385,33,16,49,
7172,1516,93,96,189,
7174,5914,417,325,742,
7177,759,43,37,80,
7180,5654,405,310,715,
7181,1527,94,86,180,
7183,1240,85,66,151,
7185,1988,149,111,260,
7187,5744,450,310,760,
7188,5853,438,336,774,
7190,1796,125,112,237,
7191,5855,438,371,809,
7196,5814,427,323,750,
7197,5859,415,358,773,
7198,5912,427,338,765,
7199,401,11,24,35,
7200,336,24,22,46,
7201,1868,113,89,202,
7203,574,43,34,77,
7205,140,9,5,14,
7206,5690,391,342,733,
7210,272,22,20,42,
7211,5769,458,301,759,
7213,936,61,69,130,
7215,5838,426,353,779,
7217,813,52,45,97,
7219,1341,102,86,188,
7221,234,30,14,44,
7225,590,38,29,67,
7226,1490,98,83,181,
7227,89,5,4,9,
7228,796,64,36,100,
7229,226,19,21,40,
7231,1173,75,64,139,
7232,5721,424,352,776,
7233,343,20,17,37,
7235,5842,369,357,726,
7238,1777,115,104,219,
7239,5770,415,285,700,
7240,5715,405,302,707,
7241,311,22,21,43,
7242,5754,415,332,747,
7243,3479,270,166,436,
7249,4078,330,218,548,
7255,5874,439,351,790,
7258,5818,431,333,764,
7259,736,47,37,84,
7261,1992,142,111,253,
7264,5774,407,356,763,
7266,682,51,31,82,
7267,1169,74,69,143,
7268,2035,137,121,258,
7269,5920,445,331,776,
7270,963,74,63,137,
7272,5940,442,331,773,
7273,533,29,38,67,
7274,2069,161,98,259,
7277,5874,439,390,829,
7278,172,12,11,23,
7279,156,20,4,24,
7280,703,38,33,71,
7281,1548,120,75,195,
7282,5929,420,356,776,
7283,1254,85,72,157,
7284,5582,403,327,730,
7285,5915,445,323,768,
7286,5908,425,313,738,
7288,4501,389,258,647,
7290,1680,144,108,252,
7291,560,37,36,73,
7292,5666,420,324,744,
7294,1766,129,102,231,
7295,5846,500,344,844,
7296,1848,136,102,238,
7297,5723,395,356,751,
7300,5854,454,340,794,
7302,5872,425,337,762,
7303,5845,419,322,741,
7306,1569,109,76,185,
7307,3496,242,194,436,
7308,5884,437,333,770,
7309,1109,84,53,137,
7310,1645,117,98,215,
7311,592,46,27,73,
7313,5976,445,321,766,
7315,1836,128,116,244,
7316,1344,86,71,157,
7317,5879,410,346,756,
7318,913,62,55,117,
7320,5948,414,333,747,
7324,916,65,75,140,
7326,5881,417,351,768,
7327,613,41,39,80,
7328,1333,99,76,175,
7329,1734,154,87,241,
7330,355,30,21,51,
7331,5897,444,349,793,
7332,1600,103,79,182,
7333,1416,132,98,230,
7335,352,31,29,60,
7336,5854,425,311,736,
7337,5806,403,276,679,
7338,1938,103,110,213,
7340,163,8,10,18,
7341,5754,409,308,717,
7342,5808,385,319,704,
7343,5191,373,278,651,
7344,1735,119,102,221,
7346,651,47,42,89,
7347,959,72,77,149,
7348,5846,461,316,777,
7349,1610,126,106,232,
7356,5844,396,330,726,
7359,5888,471,303,774,
7360,1797,142,91,233,
7363,860,60,48,108,
7364,5704,334,328,662,
7366,6000,419,344,763,
7367,564,37,33,70,
7368,5800,416,330,746,
7369,2492,183,137,320,
7370,5826,436,320,756,
7371,5893,464,335,799,
7372,5908,435,337,772,
7375,5808,417,312,729,
7376,5948,418,328,746,
7377,5790,424,344,768,
7378,1033,73,53,126,
7380,5710,394,299,693,
7385,5721,440,320,760,
7386,5657,408,353,761,
7388,720,50,47,97,
7390,84,7,8,15,
7394,5722,415,332,747,
7396,5942,454,348,802,
7397,1007,78,57,135,
7399,5814,433,345,778,
7400,6018,453,345,798,
7401,1428,86,89,175,
7402,665,55,31,86,
7403,5897,476,306,782,
7404,5901,447,360,807,
7405,1602,124,94,218,
7406,5827,415,334,749,
7407,3915,288,207,495,
7408,180,15,10,25,
7411,5730,469,273,742,
7412,5862,427,367,794,
7413,5839,424,310,734,
7416,5824,442,380,822,
7417,5835,407,308,715,
7418,5878,389,346,735,
7420,1907,139,115,254,
7421,1229,91,64,155,
7422,89,7,3,10,
7423,5884,390,347,737,
7425,1463,106,80,186,
7426,5788,445,306,751,
7427,164,16,9,25,
7428,475,22,22,44,
7429,5892,406,337,743,
7430,5807,457,282,739,
7431,1395,111,73,184,
7432,1410,109,83,192,
7433,5787,419,318,737,
7436,1758,120,97,217,
7437,5778,435,316,751,
7438,1473,108,82,190,
7439,5886,440,321,761,
7440,1704,133,78,211,
7442,5785,416,332,748,
7443,5848,422,304,726,
7444,5865,438,351,789,
7447,240,10,6,16,
7448,1284,82,73,155,
7449,5913,441,356,797,
7452,1499,119,78,197,
7453,5821,410,342,752,
7454,99,10,6,16,
7455,266,21,11,32,
7456,5833,444,326,770,
7457,5680,384,320,704,
7459,275,14,17,31,
7460,1189,86,67,153,
7462,5786,449,312,761,
7464,162,13,8,21,
7465,5794,441,325,766,
7467,5710,435,360,795,
7468,72,7,6,13,
7470,5768,444,287,731,
7473,5824,397,339,736,
7474,2487,202,140,342,
7477,5786,380,340,720,
7478,406,30,23,53,
7481,2548,190,158,348,
7482,1169,78,64,142,
7483,655,56,39,95,
7485,5683,428,337,765,
7486,5885,458,356,814,
7487,5927,429,344,773,
7488,5751,426,284,710,
7491,5855,438,335,773,
7492,5841,427,360,787,
7493,5814,394,336,730,
7494,1287,123,65,188,
7495,5856,431,352,783,
7496,5750,429,314,743,
7497,5792,412,317,729,
7500,1116,82,67,149,
7501,5758,409,385,794,
7502,5950,430,369,799,
7504,159,11,10,21,
7505,5750,397,343,740,
7506,5873,470,322,792,
7507,5899,411,336,747,
7511,1195,93,68,161,
7515,1705,121,89,210,
7516,5892,424,333,757,
7518,5843,405,303,708,
7519,5918,352,342,694,
7520,5861,454,342,796,
7522,3960,310,199,509,
7523,1769,129,109,238,
7524,5967,413,334,747,
7526,295,19,22,41,
7527,5829,422,304,726,
7528,5775,475,301,776,
7529,1160,92,58,150,
7530,5971,434,323,757,
7531,5729,382,343,725,
7532,5808,442,350,792,
7533,5775,425,320,745,
7536,5876,382,345,727,
7538,5940,392,331,723,
7539,5819,411,330,741,
7540,5879,444,356,800,
7541,5823,411,318,729,
7543,5736,389,328,717,
7544,5918,406,344,750,
7545,5895,442,361,803,
7547,570,38,41,79,
7549,5794,417,307,724,
7550,5757,446,306,752,
7552,297,21,17,38,
7553,3340,229,195,424,
7554,974,69,66,135,
7556,5798,418,360,778,
7557,5747,437,312,749,
7558,4460,306,255,561,
7559,453,35,21,56,
7560,5782,417,318,735,
7561,5783,414,318,732,
7562,714,39,49,88,
7563,3737,258,188,446,
7564,5878,383,369,752,
7565,5845,419,343,762,
7566,2939,242,187,429,
7567,509,36,30,66,
7570,5875,410,330,740,
7571,1895,130,93,223,
7572,198,13,10,23,
7573,5824,434,326,760,
7577,5769,411,307,718,
7578,529,37,21,58,
7579,209,15,15,30,
7580,5874,402,333,735,
7581,5901,401,320,721,
7582,5763,424,348,772,
7583,5847,442,323,765,
7584,182,18,6,24,
7587,5856,432,340,772,
7590,918,71,57,128,
7592,1697,148,76,224,
7593,5846,411,341,752,
7594,4535,288,281,569,
7595,1885,147,114,261,
7596,5792,403,351,754,
7598,4194,294,262,556,
7599,5848,470,333,803,
7601,1128,87,59,146,
7603,344,28,21,49,
7604,3800,240,232,472,
7606,5755,419,309,728,
7607,2806,214,157,371,
7608,5809,420,340,760,
7609,579,42,34,76,
7610,892,73,46,119,
7611,5829,484,331,815,
7612,1660,110,90,200,
7613,1332,88,80,168,
7614,5845,418,313,731,
7615,1364,85,88,173,
7616,597,40,38,78,
7617,5779,420,342,762,
7618,96,2,2,4,
7621,5784,412,315,727,
7622,5791,425,342,767,
7625,5888,433,351,784,
7626,5776,400,305,705,
7627,5809,419,345,764,
7628,5924,426,333,759,
7629,2382,186,144,330,
7631,792,77,46,123,
7634,5693,429,283,712,
7635,5726,443,307,750,
7636,5904,425,347,772,
7638,1868,131,107,238,
7642,5801,427,300,727,
7645,750,49,48,97,
7648,5856,409,360,769,
7649,5747,408,330,738,
7650,5901,412,351,763,
7652,5865,434,339,773,
7653,5858,396,322,718,
7655,4394,341,260,601,
7656,871,71,44,115,
7658,2522,215,137,352,
7659,5889,431,354,785,
7661,5812,387,325,712,
7664,5737,393,358,751,
7665,1396,107,86,193,
7666,5896,435,312,747,
7667,4653,343,281,624,
7669,5806,437,325,762,
7670,1403,86,71,157,
7671,791,48,35,83,
7673,159,19,9,28,
7675,5561,385,358,743,
7676,5756,416,314,730,
7677,3411,267,177,444,
7678,5889,424,322,746,
7679,5601,362,329,691,
7680,5752,487,305,792,
7681,5777,433,306,739,
7685,1618,117,90,207,
7686,288,17,17,34,
7688,3997,261,206,467,
7689,10,1,1,2,
7692,5867,405,328,733,
7693,5692,461,313,774,
7694,5540,385,361,746,
7700,5875,456,345,801,
7701,5875,442,318,760,
7702,742,57,50,107,
7705,5843,414,331,745,
7707,1501,114,87,201,
7708,5870,436,323,759,
7710,5836,415,307,722,
7711,390,39,16,55,
7712,268,25,8,33,
7713,5696,418,315,733,
7715,5884,386,336,722,
7716,5706,391,348,739,
7717,5863,425,320,745,
7718,62,8,5,13,
7719,1531,130,87,217,
7720,627,52,41,93,
7725,5796,424,304,728,
7727,575,41,25,66,
7728,630,44,46,90,
7729,5823,450,335,785,
7730,1207,91,68,159,
7731,5898,406,326,732,
7733,13,1,1,2,
7735,2833,207,162,369,
7736,5791,406,329,735,
7737,5833,397,339,736,
7739,1824,134,103,237,
7742,5822,422,354,776,
7744,5934,482,314,796,
7745,164,11,7,18,
7746,5748,424,307,731,
7750,5947,419,308,727,
7751,5731,446,324,770,
7755,150,12,7,19,
7756,5894,408,324,732,
7757,1968,124,117,241,
7759,5701,416,346,762,
7760,670,41,31,72,
7762,1731,138,97,235,
7766,3947,257,228,485,
7767,5693,395,277,672,
7768,290,16,15,31,
7769,4116,332,209,541,
7771,3949,291,241,532,
7775,1752,114,94,208,
7776,173,18,9,27,
7777,5684,404,331,735,
7779,4240,304,242,546,
7780,21,2,2,4,
7781,3916,264,212,476,
7783,190,11,14,25,
7789,841,63,49,112,
7790,5966,421,343,764,
7792,5796,405,324,729,
7794,5914,423,359,782,
7796,449,36,31,67,
7797,1768,97,108,205,
7798,208,16,8,24,
7799,5663,399,304,703,
7800,5902,420,373,793,
7801,5648,462,338,800,
7802,1290,99,80,179,
7803,5794,413,326,739,
7806,348,33,24,57,
7807,1137,78,60,138,
7808,5779,421,278,699,
7809,311,20,21,41,
7812,5685,416,336,752,
7815,317,11,19,30,
7816,5827,372,314,686,
7817,568,36,36,72,
7818,4266,313,214,527,
7819,5802,450,336,786,
7820,1496,109,93,202,
7821,5909,413,317,730,
7822,5697,388,312,700,
7823,1069,80,46,126,
7824,993,64,54,118,
7826,5830,425,331,756,
7827,5846,456,306,762,
7828,5887,412,341,753,
7829,329,23,14,37,
7830,5845,393,362,755,
7831,5860,432,296,728,
7832,5839,447,311,758,
7833,1026,77,61,138,
7834,5911,440,296,736,
7835,1109,75,64,139,
7836,2120,147,95,242,
7837,78,3,4,7,
7838,1294,99,64,163,
7839,4148,251,227,478,
7840,302,20,15,35,
7841,5866,407,346,753,
7843,1308,90,68,158,
7844,1225,81,63,144,
7845,3498,273,199,472,
7846,1912,159,110,269,
7847,5902,384,347,731,
7848,5692,408,309,717,
7851,5700,480,317,797,
7852,5798,424,338,762,
7855,5709,363,356,719,
7856,319,17,13,30,
7857,5857,400,381,781,
7858,5892,459,319,778,
7860,391,35,15,50,
7861,1735,135,92,227,
7862,5701,396,320,716,
7863,708,40,42,82,
7864,614,41,43,84,
7865,5883,423,375,798,
7867,3373,256,184,440,
7868,5847,440,331,771,
7869,5968,449,340,789,
7870,1940,133,110,243,
7871,5911,415,347,762,
7872,5818,402,341,743,
7873,2137,153,112,265,
7875,5898,400,328,728,
7876,5598,355,323,678,
7877,5818,457,263,720,
7878,5955,395,311,706,
7879,5916,432,331,763,
7880,5781,426,317,743,
7882,180,14,5,19,
7885,5942,452,332,784,
7887,1763,135,88,223,
7889,5819,408,359,767,
7890,217,9,14,23,
7891,587,46,37,83,
7893,686,56,48,104,
7894,5877,404,334,738,
7895,5839,441,312,753,
7897,466,41,25,66,
7898,5942,432,354,786,
7899,4075,308,229,537,
7900,437,36,27,63,
7901,5820,431,300,731,
7905,1374,99,57,156,
7907,5836,432,347,779,
7912,5794,383,342,725,
7913,5944,442,350,792,
7916,447,36,22,58,
7917,5618,417,337,754,
7919,5883,393,351,744,
7920,1410,103,75,178,
7924,5723,469,315,784,
7925,5834,417,328,745,
7926,5651,370,319,689,
7929,451,30,31,61,
7930,5575,375,314,689,
7931,5791,404,322,726,
7933,609,34,39,73,
7934,5659,434,314,748,
7935,5817,405,350,755,
7936,5843,419,349,768,
7938,5998,439,330,769,
7940,5884,422,324,746,
7943,5827,468,287,755,
7944,1522,128,74,202,
7947,4827,342,272,614,
7948,1918,150,122,272,
7949,1340,98,79,177,
7951,5847,391,342,733,
7952,5956,458,353,811,
7953,5846,414,350,764,
7954,5798,420,311,731,
7956,5927,427,368,795,
7957,5743,428,292,720,
7960,114,11,14,25,
7961,629,35,33,68,
7962,5880,445,328,773,
7963,1449,80,91,171,
7964,5792,423,301,724,
7965,609,39,21,60,
7966,5796,425,307,732,
7967,5781,404,309,713,
7968,5923,449,353,802,
7969,512,39,32,71,
7970,1527,100,90,190,
7971,2355,138,127,265,
7972,5961,442,372,814,
7974,1256,106,70,176,
7975,2680,191,149,340,
7976,891,64,39,103,
7977,780,62,54,116,
7978,310,19,23,42,
7979,158,17,7,24,
7981,5899,457,343,800,
7983,95,9,5,14,
7984,5920,403,332,735,
7986,1090,78,79,157,
7987,5611,366,336,702,
7988,5844,439,305,744,
7989,5721,406,351,757,
7990,5798,420,338,758,
7991,2117,157,124,281,
7992,5961,404,338,742,
7993,5697,417,276,693,
7995,5773,409,346,755,
7996,5830,431,328,759,
7999,1877,149,89,238,
8001,1280,91,68,159,
8002,49,3,2,5,
8003,5874,411,353,764,
8004,5865,419,351,770,
8006,5842,429,318,747,
8007,5679,438,292,730,
8009,5516,376,343,719,
8010,733,52,34,86,
8011,2632,163,146,309,
8012,4041,289,258,547,
8016,5799,421,326,747,
8018,5980,402,356,758,
8020,4734,320,273,593,
8022,339,28,12,40,
8023,5669,403,338,741,
8025,273,22,14,36,
8026,5962,411,357,768,
8028,65,1,2,3,
8029,5873,408,315,723,
8030,5797,425,301,726,
8031,5735,416,318,734,
8032,5865,411,332,743,
8034,5718,396,346,742,
8035,966,67,63,130,
8036,1696,120,118,238,
8037,282,25,14,39,
8038,5944,406,319,725,
8039,513,45,36,81,
8040,247,12,19,31,
8041,5818,434,314,748,
8042,567,42,33,75,
8046,765,74,38,112,
8047,485,27,26,53,
8049,5877,414,353,767,
8050,5965,470,307,777,
8051,5936,419,346,765,
8053,661,54,30,84,
8054,124,8,5,13,
8055,5780,423,344,767,
8057,1090,77,61,138,
8058,5975,430,352,782,
8059,738,60,48,108,
8062,376,20,29,49,
8066,5868,465,317,782,
8067,2258,159,134,293,
8068,1979,132,114,246,
8069,948,82,51,133,
8072,1619,121,87,208,
8075,5717,403,257,660,
8076,1981,155,106,261,
8078,52,7,3,10,
8079,5737,400,360,760,
8081,5869,459,316,775,
8084,60,2,5,7,
8085,1200,93,68,161,
8086,5721,428,344,772,
8087,5883,418,341,759,
8088,5907,461,302,763,
8089,5816,426,351,777,
8090,5796,421,347,768,
8091,210,10,9,19,
8093,946,85,45,130,
8094,4164,268,213,481,
8097,5943,444,350,794,
8098,5888,419,342,761,
8100,622,40,32,72,
8101,659,40,36,76,
8102,5930,435,332,767,
8106,5940,444,310,754,
8107,5712,443,302,745,
8108,5967,441,354,795,
8109,5760,435,360,795,
8113,5807,424,304,728,
8115,728,50,36,86,
8116,1397,129,76,205,
8118,5799,439,320,759,
8120,1497,113,75,188,
8121,5828,438,327,765,
8122,5872,414,360,774,
8124,5815,420,313,733,
8126,5768,391,333,724,
8127,1495,95,88,183,
8128,5883,442,349,791,
8129,680,53,34,87,
8130,101,9,1,10,
8131,1556,110,80,190,
8133,5808,400,351,751,
8135,5772,383,354,737,
8136,182,9,13,22,
8137,1613,103,96,199,
8138,5918,451,300,751,
8139,2555,182,141,323,
8140,5931,449,317,766,
8142,5711,398,303,701,
8143,5631,453,323,776,
8145,5906,433,334,767,
8147,5820,454,273,727,
8148,5748,434,338,772,
8151,292,22,12,34,
8152,5698,383,341,724,
8155,6031,434,328,762,
8156,967,71,44,115,
8157,5805,421,340,761,
8158,1982,154,125,279,
8159,4025,278,244,522,
8160,5968,427,356,783,
8161,628,38,30,68,
8162,775,52,51,103,
8163,1471,104,76,180,
8164,696,47,33,80,
8166,1825,150,92,242,
8167,56,5,2,7,
8173,1286,82,57,139,
8176,5881,465,364,829,
8177,1919,140,102,242,
8178,5976,465,358,823,
8179,6003,417,328,745,
8182,549,45,33,78,
8185,5777,416,318,734,
8186,5876,413,342,755,
8187,5859,436,335,771,
8189,966,56,67,123,
8192,5878,419,323,742,
8193,2014,125,135,260,
8194,5205,353,264,617,
8195,5972,456,315,771,
8196,75,4,7,11,
8198,2248,147,123,270,
8199,5927,436,308,744,
8202,5939,399,353,752,
8204,80,6,2,8,
8205,261,25,16,41,
8206,2137,151,124,275,
8207,2002,150,119,269,
8208,5886,461,331,792,
8209,1471,105,94,199,
8210,4328,325,240,565,
8212,5926,423,354,777,
8213,5565,389,316,705,
8214,1262,94,79,173,
8216,2527,164,145,309,
8217,5847,442,315,757,
8218,899,62,54,116,
8220,240,8,14,22,
8223,4089,282,233,515,
8224,5788,397,305,702,
8225,5764,377,372,749,
8226,5763,413,328,741,
8227,241,19,13,32,
8228,5899,447,337,784,
8229,599,40,28,68,
8230,1654,110,94,204,
8231,548,38,32,70,
8232,155,5,8,13,
8233,1169,76,61,137,
8234,5892,444,327,771,
8236,5763,439,319,758,
8237,5544,395,349,744,
8238,5678,432,314,746,
8240,5903,380,330,710,
8241,5825,441,350,791,
8242,1118,83,68,151,
8243,2066,145,130,275,
8244,6029,426,353,779,
8247,5764,405,314,719,
8248,661,52,41,93,
8249,1665,120,95,215,
8251,450,25,30,55,
8252,6049,429,345,774,
8254,5915,421,344,765,
8255,5832,440,305,745,
8257,5888,434,305,739,
8259,1300,99,59,158,
8261,5886,438,345,783,
8264,285,22,14,36,
8265,2111,183,122,305,
8267,5803,405,346,751,
8269,5907,393,379,772,
8276,4267,322,246,568,
8279,118,13,9,22,
8280,5713,419,318,737,
8281,5847,436,350,786,
8282,5795,407,339,746,
8284,6030,439,338,777,
8285,5752,385,330,715,
8286,5686,421,324,745,
8287,208,15,14,29,
8288,352,35,21,56,
8289,5984,416,383,799,
8290,204,10,16,26,
8291,1034,62,59,121,
8293,5770,418,323,741,
8295,5678,392,328,720,
8296,5873,446,336,782,
8297,43,6,1,7,
8298,5818,423,321,744,
8301,5815,422,323,745,
8302,5741,415,355,770,
8305,5790,410,325,735,
8307,5901,417,315,732,
8308,737,53,32,85,
8309,130,8,4,12,
8312,5765,378,356,734,
8314,1251,113,78,191,
8315,5787,397,328,725,
8316,5813,426,333,759,
8317,345,31,20,51,
8321,4792,369,296,665,
8323,5806,455,350,805,
8325,430,26,20,46,
8326,683,44,42,86,
8328,5834,432,331,763,
8332,270,18,13,31,
8333,5746,439,300,739,
8335,5739,386,358,744,
8336,373,31,17,48,
8337,500,42,27,69,
8338,667,39,37,76,
8340,530,33,32,65,
8342,96,7,7,14,
8343,5712,428,315,743,
8344,5809,397,358,755,
8346,5875,403,352,755,
8347,1328,94,79,173,
8348,5889,373,336,709,
8350,1088,85,59,144,
8351,5854,389,356,745,
8352,5865,441,341,782,
8353,4850,352,279,631,
8354,1207,85,73,158,
8357,146,8,7,15,
8358,5758,392,332,724,
8359,49,1,2,3,
8360,700,61,41,102,
8361,1650,134,96,230,
8362,5903,455,355,810,
8365,5783,410,322,732,
8366,985,78,61,139,
8370,5964,414,327,741,
8373,5973,441,362,803,
8375,2057,145,119,264,
8376,1074,64,68,132,
8377,1311,85,82,167,
8379,1462,120,84,204,
8380,5697,344,369,713,
8383,317,27,15,42,
8385,110,7,8,15,
8386,5870,421,352,773,
8387,5798,399,305,704,
8389,1486,114,87,201,
8390,5884,422,331,753,
8394,1721,111,97,208,
8395,2342,165,121,286,
8397,5807,438,321,759,
8398,5876,421,347,768,
8399,1252,90,80,170,
8401,5829,432,304,736,
8402,5861,422,322,744,
8403,2568,190,139,329,
8404,5883,465,344,809,
8406,5898,427,337,764,
8407,5837,443,337,780,
8408,5605,397,330,727,
8409,1673,126,101,227,
8410,1169,82,72,154,
8411,5864,421,330,751,
8413,574,50,39,89,
8416,5730,375,319,694,
8418,3901,264,239,503,
8420,5745,402,320,722,
8424,1470,104,67,171,
8426,434,29,28,57,
8428,1236,96,86,182,
8429,5900,383,318,701,
8433,1698,134,95,229,
8434,896,63,51,114,
8436,5971,452,356,808,
8437,5772,427,341,768,
8438,5964,433,337,770,
8439,786,54,60,114,
8440,1803,137,102,239,
8441,946,64,54,118,
8442,5703,419,326,745,
8443,5912,438,312,750,
8444,5946,438,347,785,
8445,5804,419,323,742,
8446,5827,465,315,780,
8447,43,4,4,8,
8448,200,15,8,23,
8449,5811,441,346,787,
8450,5811,359,368,727,
8451,509,34,25,59,
8452,5793,371,311,682,
8455,5850,406,315,721,
8456,840,51,45,96,
8457,5956,423,338,761,
8460,5650,456,311,767,
8461,5829,408,336,744,
8462,5774,393,339,732,
8463,2445,159,143,302,
8464,52,4,4,8,
8465,4281,313,247,560,
8466,5772,411,325,736,
8468,5708,452,320,772,
8469,1020,86,45,131,
8470,5699,387,347,734,
8472,5663,422,344,766,
8474,168,7,12,19,
8475,334,28,15,43,
8476,736,55,38,93,
8478,5817,418,319,737,
8479,5762,392,319,711,
8483,97,8,6,14,
8485,5809,457,334,791,
8487,5845,427,331,758,
8488,5868,436,330,766,
8489,5812,460,337,797,
8490,5776,423,343,766,
8492,5731,432,295,727,
8496,1195,78,69,147,
8498,5821,458,350,808,
8499,1805,128,112,240,
8500,5769,411,330,741,
8502,5831,378,326,704,
8503,747,55,37,92,
8504,5796,432,326,758,
8505,4176,308,230,538,
8509,444,44,18,62,
8510,1577,116,78,194,
8511,5704,406,330,736,
8512,641,45,25,70,
8513,658,47,43,90,
8515,5660,391,360,751,
8516,1535,129,82,211,
8517,682,51,32,83,
8518,5849,455,326,781,
8520,746,48,56,104,
8521,5821,431,328,759,
8522,5914,437,323,760,
8523,521,33,35,68,
8524,1144,78,54,132,
8526,260,19,12,31,
8527,5809,435,322,757,
8528,5774,434,341,775,
8529,6018,420,335,755,
8530,573,49,35,84,
8531,4651,348,246,594,
8532,5819,419,341,760,
8533,5965,426,343,769,
8534,1044,66,47,113,
8537,5932,478,370,848,
8538,5903,432,324,756,
8539,5684,449,325,774,
8541,5826,432,334,766,
8542,739,53,29,82,
8543,1733,137,85,222,
8545,5846,421,324,745,
8546,5779,425,315,740,
8550,5925,406,360,766,
8551,4079,276,197,473,
8552,5678,379,362,741,
8554,5794,443,319,762,
8555,5811,426,323,749,
8556,287,24,19,43,
8557,5705,372,310,682,
8559,5819,439,324,763,
8560,5817,382,331,713,
8562,5856,426,309,735,
8563,5917,421,340,761,
8564,1004,64,65,129,
8565,2272,146,141,287,
8569,5693,437,331,768,
8570,388,28,30,58,
8572,2196,163,133,296,
8573,181,9,7,16,
8574,2080,153,113,266,
8576,5870,447,343,790,
8577,1673,105,100,205,
8578,5875,385,331,716,
8579,5971,412,328,740,
8580,803,62,51,113,
8581,5750,418,332,750,
8582,1924,133,113,246,
8583,5763,382,374,756,
8584,5878,440,321,761,
8585,1861,132,121,253,
8589,5726,432,352,784,
8590,2179,148,130,278,
8591,1163,91,73,164,
8592,681,54,30,84,
8594,1151,80,81,161,
8597,842,73,54,127,
8598,5714,417,334,751,
8599,5815,411,329,740,
8602,5780,424,325,749,
8603,6033,429,311,740,
8604,595,46,39,85,
8605,353,26,18,44,
8607,5801,410,320,730,
8608,86,8,2,10,
8609,6072,419,334,753,
8610,1432,109,93,202,
8611,5846,385,329,714,
8612,82,5,5,10,
8613,5866,421,343,764,
8615,421,44,23,67,
8616,5766,455,290,745,
8617,540,41,22,63,
8618,5754,414,295,709,
8620,1427,103,78,181,
8621,5783,449,345,794,
8623,5997,401,366,767,
8624,5730,403,327,730,
8625,5742,430,340,770,
8626,5835,438,311,749,
8627,1595,115,106,221,
8630,391,26,25,51,
8631,1221,99,67,166,
8632,4059,315,208,523,
8633,4686,321,239,560,
8634,5891,404,355,759,
8636,1508,108,82,190,
8637,1217,97,79,176,
8638,5722,420,360,780,
8639,252,21,18,39,
8640,1739,145,114,259,
8642,6006,429,348,777,
8645,5781,445,326,771,
8646,5856,376,331,707,
8647,6046,420,361,781,
8648,5935,436,338,774,
8649,284,12,15,27,
8652,5884,454,339,793,
8653,5954,414,351,765,
8654,1115,80,49,129,
8655,5965,415,329,744,
8656,5839,400,337,737,
8657,5875,409,337,746,
8658,5844,421,385,806,
8659,5873,455,318,773,
8660,3146,203,180,383,
8661,1164,106,65,171,
8662,5959,441,341,782,
8663,5920,465,361,826,
8665,5799,437,341,778,
8668,5872,384,381,765,
8669,5788,418,315,733,
8672,614,37,32,69,
8673,5689,429,319,748,
8674,605,35,45,80,
8676,5974,460,320,780,
8677,461,36,20,56,
8678,5746,419,296,715,
8679,5879,419,337,756,
8680,1644,115,88,203,
8682,6093,449,346,795,
8683,2018,134,113,247,
8684,5848,449,337,786,
8685,4155,339,220,559,
8686,2118,139,132,271,
8687,1034,65,64,129,
8688,5965,396,350,746,
8690,1815,130,116,246,
8691,5814,441,328,769,
8694,5833,448,299,747,
8695,2730,225,159,384,
8696,5769,409,332,741,
8697,1422,104,86,190,
8698,2100,135,111,246,
8699,1765,138,105,243,
8700,5685,404,329,733,
8701,5810,406,378,784,
8704,5828,407,325,732,
8706,5907,370,384,754,
8707,373,27,19,46,
8708,5912,418,337,755,
8709,1600,114,72,186,
8710,1157,86,73,159,
8712,5886,419,349,768,
8713,4290,264,266,530,
8714,5695,431,346,777,
8715,5699,385,329,714,
8717,5755,434,310,744,
8718,5859,445,327,772,
8720,5932,452,369,821,
8723,5872,413,329,742,
8724,5777,420,334,754,
8725,5729,412,319,731,
8726,5846,365,286,651,
8727,5895,429,329,758,
8730,5835,433,351,784,
8731,788,55,34,89,
8737,713,59,38,97,
8738,702,55,45,100,
8741,5975,447,352,799,
8742,5941,445,373,818,
8743,254,22,11,33,
8744,50,3,1,4,
8745,117,3,9,12,
8747,5787,412,319,731,
8748,5771,409,369,778,
8750,2034,145,122,267,
8751,2053,119,129,248,
8757,3988,296,254,550,
8758,5886,402,313,715,
8759,1018,81,52,133,
8760,5800,405,359,764,
8762,5666,404,346,750,
8763,2019,145,117,262,
8764,4901,360,276,636,
8765,5686,389,333,722,
8766,5871,414,349,763,
8767,332,19,22,41,
8768,741,49,45,94,
8769,247,19,9,28,
8770,150,7,6,13,
8772,661,49,34,83,
8773,5805,408,307,715,
8774,5960,453,338,791,
8775,5596,411,376,787,
8776,1801,118,105,223,
8777,5757,458,330,788,
8780,1090,81,76,157,
8782,894,74,55,129,
8783,5876,415,328,743,
8784,5586,384,329,713,
8785,643,43,45,88,
8786,5922,414,333,747,
8787,5699,363,388,751,
8789,905,57,61,118,
8790,658,50,42,92,
8791,5777,384,304,688,
8792,5680,414,307,721,
8794,1141,65,72,137,
8795,1307,98,79,177,
8796,5799,401,346,747,
8798,1035,84,56,140,
8799,5916,422,328,750,
8801,5863,404,363,767,
8803,5741,412,325,737,
8804,5890,451,329,780,
8812,5780,423,335,758,
8814,5818,405,342,747,
8818,218,15,16,31,
8821,5958,422,342,764,
8822,6028,425,351,776,
8823,5719,388,337,725,
8824,4078,283,256,539,
8826,5884,457,340,797,
8828,539,30,29,59,
8830,5958,415,341,756,
8831,5673,401,326,727,
8833,550,48,18,66,
8834,2374,171,131,302,
8835,923,51,46,97,
8836,5776,359,354,713,
8837,387,27,22,49,
8839,5826,397,314,711,
8840,5836,409,335,744,
8844,2345,170,135,305,
8845,5868,440,348,788,
8847,5763,423,308,731,
8848,1718,107,106,213,
8849,5861,383,349,732,
8850,5777,400,308,708,
8851,1656,123,97,220,
8852,5865,412,334,746,
8853,5942,463,329,792,
8854,5930,458,334,792,
8856,108,9,5,14,
8857,1277,80,80,160,
8858,1156,88,57,145,
8859,1741,112,87,199,
8860,5771,441,343,784,
8861,5908,431,315,746,
8863,5774,415,314,729,
8864,5988,426,339,765,
8866,5808,442,309,751,
8867,1312,108,81,189,
8868,5878,436,316,752,
8870,215,9,9,18,
8871,31,1,3,4,
8873,5865,422,345,767,
8874,2072,149,105,254,
8875,344,24,23,47,
8876,5856,393,340,733,
8878,600,59,36,95,
8883,4271,311,259,570,
8886,519,44,26,70,
8887,330,25,15,40,
8888,5877,392,348,740,
8889,622,40,33,73,
8890,5657,406,331,737,
8892,5712,390,332,722,
8893,909,69,55,124,
8894,5855,420,342,762,
8895,5710,423,335,758,
8897,5826,443,317,760,
8898,960,78,68,146,
8901,913,72,48,120,
8902,360,26,11,37,
8903,5826,443,335,778,
8904,970,73,51,124,
8907,5951,417,324,741,
8909,4441,321,256,577,
8910,6041,453,380,833,
8911,5686,397,324,721,
8912,5778,376,366,742,
8913,5748,445,342,787,
8916,5792,438,329,767,
8917,5768,420,319,739,
8918,1816,127,78,205,
8922,5744,473,314,787,
8923,5800,418,320,738,
8926,1279,85,72,157,
8927,5833,423,295,718,
8928,1275,104,94,198,
8930,5899,442,325,767,
8932,1069,69,53,122,
8933,5965,435,367,802,
8935,1748,135,91,226,
8936,5873,433,337,770,
8937,1522,108,89,197,
8938,5775,402,334,736,
8940,5951,424,323,747,
8941,1339,99,71,170,
8942,5839,406,357,763,
8943,594,55,32,87,
8944,5785,400,336,736,
8945,534,53,32,85,
8946,218,9,9,18,
8948,5656,403,328,731,
8949,1461,109,86,195,
8950,5613,405,301,706,
8951,5927,427,364,791,
8955,1272,92,93,185,
8958,640,35,39,74,
8960,5950,411,312,723,
8962,1713,115,94,209,
8964,815,59,51,110,
8966,769,62,44,106,
8967,5761,387,336,723,
8968,5867,447,330,777,
8969,5735,428,335,763,
8971,5774,430,312,742,
8972,5513,407,299,706,
8974,6042,428,328,756,
8975,1246,93,92,185,
8976,5993,436,331,767,
8981,1263,103,76,179,
8982,1759,114,102,216,
8984,5626,414,331,745,
8985,5712,382,329,711,
8986,5931,463,335,798,
8987,745,55,43,98,
8988,5859,381,319,700,
8990,1101,80,55,135,
8991,5975,391,344,735,
8996,1008,77,66,143,
8997,5709,401,350,751,
8998,311,29,11,40,
9000,623,48,32,80,
9002,5865,432,345,777,
9003,5827,404,341,745,
9004,5866,394,342,736,
9012,1144,87,58,145,
9014,5742,406,367,773,
9015,5661,418,316,734,
9016,5707,388,338,726,
9017,5916,473,310,783,
9020,351,24,24,48,
9021,5805,440,360,800,
9022,5722,408,347,755,
9023,2281,180,141,321,
9024,626,36,36,72,
9025,442,19,29,48,
9027,5552,395,273,668,
9028,5691,412,326,738,
9029,5881,423,350,773,
9031,5864,407,313,720,
9032,1054,65,57,122,
9034,342,28,26,54,
9035,5728,434,333,767,
9036,1751,126,112,238,
9037,503,36,28,64,
9040,5778,407,304,711,
9042,5790,438,340,778,
9043,970,80,69,149,
9044,5709,414,312,726,
9045,1725,132,96,228,
9046,5912,435,341,776,
9047,1986,151,118,269,
9048,5748,412,331,743,
9049,5804,413,352,765,
9051,931,70,39,109,
9052,2359,170,125,295,
9053,5809,419,321,740,
9057,528,44,35,79,
9058,1087,60,69,129,
9059,1643,102,94,196,
9060,2163,168,135,303,
9061,1689,127,82,209,
9062,769,61,53,114,
9064,5988,444,371,815,
9066,75,8,3,11,
9067,5705,437,330,767,
9071,5923,404,343,747,
9073,763,54,41,95,
9074,46,3,1,4,
9076,4169,303,229,532,
9077,5801,444,300,744,
9079,5845,430,316,746,
9081,5893,456,339,795,
9082,5745,454,324,778,
9083,5843,444,330,774,
9084,2661,204,126,330,
9085,4142,297,219,516,
9087,142,10,9,19,
9088,1714,100,99,199,
9089,5814,468,340,808,
9090,2426,157,121,278,
9091,257,16,15,31,
9093,4006,324,226,550,
9094,473,29,26,55,
9095,5682,406,340,746,
9098,978,83,59,142,
9099,3595,258,183,441,
9101,4244,287,236,523,
9102,5826,371,341,712,
9103,1074,83,59,142,
9104,5824,465,309,774,
9106,5782,413,331,744,
9109,486,41,30,71,
9110,5767,408,303,711,
9111,5844,456,320,776,
9112,5771,407,293,700,
9114,5853,423,317,740,
9118,5752,416,309,725,
9119,5781,425,313,738,
9121,5784,399,321,720,
9122,4115,294,256,550,
9123,5738,379,336,715,
9124,1087,84,59,143,
9126,472,60,33,93,
9131,1275,89,60,149,
9133,894,76,45,121,
9136,474,40,23,63,
9138,5711,408,323,731,
9139,122,10,7,17,
9140,5532,421,295,716,
9141,1425,104,84,188,
9142,854,65,60,125,
9143,5854,440,332,772,
9144,5787,415,351,766,
9145,528,37,20,57,
9146,1113,73,75,148,
9147,5933,439,344,783,
9148,5868,436,320,756,
9149,1111,96,53,149,
9150,5940,426,323,749,
9151,88,5,9,14,
9152,87,6,4,10,
9153,921,50,69,119,
9155,5820,424,324,748,
9156,5844,407,342,749,
9158,5828,456,355,811,
9161,5916,448,323,771,
9165,5859,422,335,757,
9167,285,19,15,34,
9168,5749,417,321,738,
9170,5778,406,332,738,
9171,6056,425,304,729,
9175,5707,398,325,723,
9176,5761,390,318,708,
9177,99,2,4,6,
9179,5847,431,341,772,
9181,5875,387,328,715,
9182,5804,436,326,762,
9183,21,1,1,2,
9184,654,42,36,78,
9185,402,27,21,48,
9186,926,68,58,126,
9187,6048,422,338,760,
9188,5842,432,338,770,
9189,5822,395,333,728,
9190,313,21,21,42,
9191,1537,104,85,189,
9192,525,40,28,68,
9193,5805,382,329,711,
9194,4362,299,257,556,
9195,1101,75,77,152,
9196,5674,392,300,692,
9198,527,35,32,67,
9201,5895,419,350,769,
9202,312,15,18,33,
9203,5780,438,347,785,
9206,1321,86,66,152,
9208,5495,370,336,706,
9209,5853,431,340,771,
9210,964,64,51,115,
9211,1426,92,83,175,
9212,406,32,23,55,
9213,5900,414,346,760,
9215,5835,388,323,711,
9216,5835,411,286,697,
9217,1821,126,107,233,
9218,5909,429,349,778,
9219,1799,125,104,229,
9220,5971,436,320,756,
9221,1565,112,72,184,
9223,5846,410,321,731,
9224,73,6,8,14,
9226,534,34,26,60,
9227,6040,438,337,775,
9229,5881,426,309,735,
9232,1745,115,84,199,
9234,5882,383,351,734,
9235,3877,269,229,498,
9236,2808,217,148,365,
9238,360,26,26,52,
9239,5819,419,307,726,
9241,5855,385,318,703,
9245,5960,432,312,744,
9248,2047,151,112,263,
9250,5814,429,334,763,
9251,5809,415,351,766,
9252,5646,431,306,737,
9254,1556,121,87,208,
9255,5902,431,364,795,
9256,1756,124,88,212,
9257,5780,372,347,719,
9258,5728,418,320,738,
9260,4483,301,280,581,
9261,5932,436,313,749,
9262,5904,443,349,792,
9263,5836,407,321,728,
9264,5943,443,316,759,
9265,5764,402,333,735,
9267,5761,448,323,771,
9268,5769,443,302,745,
9269,4191,324,268,592,
9271,124,11,8,19,
9272,960,67,65,132,
9273,203,13,13,26,
9274,2068,154,124,278,
9275,5629,387,324,711,
9276,638,39,41,80,
9277,1403,97,78,175,
9278,5821,443,329,772,
9279,761,58,57,115,
9280,5829,440,335,775,
9281,29,4,2,6,
9282,206,16,11,27,
9283,15,1,2,3,
9284,570,43,36,79,
9285,1132,90,59,149,
9286,2963,207,150,357,
9287,1050,78,60,138,
9291,5913,383,419,802,
9293,5918,449,340,789,
9294,5904,387,334,721,
9295,5966,458,311,769,
9298,5689,381,322,703,
9300,3781,269,219,488,
9302,5950,402,339,741,
9304,5841,425,342,767,
9305,1088,86,61,147,
9306,5776,364,328,692,
9308,5786,408,307,715,
9309,5897,415,344,759,
9310,1306,92,92,184,
9311,1354,89,72,161,
9312,529,34,26,60,
9314,5898,411,334,745,
9315,5678,412,337,749,
9316,441,33,21,54,
9317,5971,489,288,777,
9319,5936,433,354,787,
9320,1973,140,120,260,
9321,428,25,29,54,
9323,5917,415,337,752,
9324,86,8,3,11,
9325,5720,363,344,707,
9326,5603,412,344,756,
9328,5903,454,338,792,
9329,5824,417,337,754,
9330,47,3,2,5,
9331,5849,394,322,716,
9332,741,51,48,99,
9334,5757,421,327,748,
9336,5796,426,331,757,
9338,5859,446,292,738,
9340,4425,359,218,577,
9341,2213,160,143,303,
9343,2506,192,148,340,
9344,1437,104,83,187,
9345,5984,411,319,730,
9346,1196,84,65,149,
9347,370,25,24,49,
9348,1481,105,85,190,
9349,4616,362,239,601,
9351,5919,432,340,772,
9352,963,63,55,118,
9354,1540,109,96,205,
9355,1285,95,61,156,
9356,225,14,11,25,
9357,1908,140,99,239,
9360,5889,417,343,760,
9361,5689,411,332,743,
9362,570,42,38,80,
9363,5925,425,332,757,
9364,1341,94,80,174,
9365,1419,103,86,189,
9366,5831,394,374,768,
9367,5632,457,301,758,
9368,5914,425,327,752,
9369,1661,124,98,222,
9371,5871,443,349,792,
9372,1601,129,90,219,
9374,1720,131,91,222,
9375,362,28,17,45,
9376,5730,405,320,725,
9382,196,16,7,23,
9383,1056,78,48,126,
9384,5792,417,318,735,
9387,1050,74,63,137,
9388,5631,360,352,712,
9389,5769,411,365,776,
9390,5717,426,322,748,
9392,3241,246,169,415,
9393,1178,80,73,153,
9394,5780,454,313,767,
9395,4161,297,228,525,
9397,5864,401,353,754,
9399,5814,390,342,732,
9401,5691,396,319,715,
9403,5877,447,351,798,
9404,766,52,46,98,
9405,81,6,4,10,
9407,5778,477,299,776,
9408,110,4,6,10,
9409,2883,219,165,384,
9410,4062,305,221,526,
9412,5867,414,308,722,
9414,1702,127,90,217,
9415,5822,413,368,781,
9416,5971,405,358,763,
9418,201,10,6,16,
9420,5835,448,322,770,
9423,5967,455,301,756,
9424,228,23,15,38,
9425,5750,450,298,748,
9426,5857,404,330,734,
9427,5894,449,300,749,
9428,5732,393,313,706,
9429,606,50,29,79,
9431,294,15,24,39,
9432,5852,410,325,735,
9433,5687,386,353,739,
9434,355,27,31,58,
9436,1002,70,50,120,
9439,1184,76,63,139,
9440,5887,414,320,734,
9441,4361,308,261,569,
9443,5942,401,339,740,
9444,372,21,14,35,
9445,1609,122,100,222,
9447,64,5,3,8,
9448,5706,451,318,769,
9449,4273,360,227,587,
9450,1076,75,70,145,
9453,1415,105,70,175,
9454,5843,450,291,741,
9455,5689,419,326,745,
9456,5921,420,362,782,
9457,1617,112,93,205,
9459,1522,107,94,201,
9461,791,70,47,117,
9463,6036,459,327,786,
9464,5939,416,340,756,
9465,5939,401,373,774,
9466,1808,138,108,246,
9467,1284,120,79,199,
9468,5864,458,323,781,
9469,5829,409,349,758,
9470,5727,394,329,723,
9472,5867,422,350,772,
9473,5704,391,348,739,
9474,583,43,24,67,
9475,5851,443,354,797,
9476,1579,110,87,197,
9477,131,13,11,24,
9478,828,68,41,109,
9479,5714,407,343,750,
9480,5913,421,338,759,
9483,5800,409,315,724,
9486,1460,88,88,176,
9488,5852,405,346,751,
9490,5782,447,320,767,
9491,837,71,48,119,
9492,2083,160,109,269,
9494,468,31,24,55,
9495,713,54,44,98,
9496,5822,401,321,722,
9497,2688,215,149,364,
9499,6030,415,334,749,
9501,6003,407,334,741,
9502,5805,422,339,761,
9503,2086,142,110,252,
9504,4121,306,223,529,
9508,733,63,37,100,
9509,6095,454,342,796,
9510,1008,93,52,145,
9511,1670,122,105,227,
9515,551,40,33,73,
9516,4009,255,253,508,
9517,1648,121,120,241,
9519,5844,387,353,740,
9521,237,20,10,30,
9523,5857,419,283,702,
9525,5947,442,312,754,
9527,1478,99,83,182,
9528,1762,128,106,234,
9529,5984,459,321,780,
9534,153,9,10,19,
9536,1458,96,91,187,
9538,315,35,16,51,
9542,898,58,49,107,
9543,1602,135,80,215,
9544,3942,268,252,520,
9546,5796,459,303,762,
9547,5786,436,350,786,
9549,248,21,12,33,
9550,5968,451,310,761,
9551,5799,396,343,739,
9552,5892,436,324,760,
9554,3304,268,160,428,
9555,1610,121,93,214,
9556,5837,380,353,733,
9557,5742,439,337,776,
9559,5771,420,320,740,
9560,5700,400,304,704,
9562,4394,291,259,550,
9566,5708,448,343,791,
9567,1673,119,104,223,
9568,5854,443,315,758,
9570,5640,455,283,738,
9571,5700,481,296,777,
9573,923,69,48,117,
9575,588,35,20,55,
9576,252,14,19,33,
9577,177,17,8,25,
9578,1493,119,82,201,
9582,1160,73,61,134,
9585,5849,432,342,774,
9587,1462,90,86,176,
9589,5836,398,321,719,
9590,655,41,52,93,
9592,5801,439,318,757,
9594,5904,470,348,818,
9595,5586,388,332,720,
9597,5697,406,337,743,
9598,622,54,31,85,
9599,43,2,5,7,
9600,18,2,2,4,
9601,1359,117,59,176,
9602,139,17,6,23,
9603,1451,96,89,185,
9604,547,46,34,80,
9605,5781,409,310,719,
9610,5591,483,307,790,
9611,5971,422,354,776,
9613,1387,105,83,188,
9614,5871,428,309,737,
9615,1077,80,66,146,
9616,5755,462,296,758,
9617,100,8,8,16,
9620,5872,432,338,770,
9621,189,6,7,13,
9622,5883,427,363,790,
9623,5835,489,330,819,
9624,5875,391,324,715,
9625,1403,91,86,177,
9626,5834,449,310,759,
9628,5863,424,350,774,
9632,5931,422,351,773,
9633,1133,79,65,144,
9634,4444,294,269,563,
9635,5838,412,327,739,
9636,111,7,6,13,
9637,5751,411,297,708,
9642,5885,397,347,744,
9644,192,9,13,22,
9645,5870,399,335,734,
9646,1291,87,64,151,
9647,5945,440,334,774,
9650,5882,435,321,756,
9652,735,45,48,93,
9653,1186,73,69,142,
9654,5941,415,319,734,
9655,416,29,20,49,
9656,5854,419,377,796,
9658,249,17,7,24,
9660,5741,426,311,737,
9661,662,52,29,81,
9662,5861,414,322,736,
9663,5822,440,359,799,
9665,5874,400,317,717,
9667,1936,134,122,256,
9668,5805,437,348,785,
9670,5813,442,365,807,
9671,5951,427,323,750,
9672,5706,448,339,787,
9673,109,8,6,14,
9676,5670,405,331,736,
9677,5928,433,319,752,
9680,6019,454,323,777,
9682,5792,404,345,749,
9683,964,76,47,123,
9684,453,28,36,64,
9685,89,5,3,8,
9687,109,7,4,11,
9688,5864,458,349,807,
9689,5823,400,317,717,
9690,4791,357,266,623,
9692,2149,151,123,274,
9694,1924,137,111,248,
9695,1989,174,103,277,
9697,1832,141,97,238,
9702,5921,449,318,767,
9703,5949,405,330,735,
9705,788,59,41,100,
9706,949,74,53,127,
9707,2201,141,133,274,
9709,3913,310,217,527,
9711,5985,426,325,751,
9712,5952,420,341,761,
9714,3841,299,206,505,
9715,66,6,3,9,
9716,5761,439,336,775,
9717,5747,412,309,721,
9718,466,40,27,67,
9722,5962,423,306,729,
9723,4217,318,245,563,
9724,5821,479,307,786,
9726,3267,229,182,411,
9729,1754,121,94,215,
9732,5732,426,312,738,
9733,5765,433,306,739,
9736,2120,166,122,288,
9737,5942,447,337,784,
9738,2131,169,99,268,
9739,148,13,8,21,
9740,5536,411,310,721,
9741,617,44,34,78,
9743,5901,421,305,726,
9746,1124,76,53,129,
9748,1492,120,82,202,
9750,632,35,42,77,
9753,5739,384,319,703,
9755,1757,129,114,243,
9757,669,41,42,83,
9758,2079,158,127,285,
9759,5779,432,337,769,
9761,1644,138,90,228,
9762,5667,409,318,727,
9763,5905,465,285,750,
9764,1233,87,71,158,
9766,5770,396,298,694,
9770,5822,400,312,712,
9774,758,48,42,90,
9776,5890,453,355,808,
9777,5730,448,375,823,
9779,943,66,51,117,
9781,5999,437,333,770,
9782,773,50,29,79,
9784,1256,94,77,171,
9785,5889,444,328,772,
9787,5838,410,356,766,
9791,1095,73,67,140,
9793,1333,100,87,187,
9795,1567,101,83,184,
9796,5843,406,309,715,
9797,5671,403,331,734,
9798,118,7,8,15,
9801,5810,421,326,747,
9803,5779,433,347,780,
9804,1509,127,78,205,
9805,1610,110,92,202,
9806,4631,361,248,609,
9808,6002,419,367,786,
9810,866,46,51,97,
9811,92,9,5,14,
9812,5844,431,349,780,
9814,5788,410,329,739,
9816,1511,111,64,175,
9817,353,24,30,54,
9818,5957,442,354,796,
9820,5751,385,317,702,
9821,240,13,13,26,
9823,424,27,23,50,
9824,5861,386,329,715,
9825,1753,125,113,238,
9826,5919,430,351,781,
9827,585,35,26,61,
9828,6020,473,347,820,
9829,5879,423,339,762,
9830,5831,429,314,743,
9831,5661,398,299,697,
9832,270,20,9,29,
9833,5820,440,308,748,
9834,5729,447,312,759,
9835,1909,128,108,236,
9837,5830,435,291,726,
9838,5874,404,330,734,
9841,5785,417,341,758,
9842,1740,127,109,236,
9843,5855,431,313,744,
9844,5818,421,370,791,
9846,1184,108,60,168,
9847,5866,429,305,734,
9848,2127,133,106,239,
9850,1275,76,83,159,
9851,5978,465,307,772,
9856,2334,174,116,290,
9857,2118,179,107,286,
9858,5837,417,337,754,
9859,5928,421,338,759,
9860,1342,79,73,152,
9862,1715,126,100,226,
9863,5910,448,318,766,
9865,5659,369,325,694,
9866,975,61,53,114,
9867,5883,446,348,794,
9868,5746,402,311,713,
9869,5770,428,313,741,
9870,5903,437,311,748,
9871,4105,292,262,554,
9872,2548,167,176,343,
9873,1100,79,65,144,
9875,3981,273,234,507,
9876,5776,423,345,768,
9878,926,56,50,106,
9879,5927,436,331,767,
9880,805,47,51,98,
9882,5717,498,310,808,
9883,1958,116,110,226,
9884,548,46,27,73,
9885,1422,101,89,190,
9886,5799,405,318,723,
9887,534,33,25,58,
9888,5959,416,345,761,
9890,5919,439,359,798,
9891,5913,442,329,771,
9892,593,42,29,71,
9893,5843,407,349,756,
9895,5811,423,330,753,
9896,5801,401,341,742,
9897,5823,414,345,759,
9898,5855,426,351,777,
9899,333,23,13,36,
9900,5816,451,293,744,
9901,174,12,10,22,
9902,5903,395,338,733,
9904,5724,402,306,708,
9905,2315,152,139,291,
9906,1083,75,54,129,
9907,5766,404,349,753,
9908,302,30,19,49,
9909,5903,402,317,719,
9910,5802,421,312,733,
9911,5866,419,336,755,
9912,5769,408,343,751,
9913,5813,416,285,701,
9915,5914,463,372,835,
9916,5710,372,349,721,
9917,5898,446,335,781,
9918,6010,436,344,780,
9919,5886,455,317,772,
9920,5987,511,340,851,
9921,531,39,46,85,
9922,5809,403,334,737,
9925,5770,419,353,772,
9927,450,32,19,51,
9928,5784,472,329,801,
9930,35,1,2,3,
9931,5884,406,340,746,
9932,2943,191,189,380,
9933,1416,98,74,172,
9934,5684,407,321,728,
9935,834,56,50,106,
9936,5799,454,336,790,
9938,5948,430,342,772,
9939,1186,68,78,146,
9940,6011,439,323,762,
9941,206,13,10,23,
9943,238,23,15,38,
9945,5796,381,362,743,
9947,5835,459,329,788,
9948,985,85,38,123,
9949,5694,407,335,742,
9950,5882,444,331,775,
9951,5912,441,320,761,
9952,5655,394,317,711,
9954,5953,415,349,764,
9955,5800,450,299,749,
9956,1319,104,74,178,
9957,5972,428,315,743,
9959,5805,436,318,754,
9962,5778,431,354,785,
9963,25,2,1,3,
9964,5784,428,338,766,
9965,5780,420,285,705,
9967,5985,446,370,816,
9969,5807,412,339,751,
9970,1064,80,52,132,
9971,5741,429,318,747,
9972,5765,413,301,714,
9973,5739,395,323,718,
9974,5750,431,327,758,
9975,5815,431,341,772,
9976,5742,425,302,727,
9977,4078,301,238,539,
9979,3953,277,233,510,
9980,5787,402,337,739,
9981,763,54,32,86,
9982,482,40,27,67,
9984,5770,418,313,731,
9985,5652,417,292,709,
9987,1355,107,81,188,
9989,1482,108,86,194,
9990,294,20,24,44,
9991,5767,408,337,745,
9992,4582,353,243,596,
9993,1831,137,97,234,
9995,417,29,32,61,
9996,5810,420,318,738,
9997,5782,440,317,757,
9998,1405,95,77,172,
