eventID,numPhotons,numReachedDown,numReachedUp,numPE,
1,4880,346,263,609,
3,4888,346,291,637,
4,4780,359,286,645,
5,4905,312,306,618,
6,4971,322,279,601,
7,4907,344,298,642,
9,4889,336,302,638,
10,1297,91,60,151,
11,4878,378,275,653,
12,4806,353,283,636,
14,4761,367,256,623,
15,5098,359,307,666,
16,4808,339,270,609,
17,947,86,51,137,
18,395,25,27,52,
19,171,12,4,16,
20,4931,370,266,636,
24,353,37,16,53,
25,404,33,20,53,
26,4873,397,240,637,
29,4740,375,289,664,
30,4829,388,296,684,
31,4873,379,267,646,
32,4879,372,277,649,
33,4812,327,286,613,
34,524,40,31,71,
35,4829,345,272,617,
36,4827,333,282,615,
39,52,4,5,9,
40,111,7,10,17,
41,4912,321,258,579,
42,928,60,47,107,
43,47,2,6,8,
44,754,48,41,89,
45,63,5,2,7,
46,4893,333,285,618,
47,4720,358,265,623,
48,4906,337,284,621,
49,4883,342,255,597,
50,4826,337,280,617,
54,4858,356,268,624,
55,714,54,49,103,
56,4799,312,288,600,
58,4804,383,269,652,
59,347,35,24,59,
60,4826,358,280,638,
61,260,16,17,33,
63,4819,355,312,667,
64,4832,368,280,648,
65,800,65,33,98,
67,4797,352,281,633,
68,4830,337,285,622,
69,4914,343,297,640,
70,472,27,33,60,
71,70,4,4,8,
72,4871,348,277,625,
74,4970,370,301,671,
75,289,24,17,41,
76,4967,339,291,630,
77,4828,361,276,637,
78,288,20,21,41,
80,4766,349,261,610,
81,3557,253,214,467,
84,4887,361,258,619,
85,4835,370,299,669,
87,4980,347,279,626,
88,1336,80,76,156,
89,743,63,34,97,
90,79,7,9,16,
91,4851,346,272,618,
92,4665,334,274,608,
94,4937,366,284,650,
95,3942,326,205,531,
96,4817,379,262,641,
97,991,79,52,131,
98,4878,347,286,633,
99,4916,364,298,662,
100,4689,354,292,646,
102,4942,378,283,661,
103,4836,393,256,649,
104,1110,68,51,119,
105,4890,370,293,663,
106,4748,328,275,603,
108,4838,337,292,629,
110,4934,381,283,664,
112,403,28,24,52,
113,4908,354,298,652,
114,4911,352,281,633,
117,4776,371,278,649,
119,4736,333,295,628,
120,4787,357,298,655,
121,902,53,65,118,
122,4910,300,295,595,
124,4867,326,249,575,
125,4836,349,273,622,
127,1174,73,69,142,
129,4913,355,296,651,
130,4955,335,287,622,
131,4948,373,260,633,
132,1022,63,60,123,
133,4907,372,275,647,
135,4785,335,281,616,
136,609,53,35,88,
137,4796,318,287,605,
138,1050,74,55,129,
139,4841,350,286,636,
140,375,19,21,40,
141,1361,95,89,184,
142,4959,371,277,648,
143,1312,102,75,177,
145,4827,335,294,629,
146,4816,348,285,633,
147,4725,335,284,619,
149,4873,317,257,574,
150,517,38,38,76,
151,4755,343,251,594,
152,675,51,40,91,
153,4793,339,260,599,
154,4736,348,298,646,
155,4848,353,283,636,
156,148,12,3,15,
158,4664,293,256,549,
159,4750,331,284,615,
160,1220,79,70,149,
161,4790,340,305,645,
162,4852,357,272,629,
163,927,67,45,112,
164,4843,378,277,655,
165,4959,330,280,610,
166,4749,343,285,628,
167,122,8,5,13,
168,4853,369,249,618,
170,5012,376,300,676,
171,4770,387,266,653,
173,4870,401,286,687,
176,4762,339,273,612,
177,4839,309,265,574,
178,4993,347,260,607,
179,97,5,7,12,
180,3543,262,216,478,
181,1039,83,45,128,
182,47,3,1,4,
183,4844,323,262,585,
184,564,34,28,62,
185,4754,322,279,601,
186,3557,242,210,452,
188,1145,86,79,165,
189,4887,370,265,635,
191,4887,363,269,632,
193,4902,365,261,626,
194,4770,371,282,653,
195,4898,348,258,606,
196,4908,345,256,601,
197,511,49,24,73,
199,4898,325,288,613,
200,406,31,26,57,
201,4953,367,303,670,
204,4676,317,283,600,
208,727,64,58,122,
209,79,7,9,16,
211,4890,333,268,601,
212,1415,113,70,183,
213,4976,338,263,601,
214,4811,357,258,615,
215,4870,353,269,622,
216,4877,390,246,636,
218,391,34,27,61,
220,4876,340,290,630,
221,509,36,27,63,
222,63,5,3,8,
223,4841,380,277,657,
224,34,3,1,4,
225,789,55,35,90,
226,4709,342,279,621,
228,1432,112,85,197,
229,139,9,11,20,
230,635,38,34,72,
231,4842,348,260,608,
232,4876,340,259,599,
234,4884,357,300,657,
236,915,75,53,128,
237,4691,333,276,609,
238,4770,307,293,600,
239,4885,333,288,621,
241,4782,361,255,616,
244,4881,376,268,644,
245,4905,381,294,675,
246,4729,368,282,650,
247,4853,367,293,660,
249,4930,381,267,648,
251,4837,335,277,612,
252,4920,339,275,614,
253,425,25,19,44,
255,783,60,48,108,
257,4689,368,271,639,
258,4872,367,278,645,
259,4951,339,285,624,
260,4848,327,244,571,
261,11,1,1,2,
263,4694,362,245,607,
264,4887,365,282,647,
268,4702,373,280,653,
269,551,43,32,75,
270,4626,336,258,594,
271,4899,351,299,650,
272,4870,346,252,598,
274,964,67,56,123,
275,4701,345,282,627,
277,4910,366,245,611,
278,4787,319,290,609,
279,3283,241,194,435,
280,4802,358,234,592,
281,4816,354,281,635,
282,4912,376,240,616,
283,4803,296,311,607,
284,731,60,37,97,
285,824,64,37,101,
286,4813,339,304,643,
287,4800,339,303,642,
288,263,15,15,30,
294,1159,68,61,129,
295,41,1,2,3,
296,4790,345,273,618,
298,4809,349,278,627,
299,4796,373,272,645,
300,85,10,3,13,
301,353,22,23,45,
303,4746,338,284,622,
305,4747,325,261,586,
306,4829,343,304,647,
307,4777,364,263,627,
308,4691,349,276,625,
309,1260,95,64,159,
310,4981,349,320,669,
312,4822,364,267,631,
314,4919,329,304,633,
315,4816,328,257,585,
316,1472,121,91,212,
317,4730,329,266,595,
318,4947,346,266,612,
319,4870,353,281,634,
320,3645,239,253,492,
321,1002,77,53,130,
323,4766,354,273,627,
324,972,67,54,121,
325,1199,98,63,161,
326,4731,328,255,583,
327,466,46,28,74,
329,4886,390,269,659,
330,4747,355,299,654,
331,4894,375,279,654,
332,49,2,2,4,
333,4828,349,271,620,
334,703,50,51,101,
335,154,13,9,22,
337,4879,343,291,634,
338,4719,315,267,582,
341,4904,358,308,666,
342,4809,340,266,606,
343,38,3,1,4,
344,4789,332,235,567,
345,4855,361,258,619,
348,4906,374,285,659,
349,4888,332,280,612,
350,4901,391,295,686,
352,4756,327,263,590,
353,4835,389,296,685,
354,4811,357,266,623,
355,4778,294,269,563,
358,4847,372,278,650,
359,4803,358,268,626,
361,4858,382,263,645,
362,4837,396,241,637,
363,4947,354,270,624,
365,16,1,2,3,
366,4843,349,276,625,
367,4711,392,245,637,
370,2527,191,138,329,
371,4819,352,275,627,
372,3033,217,182,399,
373,4952,339,257,596,
375,4808,338,276,614,
377,4978,342,303,645,
379,4842,334,285,619,
380,1703,131,100,231,
381,3807,276,221,497,
385,4715,315,278,593,
386,4884,357,242,599,
387,535,42,32,74,
390,4797,365,268,633,
392,4732,362,258,620,
393,4802,361,280,641,
394,205,11,10,21,
395,3534,223,188,411,
397,4715,324,276,600,
398,5012,375,289,664,
399,4989,382,316,698,
403,4953,337,276,613,
404,4912,365,253,618,
405,4763,355,250,605,
406,821,62,35,97,
407,933,79,62,141,
408,246,19,9,28,
409,892,64,49,113,
410,4840,322,281,603,
411,4739,366,261,627,
412,4872,379,291,670,
413,822,53,38,91,
414,4942,371,257,628,
416,4861,352,271,623,
418,4837,303,306,609,
419,4749,338,258,596,
420,1189,95,70,165,
421,4928,332,292,624,
422,3753,269,212,481,
423,356,22,27,49,
425,4973,333,300,633,
426,4896,334,275,609,
427,3464,223,195,418,
431,4827,355,256,611,
432,4919,346,293,639,
433,4693,348,268,616,
434,4719,364,274,638,
435,1343,103,66,169,
436,4796,368,253,621,
437,4725,334,287,621,
439,4904,363,272,635,
440,4699,322,312,634,
441,4968,335,279,614,
442,4760,342,260,602,
444,4833,342,286,628,
445,4955,373,277,650,
446,4894,345,282,627,
447,4882,314,274,588,
448,4820,299,282,581,
450,4893,344,291,635,
452,4763,341,249,590,
453,25,2,3,5,
454,4850,357,280,637,
455,4923,348,295,643,
456,1080,81,66,147,
460,4847,387,280,667,
461,3961,334,216,550,
462,4720,333,249,582,
466,4823,357,283,640,
467,371,32,22,54,
468,4767,335,255,590,
469,4795,366,259,625,
470,4865,334,294,628,
471,4748,367,238,605,
473,4672,340,241,581,
474,1181,82,65,147,
475,4865,337,301,638,
476,4758,378,278,656,
477,4738,359,250,609,
478,4768,347,235,582,
480,4686,374,270,644,
481,4836,356,251,607,
482,4760,308,274,582,
483,754,65,37,102,
484,4817,316,292,608,
485,4958,363,287,650,
486,210,13,12,25,
487,277,20,15,35,
488,1022,83,63,146,
489,4795,339,271,610,
491,3714,234,207,441,
493,4970,343,288,631,
494,374,21,26,47,
495,4905,372,255,627,
496,4868,390,243,633,
497,4943,387,281,668,
498,904,73,55,128,
499,4845,332,236,568,
500,3881,316,198,514,
501,4903,341,292,633,
502,250,16,18,34,
503,4613,341,234,575,
505,132,7,15,22,
506,4773,344,268,612,
507,670,57,41,98,
508,4765,346,308,654,
510,3790,295,210,505,
511,1367,86,68,154,
513,4914,354,278,632,
514,4976,367,316,683,
518,4709,300,305,605,
519,1268,86,74,160,
520,4894,367,240,607,
521,4955,363,305,668,
522,4835,364,268,632,
524,1234,82,77,159,
525,4944,355,262,617,
526,4821,359,268,627,
527,1339,91,71,162,
528,4945,375,276,651,
529,309,27,16,43,
532,4918,313,290,603,
533,4815,340,273,613,
534,4955,359,282,641,
535,4806,339,259,598,
537,4879,348,289,637,
538,4894,364,241,605,
539,4958,342,263,605,
541,1259,90,71,161,
542,4720,307,288,595,
544,657,45,45,90,
545,465,27,32,59,
546,4825,346,263,609,
550,4171,279,258,537,
551,4713,327,295,622,
552,4922,332,307,639,
553,3868,280,192,472,
554,4842,334,277,611,
555,4942,376,269,645,
558,4744,326,275,601,
559,4887,380,295,675,
560,1536,139,83,222,
561,553,42,35,77,
562,4918,368,268,636,
563,4823,359,234,593,
564,4656,331,281,612,
565,4845,354,274,628,
567,1551,112,83,195,
568,4906,347,262,609,
569,4837,377,268,645,
570,5010,375,283,658,
571,635,51,31,82,
573,4858,353,274,627,
574,4878,363,265,628,
577,4825,347,253,600,
578,4947,374,311,685,
579,4790,338,278,616,
580,656,55,37,92,
581,4739,388,268,656,
583,4857,375,286,661,
585,911,65,50,115,
586,4842,348,265,613,
587,4755,355,251,606,
588,4723,348,243,591,
589,5002,383,280,663,
591,4746,319,283,602,
592,380,21,19,40,
593,200,14,12,26,
594,3895,295,211,506,
595,346,22,10,32,
596,4791,352,263,615,
599,78,7,5,12,
600,4757,409,249,658,
601,4916,379,288,667,
604,4806,363,307,670,
606,4805,346,302,648,
607,4863,359,256,615,
608,298,17,23,40,
610,4808,361,264,625,
611,4838,334,266,600,
612,4803,334,290,624,
613,4720,326,265,591,
615,284,24,18,42,
616,4758,343,280,623,
617,1813,132,95,227,
619,4812,354,240,594,
621,1334,98,62,160,
622,1305,85,62,147,
623,853,57,45,102,
624,4900,386,274,660,
625,4839,334,247,581,
627,4856,349,288,637,
628,4786,379,258,637,
630,4813,313,256,569,
631,5096,359,262,621,
632,4848,386,282,668,
633,4792,371,252,623,
634,4838,353,256,609,
635,4662,307,281,588,
636,415,34,17,51,
637,4878,347,295,642,
638,523,44,26,70,
639,4830,366,262,628,
642,1336,83,78,161,
643,320,31,14,45,
645,4893,354,301,655,
646,1104,74,64,138,
647,4907,367,285,652,
648,4854,387,279,666,
652,436,23,23,46,
653,4786,346,242,588,
654,4928,337,285,622,
655,4790,385,284,669,
656,4863,355,231,586,
657,303,18,18,36,
659,330,25,34,59,
662,4845,346,255,601,
663,4839,381,289,670,
664,4767,330,313,643,
665,4803,346,272,618,
666,4821,359,279,638,
669,4949,343,306,649,
670,567,40,39,79,
671,4839,379,288,667,
672,4966,353,268,621,
673,4843,376,269,645,
674,4775,346,287,633,
676,4832,335,259,594,
677,22,3,1,4,
678,982,70,58,128,
680,1061,68,75,143,
681,4790,351,235,586,
682,4756,321,272,593,
685,4665,341,257,598,
686,115,12,8,20,
687,3698,259,206,465,
688,4949,373,282,655,
689,645,47,33,80,
690,498,38,26,64,
692,4712,315,275,590,
694,892,70,41,111,
696,4682,331,250,581,
697,715,47,36,83,
698,4868,329,272,601,
699,4788,328,311,639,
700,4523,324,240,564,
701,4858,365,294,659,
702,4325,303,223,526,
704,4701,362,267,629,
705,4921,356,261,617,
706,1282,92,64,156,
709,4879,364,256,620,
710,4785,349,273,622,
712,194,10,11,21,
713,4864,369,297,666,
716,4877,353,294,647,
717,4804,370,282,652,
720,4869,366,275,641,
721,4920,402,287,689,
722,4968,349,303,652,
724,4790,380,268,648,
725,3933,298,203,501,
726,4939,362,274,636,
727,4960,341,288,629,
729,4787,354,259,613,
730,4785,336,257,593,
731,4899,373,266,639,
732,4895,337,311,648,
733,671,50,43,93,
736,27,2,1,3,
737,4974,361,268,629,
738,4700,356,264,620,
739,4886,339,245,584,
740,968,84,68,152,
742,4735,354,264,618,
743,4941,392,305,697,
744,22,2,1,3,
745,4767,352,273,625,
746,4913,387,252,639,
747,4847,339,262,601,
748,4918,349,287,636,
749,4012,312,200,512,
750,3464,230,178,408,
751,4880,340,300,640,
753,246,16,15,31,
754,4792,387,243,630,
755,4738,336,263,599,
756,4821,263,332,595,
757,4937,332,262,594,
758,4904,342,273,615,
759,4815,350,304,654,
760,4781,370,294,664,
761,920,80,71,151,
762,4959,325,282,607,
763,4824,326,295,621,
764,4857,364,258,622,
766,4945,353,299,652,
767,1193,77,59,136,
768,89,4,2,6,
769,4756,347,262,609,
771,4858,342,303,645,
772,4830,377,277,654,
773,947,74,62,136,
774,4848,360,247,607,
776,639,47,22,69,
777,764,40,42,82,
779,1343,94,56,150,
780,4979,342,318,660,
781,4801,389,255,644,
782,4776,368,269,637,
783,4819,322,278,600,
785,4941,381,284,665,
787,4793,391,277,668,
788,4982,341,292,633,
789,3661,282,216,498,
791,4947,347,293,640,
792,4805,346,267,613,
793,4843,371,277,648,
794,4577,336,263,599,
795,4882,360,275,635,
796,1038,73,60,133,
797,4821,291,271,562,
799,4833,379,267,646,
800,4789,330,251,581,
803,4890,308,281,589,
805,1345,92,85,177,
806,4886,327,275,602,
807,3381,236,203,439,
809,4729,362,256,618,
810,4794,351,281,632,
813,683,55,31,86,
814,1000,71,64,135,
815,4865,344,290,634,
816,4902,314,298,612,
817,4765,332,249,581,
819,1272,92,73,165,
820,462,32,28,60,
821,3330,233,183,416,
822,265,18,17,35,
824,4759,329,273,602,
825,4770,345,278,623,
826,1858,148,108,256,
827,346,27,23,50,
829,4955,367,282,649,
830,4731,323,288,611,
831,4823,341,274,615,
832,524,39,23,62,
833,270,20,16,36,
834,4909,360,288,648,
835,163,17,13,30,
836,993,76,49,125,
837,4786,328,249,577,
838,4757,347,280,627,
839,331,18,26,44,
842,3679,271,166,437,
845,4798,358,252,610,
847,4728,363,296,659,
850,4834,363,267,630,
852,682,50,34,84,
853,571,27,55,82,
855,115,8,5,13,
858,5001,387,247,634,
859,4893,342,268,610,
861,753,59,42,101,
866,1152,85,59,144,
867,4774,348,276,624,
868,4888,334,327,661,
869,4790,351,281,632,
870,4843,363,266,629,
871,4788,360,245,605,
873,4883,364,278,642,
874,4712,349,262,611,
875,4973,378,307,685,
877,4830,360,306,666,
878,4842,324,269,593,
879,4857,350,296,646,
880,4643,356,259,615,
881,399,31,28,59,
882,2187,178,110,288,
884,4727,323,291,614,
885,4869,396,264,660,
886,255,11,22,33,
888,4891,355,286,641,
889,4836,347,306,653,
890,4995,388,278,666,
891,4888,337,262,599,
892,4796,367,290,657,
893,4839,349,277,626,
894,4884,347,283,630,
895,4740,348,257,605,
896,4747,326,239,565,
897,4713,343,258,601,
898,4934,333,239,572,
900,4873,336,257,593,
901,4817,357,273,630,
903,63,4,5,9,
904,4843,363,261,624,
907,4850,354,262,616,
908,4873,360,271,631,
909,4897,397,269,666,
911,1143,85,58,143,
912,4982,338,286,624,
913,4884,322,298,620,
914,4669,326,251,577,
915,57,2,1,3,
916,4895,338,285,623,
917,4683,318,292,610,
918,211,9,14,23,
920,4880,376,260,636,
923,4902,327,278,605,
926,4880,334,253,587,
928,1223,97,68,165,
929,4950,385,271,656,
930,4792,330,291,621,
931,4910,361,280,641,
933,4876,359,290,649,
934,4860,347,261,608,
935,4937,349,293,642,
937,4710,353,244,597,
938,4847,354,285,639,
939,4939,357,307,664,
940,4657,304,283,587,
941,1131,81,60,141,
942,4824,370,298,668,
944,4806,348,319,667,
945,4684,373,245,618,
946,378,26,22,48,
947,228,16,9,25,
949,4817,348,288,636,
951,4879,364,288,652,
952,4828,337,272,609,
955,4742,386,248,634,
956,243,22,10,32,
957,705,38,36,74,
958,351,34,17,51,
959,4805,348,269,617,
960,958,71,55,126,
962,4782,313,246,559,
963,4834,338,290,628,
964,5043,381,299,680,
965,4781,340,272,612,
966,355,15,19,34,
967,4852,347,292,639,
968,2499,174,158,332,
969,348,30,25,55,
970,4886,332,281,613,
971,4820,357,273,630,
972,784,57,50,107,
977,4794,345,274,619,
978,4866,340,291,631,
979,4895,346,297,643,
980,89,6,6,12,
982,922,57,68,125,
983,4794,388,247,635,
984,311,36,17,53,
985,4868,351,299,650,
986,4745,331,265,596,
987,4956,338,268,606,
988,4883,347,274,621,
990,112,8,9,17,
992,404,26,26,52,
993,4830,336,289,625,
994,1276,92,75,167,
995,4938,384,270,654,
997,141,14,6,20,
998,672,39,40,79,
999,4639,363,265,628,
1001,4161,279,251,530,
1002,4760,351,274,625,
1003,246,17,17,34,
1004,4736,341,297,638,
1006,227,18,15,33,
1007,4802,336,274,610,
1008,107,9,4,13,
1011,4843,327,305,632,
1012,4923,354,267,621,
1013,4879,321,325,646,
1015,1172,73,64,137,
1017,4844,349,257,606,
1018,4887,374,274,648,
1019,4940,352,293,645,
1020,4597,298,260,558,
1021,4776,344,264,608,
1022,722,50,55,105,
1023,4953,350,277,627,
1024,4837,375,257,632,
1025,4880,345,261,606,
1026,4916,330,289,619,
1027,650,40,38,78,
1028,1116,80,70,150,
1029,4742,358,273,631,
1030,4950,361,263,624,
1031,4926,343,286,629,
1033,1172,82,72,154,
1034,4822,338,242,580,
1035,146,10,10,20,
1037,4801,339,290,629,
1038,4823,358,266,624,
1039,4831,338,329,667,
1040,3631,246,221,467,
1041,4908,329,314,643,
1042,4970,355,287,642,
1043,620,45,32,77,
1044,4894,357,297,654,
1046,4933,394,279,673,
1047,4969,396,277,673,
1048,4620,317,296,613,
1049,4664,324,259,583,
1051,4948,341,271,612,
1053,4814,363,247,610,
1055,236,16,15,31,
1058,4865,339,276,615,
1059,652,60,52,112,
1060,4906,368,294,662,
1061,4748,337,286,623,
1062,4718,327,278,605,
1063,4760,351,271,622,
1064,4862,331,270,601,
1065,4880,342,216,558,
1068,690,44,39,83,
1070,935,61,50,111,
1071,4929,355,313,668,
1074,4737,347,295,642,
1075,4914,370,271,641,
1076,4876,350,274,624,
1077,4743,355,287,642,
1078,482,35,39,74,
1079,4880,335,258,593,
1080,501,40,23,63,
1081,4757,331,285,616,
1082,4670,344,257,601,
1083,79,7,4,11,
1084,4894,340,281,621,
1085,427,39,19,58,
1086,4853,348,290,638,
1087,53,5,4,9,
1088,3724,294,191,485,
1089,4775,346,288,634,
1090,4750,337,278,615,
1091,4887,356,278,634,
1092,1242,80,72,152,
1093,4989,376,282,658,
1096,1071,82,44,126,
1097,594,41,36,77,
1098,565,39,32,71,
1099,4748,330,288,618,
1100,1232,82,75,157,
1102,4935,366,259,625,
1105,4853,368,290,658,
1107,4770,323,328,651,
1108,3823,282,199,481,
1109,4749,337,255,592,
1110,4864,367,267,634,
1112,4783,337,280,617,
1113,4959,384,319,703,
1114,5011,354,299,653,
1116,4720,349,256,605,
1117,4939,341,287,628,
1118,4927,368,292,660,
1119,88,3,3,6,
1122,4940,344,282,626,
1125,4815,352,295,647,
1126,4899,354,313,667,
1127,3280,263,199,462,
1128,178,11,11,22,
1129,388,30,28,58,
1130,4791,368,271,639,
1132,4910,356,278,634,
1133,4962,348,285,633,
1134,3907,313,206,519,
1135,444,27,25,52,
1137,750,59,54,113,
1138,4891,327,259,586,
1140,4748,316,257,573,
1141,4531,364,260,624,
1142,4771,402,245,647,
1143,1390,85,78,163,
1144,460,39,16,55,
1147,4978,385,266,651,
1149,48,1,3,4,
1150,3340,211,218,429,
1151,4805,373,288,661,
1152,4878,357,293,650,
1153,4810,363,278,641,
1154,4831,336,268,604,
1155,4847,356,274,630,
1157,4854,359,301,660,
1158,148,13,7,20,
1160,4869,341,285,626,
1161,4933,342,289,631,
1162,4908,356,273,629,
1163,4759,398,253,651,
1166,721,57,38,95,
1168,66,4,4,8,
1170,4882,363,272,635,
1171,313,25,17,42,
1172,4847,370,287,657,
1173,702,64,31,95,
1174,4894,310,264,574,
1176,230,11,8,19,
1179,4933,331,305,636,
1181,4871,354,273,627,
1182,343,28,20,48,
1183,4849,332,261,593,
1184,94,6,5,11,
1185,1468,107,72,179,
1186,110,8,7,15,
1187,4732,358,260,618,
1188,544,37,27,64,
1191,471,26,28,54,
1194,4926,349,294,643,
1195,5080,388,292,680,
1196,4874,372,280,652,
1197,5015,335,292,627,
1201,184,15,9,24,
1203,411,25,18,43,
1204,4905,359,253,612,
1205,4847,309,280,589,
1206,205,14,11,25,
1207,4686,328,263,591,
1208,4904,388,282,670,
1209,4983,389,288,677,
1210,4740,309,280,589,
1212,4657,333,294,627,
1213,5036,344,295,639,
1214,793,53,56,109,
1215,4869,361,275,636,
1217,4909,367,296,663,
1218,263,23,15,38,
1220,526,39,33,72,
1221,4824,357,279,636,
1222,4888,369,276,645,
1223,240,9,11,20,
1224,91,6,2,8,
1226,280,22,27,49,
1227,4874,337,287,624,
1228,4905,334,308,642,
1230,4741,357,270,627,
1231,4767,360,230,590,
1232,342,23,28,51,
1235,4777,343,282,625,
1236,630,41,26,67,
1237,367,30,18,48,
1238,621,40,33,73,
1239,1293,95,60,155,
1241,53,8,1,9,
1242,1206,85,65,150,
1243,4865,377,287,664,
1244,3794,268,216,484,
1245,3688,245,226,471,
1246,131,16,6,22,
1248,4952,384,305,689,
1249,4822,331,243,574,
1251,4849,365,298,663,
1252,4774,340,250,590,
1253,4843,314,259,573,
1255,3529,274,188,462,
1257,4820,344,291,635,
1258,542,38,24,62,
1259,5034,355,298,653,
1260,4702,356,258,614,
1261,826,51,27,78,
1262,4907,346,279,625,
1263,4827,341,255,596,
1264,4892,384,275,659,
1265,4698,328,256,584,
1267,4882,351,270,621,
1268,123,13,3,16,
1269,4921,395,295,690,
1271,4935,341,282,623,
1272,1257,94,74,168,
1273,4962,381,259,640,
1275,4836,331,278,609,
1277,3477,238,216,454,
1278,4812,365,296,661,
1280,51,4,6,10,
1283,4735,316,270,586,
1285,4727,335,270,605,
1288,4948,363,310,673,
1289,4847,365,268,633,
1290,4840,367,302,669,
1291,1898,134,124,258,
1293,428,30,27,57,
1295,4951,368,294,662,
1296,4854,335,276,611,
1298,780,58,45,103,
1299,4882,350,286,636,
1300,4918,344,277,621,
1301,4912,355,278,633,
1302,3005,190,192,382,
1303,4712,336,275,611,
1305,4798,354,291,645,
1306,4911,353,266,619,
1307,4940,354,303,657,
1308,4749,380,291,671,
1309,4743,378,251,629,
1310,86,4,1,5,
1311,4837,366,334,700,
1312,4775,349,281,630,
1313,4781,341,247,588,
1314,4714,350,222,572,
1315,4928,324,301,625,
1316,4830,368,264,632,
1317,131,8,12,20,
1318,3823,232,230,462,
1320,4723,347,245,592,
1321,4785,348,268,616,
1322,1715,134,90,224,
1324,4788,362,281,643,
1325,879,57,50,107,
1326,4746,345,240,585,
1327,1326,101,67,168,
1329,289,14,11,25,
1330,4860,349,286,635,
1331,4786,339,268,607,
1332,4735,356,277,633,
1333,1270,82,81,163,
1334,70,5,5,10,
1337,4807,342,262,604,
1338,1268,94,67,161,
1339,125,7,7,14,
1340,806,73,55,128,
1341,4779,338,244,582,
1342,4924,343,271,614,
1343,4875,368,303,671,
1344,4786,340,272,612,
1345,3634,267,210,477,
1346,4826,340,283,623,
1347,201,24,9,33,
1348,4901,358,305,663,
1350,4796,339,274,613,
1351,4802,318,298,616,
1352,219,15,8,23,
1353,4780,333,278,611,
1354,4780,357,262,619,
1355,452,35,38,73,
1356,1100,78,51,129,
1358,77,7,7,14,
1359,1165,83,78,161,
1360,4823,375,261,636,
1361,4821,358,257,615,
1362,4810,374,243,617,
1363,4731,353,258,611,
1364,4732,354,272,626,
1365,305,20,15,35,
1366,4804,354,290,644,
1368,400,35,21,56,
1369,4892,355,268,623,
1370,4820,340,314,654,
1371,3624,288,204,492,
1373,4867,304,282,586,
1375,4855,329,269,598,
1376,815,55,52,107,
1377,4769,348,260,608,
1378,4823,337,267,604,
1379,1268,80,88,168,
1381,4881,341,292,633,
1382,1137,87,68,155,
1383,4863,334,324,658,
1384,4755,338,306,644,
1385,4852,351,284,635,
1389,4814,357,261,618,
1391,4634,303,243,546,
1393,4833,385,250,635,
1394,4859,364,263,627,
1395,4870,344,273,617,
1396,58,4,2,6,
1397,4759,345,269,614,
1399,4946,385,276,661,
1400,4832,360,261,621,
1401,4730,343,271,614,
1402,4902,383,276,659,
1403,1349,100,88,188,
1405,4877,345,286,631,
1406,4830,354,254,608,
1409,3912,288,218,506,
1411,4834,340,280,620,
1412,3687,243,208,451,
1414,4818,355,287,642,
1416,351,29,18,47,
1417,4774,298,279,577,
1418,4755,338,251,589,
1419,4846,347,282,629,
1420,527,36,30,66,
1422,4793,326,253,579,
1424,4748,355,298,653,
1426,4840,360,293,653,
1427,4886,342,284,626,
1428,4994,324,316,640,
1429,4800,384,269,653,
1430,3742,267,235,502,
1431,4745,333,239,572,
1432,4897,381,281,662,
1433,4971,382,266,648,
1434,4838,332,250,582,
1436,4997,388,288,676,
1437,199,16,15,31,
1438,4883,373,280,653,
1439,825,62,53,115,
1440,849,68,33,101,
1441,4940,346,306,652,
1446,4872,369,292,661,
1447,857,58,58,116,
1448,835,65,44,109,
1449,4818,339,256,595,
1450,5003,391,298,689,
1451,4839,392,254,646,
1455,4918,371,284,655,
1456,4851,359,277,636,
1457,4861,334,296,630,
1458,525,30,32,62,
1459,612,48,48,96,
1460,4827,348,273,621,
1461,974,63,41,104,
1462,4810,380,282,662,
1465,4854,375,272,647,
1467,4931,354,252,606,
1468,4786,356,285,641,
1469,4838,355,254,609,
1470,4655,358,270,628,
1471,4936,371,266,637,
1472,4156,342,237,579,
1473,4878,376,275,651,
1474,4877,396,257,653,
1476,4832,340,295,635,
1477,4794,339,275,614,
1478,4982,357,302,659,
1480,781,59,38,97,
1482,4783,311,285,596,
1485,4867,370,226,596,
1486,1261,109,77,186,
1487,4934,354,281,635,
1488,4915,390,251,641,
1493,305,15,19,34,
1494,647,49,36,85,
1496,4844,334,308,642,
1498,222,25,12,37,
1500,3628,254,220,474,
1501,4866,339,272,611,
1504,3496,228,218,446,
1506,4967,356,286,642,
1507,4880,368,299,667,
1509,748,49,37,86,
1510,4747,306,279,585,
1511,4830,356,257,613,
1512,4981,355,289,644,
1513,558,23,35,58,
1514,4808,390,264,654,
1515,4949,402,272,674,
1516,4903,356,247,603,
1518,186,11,7,18,
1519,277,19,9,28,
1520,4920,342,279,621,
1522,1111,89,63,152,
1527,4864,363,285,648,
1528,4826,373,290,663,
1530,4816,336,253,589,
1531,4859,350,242,592,
1532,5062,371,307,678,
1534,500,42,28,70,
1537,4842,349,271,620,
1539,4940,358,283,641,
1541,170,11,6,17,
1542,4912,339,273,612,
1543,4692,323,283,606,
1544,4856,342,293,635,
1547,4740,331,245,576,
1548,4790,329,277,606,
1550,4887,348,262,610,
1551,4814,342,253,595,
1552,928,54,63,117,
1554,1394,96,76,172,
1556,4884,357,308,665,
1557,4845,370,268,638,
1559,4895,352,260,612,
1562,4861,319,264,583,
1563,4847,359,262,621,
1564,2648,184,152,336,
1565,3266,221,231,452,
1566,4928,334,264,598,
1567,4890,381,336,717,
1569,1397,111,83,194,
1570,4876,355,266,621,
1571,4162,337,236,573,
1572,4734,356,282,638,
1575,4831,358,298,656,
1577,99,9,8,17,
1578,4713,305,244,549,
1579,1045,81,78,159,
1580,4954,372,291,663,
1584,4955,394,297,691,
1585,4826,346,250,596,
1588,4849,335,274,609,
1589,4752,348,290,638,
1590,4795,351,272,623,
1591,4869,329,270,599,
1593,4765,337,281,618,
1595,698,44,41,85,
1597,4838,367,257,624,
1598,4960,355,271,626,
1600,4763,335,273,608,
1601,4777,334,255,589,
1602,255,21,12,33,
1603,4925,338,304,642,
1604,4748,376,250,626,
1605,4873,399,272,671,
1606,4764,325,282,607,
1608,2401,154,133,287,
1609,4883,369,270,639,
1614,338,27,29,56,
1617,4807,380,263,643,
1618,4716,323,282,605,
1620,4855,335,252,587,
1622,4700,352,250,602,
1625,467,41,22,63,
1626,4737,335,295,630,
1627,346,21,19,40,
1628,4864,355,265,620,
1629,4830,331,307,638,
1630,1623,123,95,218,
1632,3666,281,221,502,
1634,4938,324,292,616,
1635,585,32,30,62,
1636,605,47,30,77,
1637,233,20,12,32,
1639,3651,256,229,485,
1640,156,8,9,17,
1641,4874,347,247,594,
1642,3444,245,196,441,
1643,4797,359,254,613,
1644,5007,374,295,669,
1646,4853,369,275,644,
1647,4871,387,264,651,
1648,5032,363,314,677,
1649,4819,338,293,631,
1650,4861,361,274,635,
1651,4740,355,273,628,
1652,64,2,3,5,
1653,3512,254,205,459,
1654,4850,306,303,609,
1655,5001,353,286,639,
1656,153,18,8,26,
1657,379,23,28,51,
1658,4939,360,281,641,
1659,774,56,49,105,
1660,4802,333,287,620,
1661,3595,238,203,441,
1662,4807,334,277,611,
1663,5016,364,282,646,
1665,4773,355,256,611,
1666,4677,313,266,579,
1667,4825,348,237,585,
1668,4858,347,270,617,
1670,4786,361,256,617,
1671,5032,350,282,632,
1672,4872,357,264,621,
1673,4727,342,248,590,
1674,4790,334,256,590,
1675,4871,338,283,621,
1676,4700,390,234,624,
1677,4826,357,259,616,
1678,881,64,58,122,
1679,4785,322,293,615,
1680,4826,334,287,621,
1681,809,49,45,94,
1682,1334,75,77,152,
1683,4845,338,292,630,
1684,479,29,18,47,
1685,4842,349,292,641,
1686,2827,182,147,329,
1687,4917,345,289,634,
1688,4799,340,270,610,
1689,4774,367,270,637,
1690,4961,398,285,683,
1691,4755,341,269,610,
1692,4862,359,272,631,
1693,3800,274,223,497,
1695,4886,345,274,619,
1696,4777,344,287,631,
1697,4849,340,288,628,
1698,4939,367,287,654,
1699,854,51,42,93,
1702,4877,335,278,613,
1705,4839,341,254,595,
1707,273,10,19,29,
1709,4796,345,300,645,
1711,4836,371,257,628,
1713,581,44,33,77,
1714,933,72,66,138,
1715,4811,318,297,615,
1717,1741,122,99,221,
1718,1079,79,65,144,
1719,4933,370,286,656,
1720,4929,354,272,626,
1721,258,21,15,36,
1723,198,11,9,20,
1725,4831,328,265,593,
1726,97,3,5,8,
1727,4750,329,267,596,
1729,4867,346,302,648,
1730,475,35,33,68,
1731,4846,354,264,618,
1733,4887,365,273,638,
1735,4822,348,295,643,
1737,1154,76,66,142,
1738,4809,378,254,632,
1739,4652,338,287,625,
1740,4774,350,298,648,
1741,4740,332,260,592,
1742,4771,307,266,573,
1743,4766,355,279,634,
1745,1367,94,74,168,
1746,4885,383,278,661,
1747,4942,351,310,661,
1748,4857,350,253,603,
1749,4749,337,282,619,
1750,53,3,6,9,
1751,4891,386,273,659,
1753,4815,395,287,682,
1754,5037,365,264,629,
1757,4874,341,278,619,
1758,1183,82,56,138,
1763,1120,88,53,141,
1764,4616,349,251,600,
1765,4804,357,256,613,
1767,1541,123,82,205,
1768,4655,358,266,624,
1769,4760,327,290,617,
1770,4664,338,245,583,
1771,4775,285,292,577,
1772,393,22,26,48,
1773,4795,332,268,600,
1774,4844,325,278,603,
1775,4760,375,245,620,
1777,4904,348,297,645,
1778,4743,371,242,613,
1782,4766,350,288,638,
1784,4928,337,269,606,
1785,5004,373,268,641,
1787,4872,343,310,653,
1788,4931,363,276,639,
1790,4829,358,248,606,
1793,4799,377,266,643,
1794,4910,362,265,627,
1795,4764,354,266,620,
1796,4825,336,271,607,
1797,4810,323,282,605,
1798,4883,379,288,667,
1799,4949,404,267,671,
1800,978,70,71,141,
1802,4841,324,279,603,
1803,4896,382,276,658,
1804,4768,314,278,592,
1805,4900,355,267,622,
1806,1227,82,73,155,
1808,4838,314,299,613,
1809,4802,334,317,651,
1814,371,19,29,48,
1815,4847,360,255,615,
1816,4842,338,283,621,
1817,673,44,35,79,
1820,4926,358,270,628,
1821,4806,327,271,598,
1822,4720,350,264,614,
1824,4819,351,258,609,
1825,4988,386,281,667,
1826,4801,366,261,627,
1827,677,47,27,74,
1829,1380,93,67,160,
1830,411,35,33,68,
1831,764,52,45,97,
1832,4786,347,269,616,
1834,617,45,39,84,
1835,4858,342,291,633,
1836,4865,329,243,572,
1837,4916,368,279,647,
1839,4902,364,268,632,
1840,4849,380,234,614,
1841,4929,372,281,653,
1844,4832,323,268,591,
1845,4824,338,246,584,
1846,736,62,31,93,
1847,4786,337,264,601,
1848,4777,324,292,616,
1849,4930,357,292,649,
1853,674,45,31,76,
1854,4804,371,274,645,
1855,681,47,46,93,
1856,4834,351,303,654,
1857,448,22,21,43,
1858,4842,348,305,653,
1860,4986,377,296,673,
1861,4825,366,267,633,
1862,4871,353,275,628,
1864,4818,345,307,652,
1865,4766,381,265,646,
1866,1889,131,106,237,
1867,220,15,17,32,
1869,4878,364,282,646,
1870,4895,369,278,647,
1871,4868,351,276,627,
1872,4822,367,293,660,
1874,1167,79,68,147,
1875,448,30,38,68,
1876,4761,354,258,612,
1877,4783,338,258,596,
1878,4874,374,264,638,
1879,4840,359,276,635,
1881,676,57,42,99,
1882,4020,275,222,497,
1891,4749,340,262,602,
1892,4725,357,257,614,
1893,4877,372,254,626,
1894,79,5,6,11,
1897,3223,271,180,451,
1898,4925,350,259,609,
1900,4825,339,261,600,
1901,4778,351,275,626,
1902,4891,339,275,614,
1903,4853,346,249,595,
1904,4728,369,244,613,
1906,4865,386,274,660,
1907,4835,335,297,632,
1909,4844,364,270,634,
1910,489,32,26,58,
1912,4806,347,301,648,
1913,1382,96,82,178,
1914,1171,86,65,151,
1915,4942,335,296,631,
1916,4861,364,255,619,
1917,4825,374,253,627,
1919,1285,92,58,150,
1921,257,17,19,36,
1923,315,34,13,47,
1924,4822,361,253,614,
1927,4730,332,273,605,
1928,4913,370,279,649,
1929,4792,348,271,619,
1931,4960,366,242,608,
1933,4968,364,273,637,
1934,4709,345,278,623,
1935,3360,220,208,428,
1937,5018,396,260,656,
1938,928,55,65,120,
1939,3386,286,211,497,
1940,4757,383,266,649,
1941,4867,341,267,608,
1943,4836,347,264,611,
1946,4829,346,275,621,
1947,4890,335,272,607,
1948,4924,389,286,675,
1949,4806,349,276,625,
1950,3653,292,198,490,
1951,4722,346,271,617,
1952,4843,322,287,609,
1953,4905,366,291,657,
1954,583,39,29,68,
1955,4793,316,284,600,
1957,4817,371,292,663,
1958,4871,340,276,616,
1960,4812,360,308,668,
1962,4889,332,277,609,
1963,4784,390,264,654,
1964,4738,370,264,634,
1965,4849,339,285,624,
1966,128,3,5,8,
1967,4861,325,294,619,
1973,4834,363,265,628,
1974,190,14,15,29,
1976,4868,333,282,615,
1977,4908,354,273,627,
1978,3042,212,161,373,
1979,327,21,13,34,
1983,958,75,49,124,
1985,4826,356,288,644,
1987,5023,369,268,637,
1989,427,31,24,55,
1990,1532,113,95,208,
1991,4814,383,272,655,
1994,4726,305,249,554,
1995,184,12,10,22,
1996,1253,89,72,161,
1997,4920,381,267,648,
1998,4421,292,278,570,
1999,486,27,25,52,
2000,4901,352,280,632,
2002,4889,358,237,595,
2004,4906,360,264,624,
2005,4858,372,293,665,
2006,4765,342,231,573,
2008,1244,91,66,157,
2010,4875,334,272,606,
2011,1728,113,97,210,
2012,4727,367,257,624,
2013,1660,110,68,178,
2014,4882,343,303,646,
2015,4884,358,267,625,
2017,4932,365,262,627,
2020,4886,328,302,630,
2021,4628,330,294,624,
2022,4884,373,303,676,
2023,4957,364,293,657,
2024,4848,346,284,630,
2027,1584,108,82,190,
2028,4898,374,273,647,
2029,1273,83,75,158,
2030,4709,360,256,616,
2031,615,45,39,84,
2033,4870,368,277,645,
2034,4758,349,291,640,
2036,4911,365,294,659,
2037,1375,103,69,172,
2038,4828,339,259,598,
2039,4904,340,274,614,
2040,137,12,6,18,
2041,360,36,18,54,
2042,64,8,2,10,
2043,4795,352,285,637,
2044,4927,340,293,633,
2045,586,44,32,76,
2047,4842,397,262,659,
2049,4881,336,285,621,
2050,1062,84,59,143,
2051,470,29,23,52,
2052,4915,359,286,645,
2054,4823,327,255,582,
2055,4896,363,285,648,
2056,4689,364,250,614,
2057,4789,388,248,636,
2058,4793,370,257,627,
2059,4754,360,245,605,
2060,338,16,12,28,
2064,3399,254,180,434,
2065,4920,343,284,627,
2066,4779,331,276,607,
2068,4666,337,277,614,
2069,4803,379,251,630,
2071,4736,334,277,611,
2072,4890,383,243,626,
2074,5001,357,278,635,
2077,1394,105,86,191,
2079,4763,373,273,646,
2080,292,24,16,40,
2081,4798,348,297,645,
2082,4961,388,286,674,
2084,1233,88,68,156,
2086,1343,70,81,151,
2087,3823,322,170,492,
2090,4908,361,276,637,
2091,3323,195,175,370,
2092,4962,351,290,641,
2093,4861,354,278,632,
2095,4822,369,284,653,
2096,4728,313,268,581,
2097,1250,99,70,169,
2098,4773,351,283,634,
2099,266,17,10,27,
2100,4982,350,276,626,
2101,4815,386,260,646,
2102,4721,334,285,619,
2104,85,8,2,10,
2106,4748,354,260,614,
2107,3750,294,220,514,
2108,100,6,7,13,
2109,4815,343,296,639,
2110,361,32,15,47,
2111,4705,346,291,637,
2112,1269,64,99,163,
2113,4930,363,288,651,
2114,4919,353,246,599,
2115,31,5,2,7,
2116,4958,390,291,681,
2117,4740,353,291,644,
2118,4849,323,273,596,
2121,611,54,34,88,
2122,30,1,1,2,
2126,4831,346,281,627,
2127,1340,97,69,166,
2128,1041,76,57,133,
2129,4770,343,290,633,
2130,1260,94,73,167,
2132,4943,355,277,632,
2133,4684,363,242,605,
2134,1559,104,90,194,
2135,273,27,9,36,
2136,73,3,2,5,
2137,145,9,8,17,
2138,4824,329,247,576,
2139,4798,343,255,598,
2140,4862,361,275,636,
2141,2190,156,123,279,
2143,4892,356,281,637,
2144,4831,355,284,639,
2147,120,8,7,15,
2148,4787,347,297,644,
2149,772,47,44,91,
2151,974,87,46,133,
2152,4841,375,266,641,
2153,4882,381,282,663,
2154,4798,342,277,619,
2155,4941,351,276,627,
2156,4895,365,260,625,
2158,4822,330,266,596,
2160,4817,308,321,629,
2161,4703,340,255,595,
2163,4909,328,274,602,
2164,182,12,8,20,
2165,4715,371,251,622,
2166,4692,331,264,595,
2167,1176,91,63,154,
2168,4840,339,279,618,
2169,496,46,29,75,
2171,4817,327,303,630,
2172,919,65,56,121,
2173,4975,352,295,647,
2174,331,21,17,38,
2175,669,51,30,81,
2176,4945,327,288,615,
2177,4791,350,283,633,
2178,4831,317,310,627,
2179,4041,296,206,502,
2180,5043,363,248,611,
2181,4805,364,264,628,
2185,34,4,2,6,
2187,4829,351,269,620,
2188,1260,114,83,197,
2189,152,10,8,18,
2190,4763,372,290,662,
2191,4775,319,285,604,
2193,4757,347,251,598,
2194,805,59,38,97,
2195,4852,346,286,632,
2196,4886,361,268,629,
2197,4897,351,260,611,
2198,4905,326,281,607,
2199,4779,327,301,628,
2201,4730,346,302,648,
2202,4565,343,290,633,
2206,953,72,59,131,
2208,653,45,37,82,
2209,517,37,34,71,
2211,4643,342,272,614,
2212,845,67,44,111,
2213,5005,401,273,674,
2214,4750,324,272,596,
2215,4876,358,264,622,
2216,4847,325,312,637,
2217,4776,357,293,650,
2218,425,32,23,55,
2220,4904,341,285,626,
2221,1530,99,89,188,
2222,4868,337,277,614,
2223,28,2,1,3,
2224,4828,375,258,633,
2225,4990,382,272,654,
2227,4792,320,250,570,
2228,4872,344,307,651,
2231,4955,337,274,611,
2232,3709,263,218,481,
2234,4890,340,266,606,
2235,4824,331,282,613,
2236,4662,388,248,636,
2238,4945,360,285,645,
2239,4711,342,269,611,
2242,662,51,38,89,
2244,4874,339,265,604,
2245,4938,349,273,622,
2246,4707,302,319,621,
2247,4873,388,285,673,
2248,4809,345,233,578,
2250,234,22,6,28,
2251,4745,342,260,602,
2252,633,54,37,91,
2254,4801,342,268,610,
2255,5023,358,263,621,
2256,4772,331,280,611,
2257,1371,97,77,174,
2258,189,24,14,38,
2259,1399,106,81,187,
2260,4769,384,265,649,
2261,4906,385,259,644,
2262,4819,372,291,663,
2263,783,38,47,85,
2266,4839,360,294,654,
2267,5072,378,291,669,
2268,4876,347,289,636,
2269,4758,344,248,592,
2270,4915,349,272,621,
2272,129,9,13,22,
2274,478,38,26,64,
2276,4985,346,292,638,
2277,5057,411,265,676,
2278,4851,356,295,651,
2279,4641,375,260,635,
2280,4694,336,261,597,
2281,4886,376,233,609,
2282,3559,250,191,441,
2284,4667,329,270,599,
2285,4775,343,256,599,
2286,4981,327,317,644,
2287,4901,383,259,642,
2288,870,49,57,106,
2289,4887,368,301,669,
2290,4870,342,295,637,
2291,4890,348,255,603,
2293,4815,344,257,601,
2295,336,28,16,44,
2296,487,28,26,54,
2297,4854,369,252,621,
2298,4696,346,247,593,
2299,4820,391,254,645,
2302,4776,341,262,603,
2306,877,69,49,118,
2307,772,61,48,109,
2308,4902,352,285,637,
2309,1544,113,77,190,
2311,4872,328,253,581,
2313,4734,322,262,584,
2316,3641,300,201,501,
2320,4894,351,291,642,
2321,1256,98,61,159,
2322,921,49,61,110,
2323,4945,368,288,656,
2324,4942,357,269,626,
2326,4945,380,226,606,
2327,217,11,19,30,
2329,4797,367,275,642,
2330,4856,330,288,618,
2331,4706,335,253,588,
2332,4778,343,256,599,
2334,5035,365,274,639,
2336,4903,346,293,639,
2337,4851,366,242,608,
2338,4824,350,280,630,
2339,4792,366,272,638,
2341,207,16,11,27,
2342,862,52,50,102,
2343,127,9,7,16,
2344,266,20,13,33,
2345,4788,363,257,620,
2347,4759,339,259,598,
2350,4926,323,271,594,
2351,4828,351,286,637,
2352,4785,342,291,633,
2354,310,19,18,37,
2355,4801,344,312,656,
2356,4759,334,270,604,
2358,4935,352,272,624,
2359,4871,367,280,647,
2361,105,10,10,20,
2362,4773,327,266,593,
2363,4962,358,263,621,
2364,5038,347,291,638,
2366,4892,355,290,645,
2367,4952,355,308,663,
2368,1064,80,66,146,
2369,4829,357,255,612,
2371,4800,362,266,628,
2373,1286,91,65,156,
2374,4906,355,277,632,
2377,4673,339,245,584,
2378,3713,250,210,460,
2380,4843,339,289,628,
2381,894,58,56,114,
2382,4737,345,248,593,
2383,1301,116,66,182,
2384,5043,354,261,615,
2385,791,54,44,98,
2386,4782,308,248,556,
2388,4923,332,289,621,
2391,4737,339,252,591,
2392,4778,373,260,633,
2393,4772,361,274,635,
2396,4886,344,285,629,
2398,5094,350,258,608,
2399,4804,332,288,620,
2400,4760,344,243,587,
2401,1267,97,70,167,
2403,4797,333,272,605,
2404,63,9,4,13,
2405,4722,323,308,631,
2406,4841,357,273,630,
2407,575,48,37,85,
2408,4888,362,289,651,
2409,524,35,27,62,
2413,4853,365,273,638,
2414,4812,370,283,653,
2415,4925,349,275,624,
2416,4847,313,303,616,
2417,4900,376,295,671,
2418,4875,336,249,585,
2419,275,12,18,30,
2421,4752,354,246,600,
2424,4825,344,274,618,
2425,4905,353,298,651,
2426,4680,336,268,604,
2427,4836,360,257,617,
2429,4986,359,303,662,
2430,190,6,16,22,
2433,4878,339,255,594,
2434,383,25,25,50,
2435,4839,315,262,577,
2437,4918,356,274,630,
2438,4870,353,300,653,
2439,4988,347,295,642,
2441,4828,352,286,638,
2442,4774,344,264,608,
2444,19,2,2,4,
2446,4810,321,312,633,
2447,1620,131,100,231,
2450,1134,76,61,137,
2451,4634,356,259,615,
2452,4750,324,311,635,
2453,4714,317,253,570,
2454,308,19,15,34,
2455,4910,352,284,636,
2456,4779,324,297,621,
2457,4807,331,248,579,
2459,51,2,1,3,
2460,977,75,45,120,
2462,4854,358,269,627,
2463,4898,356,272,628,
2464,4943,370,277,647,
2466,1909,143,103,246,
2467,2173,141,130,271,
2468,4723,344,290,634,
2471,4863,355,293,648,
2472,4824,348,278,626,
2474,4762,344,266,610,
2475,4850,355,268,623,
2476,4824,368,264,632,
2477,4698,327,226,553,
2478,4855,322,305,627,
2479,4877,316,297,613,
2481,4809,349,249,598,
2483,4882,350,296,646,
2484,4925,340,271,611,
2485,4960,359,274,633,
2487,1902,137,104,241,
2488,4735,298,294,592,
2489,4855,372,278,650,
2490,169,11,8,19,
2491,4910,322,262,584,
2494,4827,353,285,638,
2497,1624,101,79,180,
2498,980,45,60,105,
2499,1499,115,85,200,
2500,4686,377,265,642,
2502,4897,360,285,645,
2503,4800,368,284,652,
2505,4779,315,270,585,
2506,4827,367,287,654,
2507,848,76,41,117,
2508,1824,135,112,247,
2509,1189,101,78,179,
2510,4778,310,272,582,
2511,4749,347,280,627,
2512,5032,390,287,677,
2513,4686,309,282,591,
2514,5013,359,255,614,
2515,4880,359,279,638,
2516,4958,321,289,610,
2517,4946,327,274,601,
2518,4859,389,277,666,
2519,4920,366,289,655,
2520,1585,136,84,220,
2521,4784,372,280,652,
2522,4826,370,285,655,
2523,3561,255,202,457,
2525,4854,340,263,603,
2526,4869,327,272,599,
2527,4956,346,281,627,
2528,1194,86,58,144,
2529,4841,334,298,632,
2530,4801,336,273,609,
2531,4796,369,282,651,
2532,4825,351,274,625,
2533,4753,331,277,608,
2534,4771,366,266,632,
2536,4868,372,290,662,
2537,4898,379,274,653,
2538,4935,394,293,687,
2540,4783,366,251,617,
2541,4920,362,285,647,
2542,4655,349,263,612,
2544,301,17,16,33,
2545,4828,359,272,631,
2546,4981,354,285,639,
2547,4806,306,258,564,
2548,4896,300,291,591,
2549,4945,352,294,646,
2551,4801,384,260,644,
2552,594,35,33,68,
2553,1155,94,64,158,
2554,4965,360,282,642,
2555,4849,329,239,568,
2556,4884,309,259,568,
2557,4804,356,270,626,
2558,4814,321,265,586,
2560,4814,343,274,617,
2561,4744,352,269,621,
2562,4855,319,281,600,
2565,4822,369,277,646,
2566,4895,344,288,632,
2567,4835,347,240,587,
2568,4817,339,288,627,
2569,4787,337,290,627,
2570,4726,361,246,607,
2572,4836,350,241,591,
2573,1236,99,59,158,
2575,4798,354,283,637,
2576,4805,348,265,613,
2577,4724,338,298,636,
2578,4993,375,302,677,
2579,4811,321,304,625,
2581,4901,343,298,641,
2582,4952,373,279,652,
2583,4804,368,282,650,
2584,327,20,16,36,
2586,474,39,28,67,
2587,4978,371,302,673,
2589,1457,116,59,175,
2590,4767,325,304,629,
2591,4840,353,261,614,
2593,4665,330,269,599,
2594,4947,333,267,600,
2595,1235,88,87,175,
2596,4847,363,295,658,
2597,1226,85,64,149,
2599,845,63,50,113,
2600,4833,370,286,656,
2601,4711,323,248,571,
2602,4832,354,280,634,
2605,828,54,44,98,
2607,4763,344,296,640,
2608,1073,86,67,153,
2609,4850,372,259,631,
2610,4868,363,255,618,
2611,3913,247,228,475,
2612,4847,390,243,633,
2613,1309,87,87,174,
2614,4891,359,266,625,
2617,4890,380,263,643,
2618,4643,371,221,592,
2619,4910,352,289,641,
2621,2129,154,132,286,
2623,4800,358,276,634,
2624,4746,320,291,611,
2625,441,40,18,58,
2626,4928,348,317,665,
2627,4889,339,269,608,
2629,3467,244,200,444,
2631,4789,380,261,641,
2632,4941,383,268,651,
2633,134,5,12,17,
2635,4901,356,282,638,
2636,4898,389,291,680,
2637,4808,329,276,605,
2638,4730,330,279,609,
2639,4793,353,263,616,
2640,617,43,35,78,
2644,4870,375,256,631,
2646,4876,353,274,627,
2647,118,7,11,18,
2648,4851,391,259,650,
2649,4894,344,260,604,
2651,4832,343,257,600,
2652,4886,333,270,603,
2653,4786,336,258,594,
2654,4785,371,246,617,
2655,4856,382,276,658,
2656,4824,372,269,641,
2658,4862,348,248,596,
2659,4956,365,314,679,
2661,4759,314,257,571,
2662,600,46,28,74,
2663,897,52,59,111,
2664,4888,346,287,633,
2666,1180,97,76,173,
2667,4916,367,276,643,
2668,5022,395,275,670,
2669,4730,340,278,618,
2670,4832,380,286,666,
2671,33,1,3,4,
2674,438,27,23,50,
2676,746,46,53,99,
2677,4850,338,287,625,
2678,3848,261,227,488,
2679,4819,373,264,637,
2680,4691,312,286,598,
2681,4104,375,226,601,
2683,4802,362,287,649,
2684,4824,353,297,650,
2685,4781,377,280,657,
2687,1179,84,60,144,
2688,4798,358,255,613,
2689,846,52,50,102,
2691,581,42,41,83,
2692,1631,113,91,204,
2693,4941,347,270,617,
2694,4908,346,269,615,
2695,4800,331,299,630,
2696,4935,356,271,627,
2697,91,6,7,13,
2698,4821,352,289,641,
2700,4834,382,276,658,
2703,4837,385,299,684,
2704,714,53,40,93,
2705,4807,360,291,651,
2706,4776,346,270,616,
2707,555,37,39,76,
2708,5003,371,281,652,
2709,998,63,47,110,
2711,4863,313,270,583,
2713,4853,377,270,647,
2715,4873,374,289,663,
2716,4842,333,268,601,
2717,4832,356,276,632,
2718,4860,379,281,660,
2720,4760,332,268,600,
2722,522,41,27,68,
2723,37,3,2,5,
2724,4855,355,296,651,
2725,4835,369,243,612,
2726,3973,303,237,540,
2728,4871,360,259,619,
2729,4824,323,292,615,
2730,4732,378,274,652,
2731,4791,340,258,598,
2733,4877,375,257,632,
2734,4850,355,302,657,
2735,4904,345,267,612,
2737,689,49,38,87,
2738,4883,370,296,666,
2739,4767,342,264,606,
2741,1834,129,122,251,
2742,814,54,47,101,
2743,4752,339,263,602,
2745,4917,353,306,659,
2746,4929,331,274,605,
2747,1635,135,107,242,
2748,4703,317,273,590,
2749,4890,361,273,634,
2751,4819,354,282,636,
2752,4940,343,280,623,
2754,4851,387,296,683,
2755,4818,376,278,654,
2756,4825,355,246,601,
2757,4856,345,288,633,
2761,448,26,28,54,
2762,4998,377,267,644,
2763,5015,362,275,637,
2764,4854,351,267,618,
2765,794,58,47,105,
2766,4935,380,311,691,
2767,494,37,25,62,
2768,4835,361,261,622,
2770,4665,324,279,603,
2772,186,12,8,20,
2773,4818,331,271,602,
2774,3402,293,169,462,
2777,394,35,13,48,
2779,4905,354,274,628,
2780,4853,332,279,611,
2781,4900,348,275,623,
2782,4740,300,314,614,
2783,1040,74,72,146,
2784,4741,323,311,634,
2785,4816,364,258,622,
2786,4754,327,314,641,
2787,515,39,28,67,
2790,4873,329,275,604,
2791,4914,335,266,601,
2792,19,3,3,6,
2794,4737,313,278,591,
2795,4927,376,284,660,
2796,4861,386,286,672,
2797,4863,342,254,596,
2798,4889,358,260,618,
2800,864,59,47,106,
2801,4631,341,273,614,
2802,4908,388,253,641,
2803,4923,356,304,660,
2804,4849,369,258,627,
2805,690,46,26,72,
2806,2086,153,108,261,
2807,4897,374,264,638,
2809,107,6,8,14,
2811,4556,338,267,605,
2812,4714,312,281,593,
2813,4858,335,265,600,
2815,4917,335,280,615,
2816,445,27,24,51,
2818,1174,81,73,154,
2819,568,40,36,76,
2820,990,78,52,130,
2821,4665,319,269,588,
2822,3576,261,202,463,
2823,4990,334,285,619,
2824,3739,259,213,472,
2825,1330,95,57,152,
2826,4816,360,255,615,
2827,4869,378,270,648,
2828,4814,368,292,660,
2829,4886,348,291,639,
2830,4789,350,268,618,
2831,4850,342,272,614,
2832,4848,336,285,621,
2833,4885,300,249,549,
2835,4914,366,275,641,
2836,4898,361,286,647,
2837,743,54,40,94,
2838,463,31,22,53,
2839,1035,72,58,130,
2840,4803,366,248,614,
2841,4933,342,275,617,
2842,4863,345,254,599,
2843,556,31,31,62,
2844,4809,359,312,671,
2845,4690,343,286,629,
2846,4959,325,329,654,
2847,4960,332,306,638,
2848,4955,390,253,643,
2849,4582,335,246,581,
2851,4840,365,263,628,
2852,3549,230,192,422,
2853,4882,342,309,651,
2855,4782,379,288,667,
2856,4762,330,278,608,
2857,1780,116,84,200,
2859,4925,375,262,637,
2860,4676,339,270,609,
2861,4825,337,253,590,
2864,4708,359,312,671,
2865,4772,310,304,614,
2866,4849,336,288,624,
2867,1945,129,105,234,
2870,4764,353,247,600,
2871,4931,335,308,643,
2872,4822,322,238,560,
2873,1376,84,85,169,
2874,4780,350,260,610,
2875,4887,357,266,623,
2878,4818,354,273,627,
2879,4877,391,256,647,
2880,4785,367,273,640,
2881,4654,318,258,576,
2882,5003,382,285,667,
2883,4807,360,290,650,
2884,925,73,52,125,
2885,4866,357,296,653,
2887,654,50,44,94,
2888,4737,340,264,604,
2889,4772,365,282,647,
2890,206,19,22,41,
2891,4820,351,265,616,
2893,1252,82,83,165,
2894,4782,318,321,639,
2895,4893,366,264,630,
2896,4917,345,287,632,
2897,4856,341,265,606,
2898,1460,107,76,183,
2900,3623,259,221,480,
2902,1479,113,77,190,
2903,4923,337,272,609,
2904,728,58,45,103,
2905,4785,336,247,583,
2906,4887,346,286,632,
2907,4852,362,271,633,
2908,4898,376,287,663,
2909,4922,335,265,600,
2910,4627,356,277,633,
2911,4933,356,288,644,
2912,4775,329,265,594,
2913,4743,347,269,616,
2914,4891,344,297,641,
2915,4799,346,284,630,
2916,1084,78,58,136,
2917,1010,79,62,141,
2918,556,33,36,69,
2919,134,7,12,19,
2920,4761,336,271,607,
2922,4775,332,244,576,
2923,4720,321,264,585,
2924,4800,371,272,643,
2925,4919,369,260,629,
2926,4891,375,285,660,
2927,4815,306,298,604,
2928,4719,352,270,622,
2930,4860,358,287,645,
2931,4857,291,258,549,
2933,4917,356,303,659,
2934,4862,364,276,640,
2936,4617,341,272,613,
2938,271,23,9,32,
2939,794,50,44,94,
2941,516,26,27,53,
2943,1091,85,54,139,
2944,4746,359,268,627,
2945,196,13,16,29,
2946,1592,123,85,208,
2947,4740,341,275,616,
2950,369,28,13,41,
2951,486,47,27,74,
2953,4835,340,278,618,
2955,4756,336,294,630,
2956,3619,257,227,484,
2960,4778,388,283,671,
2961,4994,366,282,648,
2963,310,22,17,39,
2966,4762,358,300,658,
2967,4793,340,257,597,
2968,4726,386,243,629,
2969,39,3,2,5,
2970,652,53,34,87,
2971,4917,328,288,616,
2972,1076,88,61,149,
2974,4791,345,264,609,
2975,4846,308,305,613,
2977,1131,82,62,144,
2978,4923,378,280,658,
2979,824,63,35,98,
2980,4750,392,279,671,
2981,397,30,22,52,
2982,4767,353,277,630,
2985,40,4,1,5,
2986,4904,412,273,685,
2987,677,51,36,87,
2989,4755,329,242,571,
2990,4836,371,276,647,
2991,4910,341,271,612,
2992,371,28,22,50,
2993,4841,363,271,634,
2994,4864,328,256,584,
2995,4851,354,302,656,
2996,4911,339,290,629,
2997,1679,112,97,209,
2998,4753,349,258,607,
3000,4696,356,278,634,
3001,4679,339,274,613,
3002,837,50,43,93,
3005,4958,387,279,666,
3006,4779,322,276,598,
3008,460,34,21,55,
3010,4837,382,270,652,
3012,4834,359,301,660,
3013,4785,351,261,612,
3014,530,50,33,83,
3016,4827,374,292,666,
3017,4816,363,286,649,
3018,1329,97,74,171,
3019,4795,370,246,616,
3020,4916,324,292,616,
3021,52,1,3,4,
3022,4896,344,281,625,
3023,4840,363,269,632,
3024,3975,275,239,514,
3025,4680,317,307,624,
3026,4713,352,248,600,
3028,4985,381,300,681,
3029,4813,352,270,622,
3030,4769,356,239,595,
3031,4708,337,292,629,
3032,976,50,47,97,
3033,4667,339,280,619,
3035,4709,331,266,597,
3036,973,69,59,128,
3037,1352,86,84,170,
3038,4843,358,260,618,
3040,4808,354,270,624,
3041,339,23,20,43,
3044,4823,344,260,604,
3045,624,53,38,91,
3046,430,38,27,65,
3047,4815,342,275,617,
3048,4707,347,275,622,
3049,5011,348,293,641,
3052,4824,331,283,614,
3053,4753,366,266,632,
3054,926,66,54,120,
3055,947,66,50,116,
3056,4796,310,300,610,
3058,4710,329,267,596,
3059,1423,98,69,167,
3060,4895,365,275,640,
3061,4860,381,263,644,
3063,4804,363,260,623,
3065,4923,383,283,666,
3067,1339,111,85,196,
3068,4709,320,273,593,
3069,297,27,13,40,
3070,4948,364,252,616,
3071,4779,340,251,591,
3072,4843,366,282,648,
3073,1255,108,67,175,
3074,4840,335,283,618,
3075,4778,346,282,628,
3076,4969,360,286,646,
3077,4849,333,274,607,
3079,4867,330,293,623,
3080,4870,373,272,645,
3081,4831,329,322,651,
3084,4774,335,269,604,
3085,4956,359,287,646,
3086,24,3,1,4,
3087,4848,361,283,644,
3088,4825,368,262,630,
3089,354,29,17,46,
3092,4865,362,279,641,
3093,209,18,8,26,
3094,4900,344,275,619,
3095,71,7,4,11,
3097,524,30,28,58,
3098,649,48,38,86,
3100,4923,338,289,627,
3101,237,16,14,30,
3102,4909,357,279,636,
3103,4712,336,283,619,
3104,4858,379,267,646,
3105,4795,343,270,613,
3106,4993,365,292,657,
3107,4803,359,246,605,
3108,1860,137,120,257,
3110,1553,89,81,170,
3112,4758,326,294,620,
3113,4740,360,260,620,
3114,4927,352,268,620,
3115,4833,355,277,632,
3117,4813,358,259,617,
3121,4957,350,281,631,
3122,4708,345,278,623,
3123,4765,355,272,627,
3124,1084,79,52,131,
3126,4025,283,227,510,
3127,4772,342,288,630,
3133,4951,370,284,654,
3134,100,8,8,16,
3135,4849,344,251,595,
3137,517,42,34,76,
3138,1267,97,80,177,
3139,4952,398,305,703,
3140,3681,274,207,481,
3141,4947,380,303,683,
3143,4690,333,269,602,
3144,676,46,44,90,
3145,4744,362,282,644,
3147,4948,369,284,653,
3148,4958,373,283,656,
3150,4811,372,263,635,
3151,4798,366,243,609,
3152,4741,326,281,607,
3153,255,17,12,29,
3154,4878,341,288,629,
3157,683,58,39,97,
3158,4711,389,282,671,
3160,4912,339,283,622,
3163,4102,298,267,565,
3164,4699,316,283,599,
3165,4949,340,268,608,
3167,4728,329,272,601,
3171,4811,356,279,635,
3173,12,2,1,3,
3175,1548,128,92,220,
3176,4682,354,251,605,
3177,4893,360,277,637,
3178,4769,382,312,694,
3179,3784,323,181,504,
3180,613,49,33,82,
3182,1233,75,71,146,
3183,444,30,23,53,
3184,38,1,1,2,
3186,4785,370,279,649,
3187,4962,385,260,645,
3188,1298,104,74,178,
3190,3906,268,217,485,
3191,4685,329,257,586,
3192,4825,365,259,624,
3194,1806,133,105,238,
3195,4663,340,271,611,
3196,737,50,37,87,
3197,4701,344,273,617,
3198,4898,368,289,657,
3199,21,3,2,5,
3200,4925,356,278,634,
3201,4847,364,296,660,
3205,4944,379,289,668,
3206,4901,364,278,642,
3208,4975,394,289,683,
3210,4879,357,279,636,
3211,4868,347,264,611,
3212,4820,310,261,571,
3213,4864,368,272,640,
3214,215,9,20,29,
3215,5009,380,294,674,
3216,580,38,39,77,
3217,4836,350,245,595,
3218,4848,343,265,608,
3219,4763,348,287,635,
3220,4866,328,289,617,
3221,4706,373,259,632,
3222,4966,358,291,649,
3223,4684,358,281,639,
3224,4919,356,294,650,
3225,4952,355,289,644,
3226,546,39,32,71,
3228,4795,365,260,625,
3229,4720,338,256,594,
3230,4969,389,311,700,
3231,3668,284,217,501,
3233,4945,390,269,659,
3234,4213,350,229,579,
3235,4952,378,277,655,
3236,4764,354,278,632,
3237,4852,354,275,629,
3238,4908,340,257,597,
3239,159,12,10,22,
3240,4892,369,272,641,
3241,4782,342,266,608,
3242,4806,303,272,575,
3243,659,58,32,90,
3244,364,33,26,59,
3245,415,19,26,45,
3247,4832,338,271,609,
3248,375,31,22,53,
3253,4714,324,288,612,
3254,4827,340,264,604,
3255,4878,357,284,641,
3256,145,13,12,25,
3257,4806,368,299,667,
3258,4922,353,246,599,
3259,4988,353,271,624,
3260,4738,339,255,594,
3261,142,9,7,16,
3264,4891,349,271,620,
3267,4718,376,319,695,
3268,182,14,13,27,
3269,4941,365,277,642,
3270,4823,338,266,604,
3272,4789,342,279,621,
3274,4929,367,258,625,
3275,4728,330,240,570,
3276,1022,65,58,123,
3277,786,62,53,115,
3278,4821,352,304,656,
3279,4919,342,266,608,
3280,4889,324,306,630,
3283,4879,352,289,641,
3284,4925,332,275,607,
3286,207,12,16,28,
3287,4891,327,261,588,
3288,4761,342,268,610,
3289,4879,329,281,610,
3290,1803,130,107,237,
3291,4860,384,277,661,
3292,60,3,1,4,
3293,682,56,33,89,
3294,4910,350,295,645,
3295,4853,363,279,642,
3296,4895,334,291,625,
3297,5024,356,301,657,
3299,1080,74,56,130,
3300,371,35,22,57,
3301,1068,57,62,119,
3303,4868,347,275,622,
3305,4783,344,268,612,
3306,929,62,56,118,
3307,3960,297,231,528,
3308,4814,323,288,611,
3309,4820,324,279,603,
3311,4879,338,297,635,
3312,4856,353,252,605,
3313,4818,363,285,648,
3314,4870,387,303,690,
3317,4875,324,296,620,
3318,1523,100,72,172,
3320,4686,398,266,664,
3321,4925,383,282,665,
3322,1724,128,99,227,
3326,4825,337,265,602,
3327,4791,311,300,611,
3329,4637,367,249,616,
3330,4836,366,317,683,
3331,4881,369,285,654,
3335,4910,342,266,608,
3336,115,9,10,19,
3337,700,51,37,88,
3338,4783,322,243,565,
3340,4694,373,237,610,
3343,4832,348,277,625,
3344,4829,323,268,591,
3345,4810,341,283,624,
3346,4843,308,293,601,
3347,4752,326,283,609,
3348,281,14,18,32,
3349,4927,348,276,624,
3350,4868,375,273,648,
3351,819,62,51,113,
3352,4895,382,306,688,
3353,848,58,52,110,
3354,4635,294,256,550,
3355,4825,338,308,646,
3356,4833,311,279,590,
3357,730,52,29,81,
3358,789,61,45,106,
3360,4817,346,270,616,
3361,4763,336,289,625,
3362,275,16,12,28,
3363,4836,360,285,645,
3365,4827,365,273,638,
3367,333,21,14,35,
3368,4775,304,284,588,
3369,4863,358,286,644,
3372,4928,355,269,624,
3374,54,3,5,8,
3375,736,48,61,109,
3376,4941,347,282,629,
3377,4836,358,263,621,
3378,4825,371,262,633,
3380,4937,385,291,676,
3381,4960,372,289,661,
3382,4889,346,283,629,
3383,4763,363,270,633,
3384,4856,357,295,652,
3385,896,62,47,109,
3386,4894,358,278,636,
3387,4856,375,260,635,
3388,175,17,16,33,
3389,1167,88,56,144,
3390,4723,355,269,624,
3391,4935,350,274,624,
3392,4718,361,269,630,
3394,4782,362,237,599,
3396,4968,333,287,620,
3397,4893,378,287,665,
3400,4928,363,292,655,
3401,4728,318,293,611,
3402,4794,317,312,629,
3403,4880,361,288,649,
3404,4889,358,265,623,
3405,4963,339,273,612,
3406,4848,337,300,637,
3407,249,19,12,31,
3408,4903,394,292,686,
3409,4828,336,260,596,
3410,4678,342,266,608,
3411,4795,380,252,632,
3412,2410,189,134,323,
3413,138,7,10,17,
3414,4858,405,246,651,
3415,4892,359,283,642,
3416,996,71,62,133,
3417,4985,366,267,633,
3419,4976,356,258,614,
3420,4962,344,302,646,
3421,4893,367,312,679,
3422,4798,347,270,617,
3423,4817,330,269,599,
3426,4888,350,276,626,
3427,888,56,46,102,
3428,4799,337,267,604,
3431,4833,391,277,668,
3432,811,56,43,99,
3436,4785,342,259,601,
3437,1059,97,73,170,
3440,4807,334,270,604,
3441,1210,91,78,169,
3442,4820,342,268,610,
3444,4733,365,275,640,
3445,1364,94,72,166,
3446,61,5,3,8,
3447,815,52,42,94,
3448,4656,330,254,584,
3449,4807,370,287,657,
3450,4890,377,268,645,
3451,4883,338,272,610,
3452,214,22,7,29,
3453,4733,338,265,603,
3455,534,39,27,66,
3457,4865,316,276,592,
3458,4754,356,267,623,
3459,323,22,21,43,
3460,4795,379,297,676,
3461,178,15,13,28,
3463,4836,356,260,616,
3464,216,16,11,27,
3465,1837,141,104,245,
3466,1045,57,57,114,
3467,4823,387,248,635,
3468,924,54,51,105,
3471,4760,334,248,582,
3472,4679,346,271,617,
3473,4923,312,288,600,
3474,4911,347,303,650,
3475,4913,342,280,622,
3476,3610,238,220,458,
3478,1050,72,62,134,
3479,4773,360,283,643,
3480,4814,314,302,616,
3481,4713,332,298,630,
3483,4742,310,263,573,
3484,4850,336,291,627,
3485,3302,281,171,452,
3486,4861,366,283,649,
3488,4926,332,274,606,
3491,4810,378,283,661,
3492,4828,365,283,648,
3493,4887,337,272,609,
3495,4960,370,257,627,
3496,1588,109,87,196,
3497,129,9,5,14,
3498,4918,352,292,644,
3499,50,5,1,6,
3500,968,74,67,141,
3501,4851,375,301,676,
3502,4757,338,255,593,
3503,4823,343,300,643,
3504,891,84,49,133,
3505,628,50,32,82,
3506,4846,326,273,599,
3509,5028,318,298,616,
3511,4738,380,272,652,
3513,92,6,3,9,
3514,573,40,42,82,
3515,4792,329,235,564,
3516,4739,327,259,586,
3517,539,44,29,73,
3520,61,7,5,12,
3521,4808,324,265,589,
3522,5027,382,267,649,
3523,395,30,18,48,
3524,348,30,19,49,
3525,4749,302,277,579,
3527,4837,338,303,641,
3528,4885,365,265,630,
3529,4742,353,262,615,
3530,4824,314,264,578,
3531,797,63,45,108,
3533,4989,325,292,617,
3534,3759,264,203,467,
3535,314,25,11,36,
3536,4872,363,262,625,
3537,1156,69,61,130,
3538,4758,326,280,606,
3539,4877,399,274,673,
3540,268,17,18,35,
3541,1150,88,66,154,
3542,675,49,32,81,
3545,4870,354,271,625,
3548,4957,366,256,622,
3549,4958,333,306,639,
3550,3647,257,225,482,
3553,5027,365,281,646,
3554,80,7,4,11,
3555,3838,245,206,451,
3556,4684,324,276,600,
3557,4754,382,240,622,
3559,4913,354,301,655,
3560,4811,399,262,661,
3561,392,29,21,50,
3562,1103,67,45,112,
3563,854,58,56,114,
3565,629,53,40,93,
3566,4719,331,280,611,
3567,1081,86,50,136,
3568,4729,356,253,609,
3571,1421,98,88,186,
3572,4719,350,258,608,
3574,4935,362,322,684,
3575,4882,427,243,670,
3576,234,23,15,38,
3577,4977,352,308,660,
3578,537,39,30,69,
3579,4917,351,255,606,
3580,4732,309,297,606,
3582,4895,363,258,621,
3583,3758,264,209,473,
3585,3622,247,204,451,
3587,134,15,8,23,
3588,4788,364,243,607,
3589,4733,363,288,651,
3590,4927,339,322,661,
3591,4788,344,273,617,
3592,4884,357,285,642,
3593,293,22,12,34,
3594,4818,316,269,585,
3596,4798,377,263,640,
3597,4946,369,259,628,
3600,4951,360,284,644,
3601,4956,356,317,673,
3602,1215,85,85,170,
3603,852,66,45,111,
3604,4831,352,281,633,
3605,4938,381,278,659,
3607,4952,361,266,627,
3608,4729,333,301,634,
3609,3614,268,207,475,
3610,4787,358,255,613,
3612,179,20,4,24,
3614,4765,348,249,597,
3615,4765,330,263,593,
3616,505,32,25,57,
3618,4827,355,256,611,
3619,5059,367,292,659,
3620,4886,352,285,637,
3622,4894,345,272,617,
3624,4909,370,316,686,
3625,4860,342,251,593,
3626,4753,321,278,599,
3627,4902,347,291,638,
3628,4949,332,297,629,
3629,4016,296,206,502,
3632,4864,352,283,635,
3638,687,44,37,81,
3639,221,13,16,29,
3640,5011,364,294,658,
3641,351,26,12,38,
3642,71,5,5,10,
3643,1323,123,58,181,
3644,516,32,32,64,
3645,291,18,16,34,
3646,4866,341,256,597,
3647,125,12,3,15,
3649,4868,328,264,592,
3651,1456,118,83,201,
3652,4875,348,281,629,
3653,3733,278,198,476,
3654,762,62,35,97,
3655,4950,334,316,650,
3658,4952,383,287,670,
3659,4758,317,259,576,
3660,1194,83,63,146,
3664,1188,88,61,149,
3666,4879,372,290,662,
3667,4858,355,266,621,
3668,1766,120,110,230,
3670,4891,363,285,648,
3671,4556,330,254,584,
3673,821,58,40,98,
3675,1322,97,70,167,
3677,4886,386,266,652,
3678,775,64,34,98,
3679,529,35,28,63,
3681,4215,346,255,601,
3682,3720,235,209,444,
3684,4752,336,325,661,
3685,4860,364,260,624,
3686,1284,86,72,158,
3687,802,77,48,125,
3688,4756,369,257,626,
3689,4866,305,274,579,
3691,4833,341,279,620,
3692,4831,341,288,629,
3693,4816,331,291,622,
3695,4870,339,265,604,
3697,4876,329,300,629,
3698,70,2,9,11,
3699,341,31,9,40,
3701,4894,379,293,672,
3702,4808,331,258,589,
3703,4853,375,263,638,
3705,340,36,34,70,
3706,4808,370,278,648,
3707,323,27,11,38,
3708,868,53,57,110,
3709,4766,340,275,615,
3710,1086,84,59,143,
3714,4991,342,296,638,
3715,4959,358,284,642,
3716,4891,358,242,600,
3717,126,12,8,20,
3718,4900,401,281,682,
3719,4895,350,279,629,
3720,335,18,20,38,
3721,4800,388,278,666,
3722,4838,354,282,636,
3723,2420,186,151,337,
3724,119,9,6,15,
3725,4787,359,245,604,
3726,4759,341,273,614,
3727,269,18,11,29,
3728,1314,91,80,171,
3729,4803,324,301,625,
3730,4815,354,271,625,
3731,3676,263,215,478,
3732,4861,356,267,623,
3734,4850,328,274,602,
3735,4981,330,273,603,
3736,167,14,14,28,
3737,81,6,4,10,
3738,3673,259,202,461,
3739,231,17,15,32,
3740,1889,128,110,238,
3741,1240,104,71,175,
3743,1086,86,59,145,
3745,4874,360,295,655,
3746,4867,336,283,619,
3748,881,72,56,128,
3749,418,38,14,52,
3750,4826,400,287,687,
3751,1273,91,76,167,
3752,4903,390,245,635,
3753,4955,344,272,616,
3754,825,67,52,119,
3755,4848,349,279,628,
3756,4922,356,268,624,
3759,4898,366,286,652,
3761,3863,247,245,492,
3762,4747,359,251,610,
3763,474,22,29,51,
3765,1193,93,70,163,
3767,4968,353,275,628,
3768,4687,362,279,641,
3770,4961,373,273,646,
3772,4728,333,309,642,
3773,856,73,52,125,
3777,4999,383,277,660,
3778,4593,348,283,631,
3779,4882,368,278,646,
3780,4812,370,268,638,
3781,3309,257,183,440,
3782,4803,347,244,591,
3785,4992,328,273,601,
3786,4825,337,290,627,
3788,4956,397,278,675,
3790,1770,125,115,240,
3791,4894,371,266,637,
3793,3701,259,167,426,
3794,4675,353,254,607,
3797,4877,362,288,650,
3798,914,70,60,130,
3800,727,55,40,95,
3801,4818,355,281,636,
3803,4933,374,270,644,
3804,4835,358,259,617,
3805,4733,329,266,595,
3806,4832,319,308,627,
3807,594,51,26,77,
3809,4779,307,310,617,
3810,4776,384,245,629,
3811,4852,342,263,605,
3814,298,19,17,36,
3815,4758,346,273,619,
3817,4945,324,271,595,
3818,4696,370,248,618,
3819,4855,382,280,662,
3820,4796,373,237,610,
3823,218,21,8,29,
3824,4933,344,277,621,
3828,181,15,11,26,
3829,4754,354,259,613,
3831,4840,389,258,647,
3836,631,48,32,80,
3837,4778,365,257,622,
3838,4795,357,276,633,
3839,1600,120,81,201,
3840,715,61,38,99,
3841,4855,345,280,625,
3842,1164,78,64,142,
3843,4637,335,238,573,
3844,4755,339,250,589,
3846,4910,338,278,616,
3847,4839,325,289,614,
3848,4985,376,274,650,
3849,4894,311,300,611,
3850,358,21,23,44,
3851,482,34,29,63,
3852,1003,64,59,123,
3853,4850,362,301,663,
3858,1241,94,83,177,
3859,4998,392,299,691,
3860,4868,327,278,605,
3861,325,19,21,40,
3863,4879,330,270,600,
3864,4882,342,277,619,
3865,4792,341,277,618,
3866,4674,351,252,603,
3868,415,20,27,47,
3869,4804,402,234,636,
3870,4889,330,286,616,
3871,266,19,17,36,
3873,4865,339,264,603,
3874,4669,361,240,601,
3875,4185,246,263,509,
3877,4834,348,256,604,
3878,4921,333,293,626,
3879,1405,97,71,168,
3880,4627,327,270,597,
3881,4812,329,283,612,
3882,4784,358,278,636,
3883,763,55,52,107,
3885,4857,359,251,610,
3886,988,66,61,127,
3888,4891,335,290,625,
3889,4884,348,289,637,
3890,4912,374,284,658,
3891,375,28,28,56,
3893,4916,362,263,625,
3895,4881,373,256,629,
3896,686,48,55,103,
3897,4940,353,281,634,
3898,4833,329,276,605,
3900,4706,325,293,618,
3901,4839,355,278,633,
3903,5007,349,296,645,
3905,4781,307,284,591,
3906,4699,379,264,643,
3907,4790,360,252,612,
3908,4876,304,289,593,
3910,683,50,47,97,
3911,4871,352,287,639,
3912,4859,303,283,586,
3913,4929,346,260,606,
3914,4716,365,271,636,
3917,4741,338,257,595,
3918,4843,320,265,585,
3919,5002,343,274,617,
3920,4884,325,288,613,
3921,839,57,50,107,
3922,3774,296,187,483,
3924,558,39,33,72,
3925,4861,377,284,661,
3926,4881,346,261,607,
3927,241,15,15,30,
3929,4804,357,270,627,
3931,4900,364,295,659,
3932,52,5,5,10,
3934,4908,350,273,623,
3935,4930,353,289,642,
3936,4821,358,264,622,
3937,90,8,4,12,
3942,4811,350,296,646,
3944,4915,343,284,627,
3945,1082,79,51,130,
3947,1275,106,73,179,
3948,68,4,5,9,
3950,5000,316,294,610,
3952,4677,340,227,567,
3953,838,75,52,127,
3954,4859,326,248,574,
3955,1280,97,61,158,
3956,70,5,4,9,
3957,1393,83,73,156,
3959,4889,367,279,646,
3960,1088,77,52,129,
3961,1107,71,67,138,
3962,481,35,26,61,
3963,4649,325,239,564,
3964,4926,335,282,617,
3965,4699,356,273,629,
3966,4779,312,265,577,
3967,1514,108,95,203,
3969,4910,356,242,598,
3970,4774,322,276,598,
3973,679,52,33,85,
3974,4798,346,295,641,
3975,4899,359,275,634,
3976,4871,369,258,627,
3977,4896,362,304,666,
3978,219,12,10,22,
3979,4765,359,266,625,
3980,4883,341,274,615,
3981,1172,84,80,164,
3982,4826,345,264,609,
3983,4902,369,250,619,
3984,4811,334,296,630,
3985,3730,288,189,477,
3988,27,3,3,6,
3989,4965,354,299,653,
3990,4773,373,252,625,
3991,4879,365,303,668,
3992,815,62,50,112,
3993,5030,371,307,678,
3994,4873,343,307,650,
3997,4946,348,284,632,
3998,4714,314,252,566,
3999,934,59,49,108,
4000,359,20,20,40,
4002,4790,346,271,617,
4006,4959,315,277,592,
4008,4864,332,299,631,
4010,4867,370,286,656,
4011,4770,323,241,564,
4014,4973,368,313,681,
4016,498,43,22,65,
4018,2705,186,142,328,
4019,199,20,10,30,
4020,4858,366,282,648,
4021,4815,366,272,638,
4022,4747,358,264,622,
4023,3603,264,193,457,
4024,4890,352,254,606,
4025,4716,280,266,546,
4026,4906,326,307,633,
4027,3588,254,214,468,
4029,4870,339,291,630,
4030,4058,253,236,489,
4031,248,22,13,35,
4032,4911,362,281,643,
4033,4996,392,302,694,
4034,581,34,32,66,
4036,4811,356,265,621,
4038,454,29,18,47,
4039,4893,333,298,631,
4041,4779,377,287,664,
4045,4918,346,291,637,
4046,4893,378,270,648,
4047,141,12,11,23,
4048,4803,300,364,664,
4051,4914,394,305,699,
4053,4850,350,247,597,
4054,4955,338,340,678,
4056,4909,339,297,636,
4057,4773,356,279,635,
4058,4835,363,273,636,
4059,4819,364,264,628,
4060,4827,337,264,601,
4061,386,22,26,48,
4062,593,54,29,83,
4063,4752,377,241,618,
4064,4831,328,282,610,
4065,4806,316,281,597,
4067,826,65,47,112,
4068,4888,369,289,658,
4069,254,11,15,26,
4070,4651,317,257,574,
4071,4802,312,300,612,
4072,950,67,61,128,
4073,4701,304,297,601,
4075,4942,360,277,637,
4076,3650,282,198,480,
4077,4920,353,258,611,
4078,4889,370,300,670,
4080,4779,367,260,627,
4082,4904,364,264,628,
4083,1008,68,60,128,
4084,154,10,8,18,
4085,4897,357,272,629,
4087,4912,342,281,623,
4088,4940,368,267,635,
4089,318,26,20,46,
4091,4869,341,282,623,
4092,137,16,8,24,
4093,3758,279,199,478,
4096,3955,291,207,498,
4097,4751,316,269,585,
4098,824,49,47,96,
4099,1407,106,84,190,
4101,208,21,8,29,
4102,762,59,30,89,
4103,5033,390,288,678,
4104,281,15,16,31,
4105,4773,383,299,682,
4106,4919,370,304,674,
4107,427,33,24,57,
4108,1450,96,85,181,
4109,4672,316,288,604,
4110,4613,327,283,610,
4111,4880,349,253,602,
4112,4937,356,267,623,
4113,4835,346,267,613,
4114,82,9,5,14,
4115,4838,322,302,624,
4116,4704,367,242,609,
4117,4921,355,299,654,
4118,4817,368,291,659,
4119,4806,359,265,624,
4120,534,38,34,72,
4121,4854,357,271,628,
4122,4717,363,263,626,
4123,4858,309,285,594,
4125,4761,345,277,622,
4127,4782,378,277,655,
4128,4902,356,286,642,
4129,4802,342,294,636,
4130,3932,326,195,521,
4131,279,15,17,32,
4132,194,15,6,21,
4133,4831,327,296,623,
4135,4777,361,255,616,
4140,1043,76,56,132,
4141,68,7,8,15,
4142,4422,306,235,541,
4143,1345,84,83,167,
4146,97,9,1,10,
4147,946,62,60,122,
4148,4868,314,270,584,
4149,4884,380,282,662,
4151,4994,359,295,654,
4152,276,14,10,24,
4153,4782,330,284,614,
4154,4835,351,291,642,
4156,656,39,29,68,
4159,4739,308,275,583,
4160,3780,264,215,479,
4161,4642,324,263,587,
4163,1521,90,88,178,
4164,4927,339,278,617,
4165,4943,373,258,631,
4166,903,64,51,115,
4168,4793,358,267,625,
4169,4821,332,275,607,
4170,4858,354,282,636,
4171,271,25,17,42,
4172,4749,333,234,567,
4173,4905,367,272,639,
4174,4928,349,279,628,
4175,4753,341,265,606,
4176,39,2,1,3,
4177,4877,328,275,603,
4178,4906,355,297,652,
4180,1819,116,104,220,
4181,1963,143,103,246,
4182,4719,315,296,611,
4183,66,6,4,10,
4184,4791,321,285,606,
4185,4721,316,260,576,
4186,4666,361,250,611,
4188,4761,356,242,598,
4189,4766,351,264,615,
4194,565,31,27,58,
4196,4742,324,270,594,
4199,236,23,13,36,
4200,4892,338,279,617,
4201,758,57,35,92,
4203,4829,357,273,630,
4204,4957,367,295,662,
4206,607,49,29,78,
4207,4841,362,283,645,
4208,4817,319,269,588,
4209,4842,348,294,642,
4210,4943,330,234,564,
4211,3598,227,219,446,
4214,384,33,20,53,
4215,4870,365,293,658,
4216,1282,89,81,170,
4217,1328,97,69,166,
4218,250,8,23,31,
4219,4839,362,257,619,
4220,275,21,17,38,
4221,4803,319,281,600,
4222,4783,353,254,607,
4223,4883,350,275,625,
4224,237,12,8,20,
4225,4815,339,274,613,
4226,1264,92,80,172,
4227,4838,322,255,577,
4228,5033,396,303,699,
4229,1237,77,66,143,
4230,4859,346,285,631,
4231,4930,352,285,637,
4232,4876,334,275,609,
4234,4913,393,275,668,
4235,4775,371,268,639,
4236,91,9,3,12,
4238,4789,340,278,618,
4239,4774,327,269,596,
4242,4908,344,254,598,
4243,1265,93,76,169,
4244,430,31,34,65,
4245,4792,374,265,639,
4246,215,10,13,23,
4247,66,2,2,4,
4248,4666,319,259,578,
4249,4816,373,278,651,
4250,4851,345,274,619,
4251,4842,335,280,615,
4252,1149,77,83,160,
4253,499,25,26,51,
4254,4992,356,310,666,
4255,4803,349,266,615,
4256,4934,400,265,665,
4257,3415,215,225,440,
4258,4685,350,238,588,
4259,4790,377,269,646,
4260,4728,324,284,608,
4261,4834,357,275,632,
4262,218,17,16,33,
4263,3555,239,209,448,
4264,4804,357,280,637,
4265,4792,361,263,624,
4266,4989,350,294,644,
4267,4816,371,263,634,
4268,4786,337,257,594,
4269,4641,339,234,573,
4270,5008,363,297,660,
4271,128,11,3,14,
4272,1289,91,63,154,
4273,4868,335,265,600,
4275,89,7,6,13,
4278,1229,91,66,157,
4279,4943,398,293,691,
4280,4824,328,261,589,
4281,758,55,37,92,
4282,4902,363,270,633,
4284,105,7,4,11,
4285,6,1,1,2,
4288,4990,361,322,683,
4289,4934,362,284,646,
4291,4806,337,268,605,
4292,4732,351,242,593,
4293,4958,344,298,642,
4294,4751,328,268,596,
4296,4962,370,293,663,
4297,4867,337,278,615,
4298,4831,312,282,594,
4299,499,35,33,68,
4300,4897,370,270,640,
4301,4789,376,260,636,
4302,4885,356,268,624,
4303,4859,368,279,647,
4304,765,55,43,98,
4305,1203,68,62,130,
4308,4915,329,268,597,
4310,172,9,9,18,
4311,4798,359,267,626,
4312,1106,68,63,131,
4313,4927,352,253,605,
4316,1567,112,87,199,
4317,4764,339,277,616,
4318,4747,365,271,636,
4319,4752,384,243,627,
4320,4942,369,301,670,
4323,32,3,1,4,
4324,1090,73,63,136,
4325,4938,348,302,650,
4326,4848,354,277,631,
4328,4776,321,271,592,
4329,386,33,21,54,
4330,4627,331,267,598,
4331,154,13,20,33,
4333,4892,383,242,625,
4334,4793,313,297,610,
4335,4804,343,279,622,
4336,4844,354,284,638,
4338,4907,366,275,641,
4339,399,30,15,45,
4341,4897,347,265,612,
4342,4830,351,266,617,
4343,221,23,18,41,
4345,4837,331,282,613,
4346,4808,340,253,593,
4347,25,1,1,2,
4348,4837,362,262,624,
4349,1218,98,69,167,
4350,4864,313,317,630,
4351,4951,358,316,674,
4352,981,73,65,138,
4353,3327,256,180,436,
4354,1637,114,104,218,
4355,4836,357,284,641,
4356,4842,340,266,606,
4357,180,23,7,30,
4358,4769,371,255,626,
4359,4846,346,275,621,
4360,4936,344,305,649,
4361,4787,375,278,653,
4362,5006,387,267,654,
4364,1278,103,81,184,
4365,1326,95,87,182,
4366,4785,361,257,618,
4367,4805,359,275,634,
4368,4868,321,277,598,
4370,1715,125,78,203,
4371,4948,372,260,632,
4373,4753,312,236,548,
4374,4931,338,286,624,
4375,4883,334,276,610,
4376,262,18,14,32,
4377,966,70,54,124,
4380,3498,245,201,446,
4381,4884,336,275,611,
4383,215,16,9,25,
4384,2368,156,131,287,
4386,310,18,13,31,
4387,4769,385,254,639,
4388,4799,331,299,630,
4390,4836,373,234,607,
4391,4733,329,268,597,
4392,246,18,22,40,
4393,4846,357,261,618,
4394,4865,355,232,587,
4396,311,26,19,45,
4397,4923,376,287,663,
4398,4852,376,253,629,
4399,4920,388,307,695,
4400,384,28,26,54,
4401,4877,368,266,634,
4402,1178,81,74,155,
4406,4839,332,277,609,
4408,4772,325,295,620,
4409,4873,335,287,622,
4410,4682,333,286,619,
4412,4914,330,278,608,
4413,4846,384,280,664,
4414,4914,361,288,649,
4415,4909,362,268,630,
4416,204,18,6,24,
4417,554,44,34,78,
4418,607,47,42,89,
4419,4722,332,253,585,
4420,4858,339,301,640,
4422,206,17,17,34,
4423,4900,344,259,603,
4424,4893,340,293,633,
4425,4682,309,288,597,
4426,82,5,5,10,
4427,730,49,43,92,
4428,4800,366,264,630,
4430,942,64,56,120,
4432,4825,341,276,617,
4434,4887,371,285,656,
4435,4748,364,268,632,
4436,4888,380,292,672,
4437,3884,251,226,477,
4438,1257,87,70,157,
4439,4926,415,284,699,
4440,4803,331,288,619,
4442,673,42,40,82,
4443,4778,319,291,610,
4444,4893,355,269,624,
4445,4808,394,266,660,
4449,4775,330,282,612,
4450,4920,320,292,612,
4451,4802,374,271,645,
4452,4797,288,281,569,
4453,4927,357,280,637,
4454,4859,383,253,636,
4456,1464,112,81,193,
4457,4880,332,267,599,
4459,4773,376,239,615,
4460,191,7,9,16,
4461,130,10,6,16,
4462,4894,364,271,635,
4463,161,16,4,20,
4464,4776,340,291,631,
4465,4895,380,275,655,
4466,4823,367,294,661,
4467,406,31,22,53,
4468,3744,289,186,475,
4469,4722,325,249,574,
4470,4811,345,281,626,
4473,4803,357,271,628,
4475,4833,345,259,604,
4476,4450,312,292,604,
4477,58,6,3,9,
4478,4801,319,275,594,
4480,1147,81,87,168,
4481,4845,343,260,603,
4482,4986,368,281,649,
4484,4820,331,287,618,
4485,315,25,18,43,
4487,4727,359,266,625,
4489,4828,352,243,595,
4491,4738,362,257,619,
4493,5047,377,273,650,
4494,4776,364,260,624,
4497,736,68,42,110,
4500,440,34,24,58,
4501,4982,380,258,638,
4502,634,36,35,71,
4503,4847,341,274,615,
4505,3521,279,172,451,
4506,4857,327,281,608,
4507,307,19,19,38,
4508,4882,352,293,645,
4510,4949,344,300,644,
4511,4813,362,236,598,
4513,4937,367,265,632,
4514,803,64,41,105,
4515,273,21,10,31,
4517,4930,367,281,648,
4518,4879,377,268,645,
4519,5036,350,260,610,
4520,4697,354,270,624,
4521,4812,312,247,559,
4522,4948,366,262,628,
4523,4753,304,268,572,
4524,4865,378,264,642,
4525,4791,344,234,578,
4526,4830,341,264,605,
4527,4869,337,282,619,
4529,4915,355,269,624,
4530,4811,343,276,619,
4531,4794,328,266,594,
4532,4657,338,268,606,
4533,4770,337,271,608,
4534,4837,396,248,644,
4535,4769,365,258,623,
4536,5056,365,263,628,
4537,4949,419,291,710,
4538,4840,325,288,613,
4539,4709,363,254,617,
4540,4873,335,262,597,
4541,1947,120,119,239,
4542,4067,298,191,489,
4543,4851,314,279,593,
4545,93,5,6,11,
4546,158,4,4,8,
4547,4878,380,286,666,
4548,502,31,35,66,
4549,4619,344,233,577,
4550,4714,411,229,640,
4551,4973,375,279,654,
4552,4958,363,295,658,
4554,411,28,26,54,
4555,4839,371,220,591,
4557,4731,393,255,648,
4558,97,15,4,19,
4559,5033,353,307,660,
4560,78,4,2,6,
4563,4907,344,281,625,
4564,4833,317,268,585,
4566,4801,344,320,664,
4568,571,47,36,83,
4569,4862,343,281,624,
4570,4942,302,298,600,
4571,4806,357,296,653,
4572,4930,344,289,633,
4574,1318,79,83,162,
4576,352,28,27,55,
4577,4829,299,300,599,
4578,4923,346,254,600,
4579,899,77,51,128,
4580,4765,368,251,619,
4581,4866,344,232,576,
4582,4897,342,256,598,
4583,4922,333,285,618,
4585,123,10,1,11,
4586,456,28,16,44,
4588,1093,76,73,149,
4589,4856,335,304,639,
4590,4787,342,261,603,
4591,826,46,43,89,
4592,4821,356,292,648,
4594,161,17,16,33,
4596,3541,242,213,455,
4597,4722,321,278,599,
4598,4806,366,286,652,
4600,4986,390,284,674,
4602,4850,354,286,640,
4603,4880,352,289,641,
4604,816,56,51,107,
4606,4925,323,314,637,
4608,3768,248,212,460,
4611,284,18,17,35,
4612,4963,355,277,632,
4613,1136,98,70,168,
4614,1043,74,70,144,
4616,4898,353,318,671,
4617,259,18,10,28,
4620,4877,337,300,637,
4621,4855,370,267,637,
4622,150,14,8,22,
4623,153,8,12,20,
4624,4848,369,288,657,
4625,4802,371,293,664,
4626,771,56,48,104,
4629,147,11,11,22,
4630,376,28,21,49,
4631,803,52,51,103,
4633,4771,318,293,611,
4634,4986,374,292,666,
4635,4729,313,272,585,
4636,904,49,48,97,
4637,4871,330,304,634,
4638,4915,371,284,655,
4639,4876,391,261,652,
4640,4723,327,258,585,
4641,4915,343,302,645,
4642,4951,354,296,650,
4643,446,33,30,63,
4644,4840,353,258,611,
4645,3548,247,202,449,
4646,4671,335,249,584,
4647,4989,341,273,614,
4649,4952,375,287,662,
4650,651,53,29,82,
4651,4826,345,256,601,
4652,4790,334,270,604,
4653,3501,249,227,476,
4654,4792,301,326,627,
4655,4721,311,266,577,
4656,1009,74,47,121,
4657,3623,277,209,486,
4658,4970,347,300,647,
4659,4958,362,273,635,
4661,405,29,19,48,
4662,4783,338,253,591,
4663,4809,324,318,642,
4664,1325,87,62,149,
4665,354,24,20,44,
4666,598,40,43,83,
4669,1503,122,75,197,
4670,4993,395,290,685,
4671,188,18,8,26,
4672,4865,340,263,603,
4674,4839,346,289,635,
4675,4792,352,272,624,
4676,675,46,41,87,
4678,4860,331,264,595,
4680,4790,345,274,619,
4681,4229,306,238,544,
4682,4809,321,265,586,
4683,4828,357,312,669,
4684,4845,370,268,638,
4685,3894,296,217,513,
4687,4666,338,261,599,
4688,3380,229,182,411,
4689,4739,340,288,628,
4691,100,6,6,12,
4692,4898,315,294,609,
4693,4862,389,267,656,
4694,4737,331,268,599,
4695,4844,355,287,642,
4696,52,5,4,9,
4700,4931,383,291,674,
4702,4896,321,291,612,
4703,4845,339,307,646,
4704,5031,345,284,629,
4706,4680,330,275,605,
4707,4849,314,290,604,
4708,591,43,36,79,
4709,625,56,34,90,
4710,4764,351,279,630,
4711,4882,353,271,624,
4712,4761,351,257,608,
4713,465,33,40,73,
4714,4849,334,271,605,
4715,4868,375,266,641,
4716,1515,117,103,220,
4717,4915,342,305,647,
4718,4812,363,281,644,
4719,4858,354,253,607,
4721,4921,355,275,630,
4723,4928,368,273,641,
4724,4817,321,275,596,
4725,4962,353,285,638,
4726,4694,345,263,608,
4728,4729,332,278,610,
4729,4953,364,276,640,
4731,824,55,45,100,
4732,4833,370,271,641,
4734,801,54,53,107,
4735,823,59,48,107,
4736,5071,357,278,635,
4737,4786,342,249,591,
4738,4954,345,265,610,
4739,298,16,22,38,
4740,4856,372,296,668,
4741,3875,300,201,501,
4742,41,2,1,3,
4744,336,14,16,30,
4745,4821,332,279,611,
4746,4866,341,282,623,
4748,5044,355,294,649,
4749,4741,334,266,600,
4752,4961,332,284,616,
4754,4771,348,257,605,
4757,4928,373,290,663,
4758,431,39,24,63,
4759,4784,346,244,590,
4760,4768,330,265,595,
4762,1225,93,64,157,
4763,5009,351,303,654,
4764,917,60,54,114,
4765,4879,356,259,615,
4767,4708,315,286,601,
4768,4867,366,301,667,
4769,4922,381,271,652,
4770,4891,338,263,601,
4771,329,33,21,54,
4772,1368,95,73,168,
4773,4815,346,256,602,
4774,58,9,4,13,
4775,4801,343,275,618,
4776,4911,341,311,652,
4777,4947,385,297,682,
4778,1291,119,69,188,
4779,4834,337,245,582,
4780,4777,368,272,640,
4782,4919,370,263,633,
4784,4976,400,261,661,
4785,4809,368,241,609,
4786,5074,377,295,672,
4787,4908,353,289,642,
4789,207,14,18,32,
4790,4778,336,254,590,
4791,4689,294,294,588,
4792,4868,358,282,640,
4793,4880,374,265,639,
4794,165,10,8,18,
4795,4900,370,248,618,
4796,4853,340,276,616,
4797,4820,358,278,636,
4799,986,68,58,126,
4800,1234,104,68,172,
4801,4780,335,248,583,
4803,4879,356,269,625,
4804,4828,349,274,623,
4806,4811,345,257,602,
4807,4960,369,317,686,
4808,3671,250,221,471,
4809,4112,290,230,520,
4810,4812,369,223,592,
4811,4900,362,270,632,
4812,4799,326,272,598,
4813,4848,330,291,621,
4814,895,53,42,95,
4815,4821,316,287,603,
4818,4787,354,270,624,
4819,183,17,8,25,
4820,4827,359,232,591,
4821,252,20,14,34,
4825,4719,324,256,580,
4826,4077,311,221,532,
4827,4884,324,253,577,
4828,4952,356,295,651,
4829,831,53,40,93,
4830,764,47,48,95,
4831,4665,361,258,619,
4833,421,35,19,54,
4834,4736,316,301,617,
4835,4890,341,279,620,
4837,4817,328,305,633,
4838,4919,340,278,618,
4839,4684,339,254,593,
4840,581,53,29,82,
4841,926,61,54,115,
4842,4749,383,248,631,
4844,4729,381,251,632,
4847,4665,346,247,593,
4848,984,68,54,122,
4849,4818,374,303,677,
4850,494,32,23,55,
4851,41,2,3,5,
4853,4854,366,293,659,
4854,1416,87,75,162,
4856,4926,378,260,638,
4857,34,1,2,3,
4858,3393,242,181,423,
4859,4701,386,243,629,
4861,1760,116,102,218,
4862,607,37,30,67,
4864,907,70,60,130,
4865,2291,192,120,312,
4866,4773,385,257,642,
4867,180,16,5,21,
4868,3827,306,199,505,
4869,4789,360,265,625,
4871,1154,96,72,168,
4873,4915,369,260,629,
4874,4843,334,266,600,
4876,948,62,43,105,
4877,1159,80,69,149,
4878,4835,384,303,687,
4880,4876,331,299,630,
4881,5002,356,300,656,
4883,4768,342,291,633,
4884,4938,367,282,649,
4885,4729,330,269,599,
4887,4837,368,270,638,
4888,4871,357,270,627,
4891,4746,327,274,601,
4892,4808,350,254,604,
4893,4749,353,252,605,
4894,4778,353,260,613,
4896,106,10,9,19,
4897,4665,348,282,630,
4898,5002,363,287,650,
4899,4773,314,250,564,
4900,4724,366,268,634,
4901,4662,305,248,553,
4904,4781,376,301,677,
4905,1661,126,98,224,
4906,39,2,3,5,
4908,1048,71,51,122,
4910,4893,374,269,643,
4911,4801,336,261,597,
4912,110,7,7,14,
4913,1101,97,50,147,
4915,4836,345,275,620,
4916,4870,320,301,621,
4919,1056,81,62,143,
4920,4985,382,274,656,
4921,4840,367,263,630,
4922,4778,342,282,624,
4923,4731,335,285,620,
4925,4024,287,228,515,
4926,4839,359,265,624,
4927,5007,383,298,681,
4928,76,6,3,9,
4929,4663,309,289,598,
4931,5002,396,321,717,
4932,4207,275,217,492,
4933,212,12,17,29,
4934,4868,351,281,632,
4935,4796,335,267,602,
4936,4048,307,231,538,
4937,2336,170,142,312,
4939,372,23,23,46,
4940,4748,363,293,656,
4941,1046,84,53,137,
4942,4794,307,273,580,
4944,122,9,10,19,
4945,4775,328,265,593,
4946,4889,392,281,673,
4947,4950,378,274,652,
4948,4798,360,265,625,
4949,4801,366,298,664,
4950,4782,359,260,619,
4951,4814,373,289,662,
4952,4914,379,290,669,
4953,69,4,4,8,
4954,4836,354,290,644,
4956,4704,348,275,623,
4957,4796,342,242,584,
4958,4833,360,267,627,
4959,4696,346,254,600,
4960,118,9,6,15,
4961,4961,328,273,601,
4962,4962,373,273,646,
4964,948,70,62,132,
4965,4920,365,299,664,
4967,336,26,20,46,
4968,4953,361,270,631,
4969,4840,350,249,599,
4970,4892,378,296,674,
4971,4699,354,227,581,
4973,4829,359,287,646,
4975,4828,343,269,612,
4978,4890,341,280,621,
4979,4788,351,265,616,
4980,4978,387,268,655,
4982,198,10,10,20,
4983,4849,350,260,610,
4984,4707,344,264,608,
4989,4714,305,249,554,
4993,4904,325,260,585,
4995,4833,327,300,627,
4996,4858,361,276,637,
4997,4768,356,263,619,
4998,4717,355,283,638,
5002,4843,349,294,643,
5003,4809,385,269,654,
5004,4938,373,264,637,
5005,4887,334,296,630,
5006,4937,351,263,614,
5007,4918,366,282,648,
5008,4736,353,218,571,
5009,4791,346,278,624,
5011,4799,339,263,602,
5012,263,20,19,39,
5013,4935,346,272,618,
5015,4887,336,280,616,
5016,4831,367,277,644,
5017,4686,374,264,638,
5018,4817,324,267,591,
5019,4824,365,254,619,
5020,4807,385,288,673,
5021,1340,89,91,180,
5022,282,23,17,40,
5024,4859,422,288,710,
5025,4850,357,268,625,
5026,4813,348,289,637,
5027,4713,302,318,620,
5029,5017,360,289,649,
5031,4638,276,291,567,
5032,4826,338,279,617,
5033,4798,341,277,618,
5035,4965,351,291,642,
5037,1707,118,88,206,
5039,4808,338,256,594,
5041,110,11,6,17,
5044,4909,364,293,657,
5045,4879,382,284,666,
5046,1291,86,64,150,
5047,4864,363,278,641,
5048,4878,392,282,674,
5049,291,22,17,39,
5050,1041,77,63,140,
5051,469,36,24,60,
5052,765,50,46,96,
5053,4771,339,264,603,
5054,83,5,2,7,
5055,4808,355,287,642,
5056,1048,75,47,122,
5057,4871,368,251,619,
5058,49,3,1,4,
5059,3644,294,199,493,
5060,4770,363,268,631,
5061,4964,385,273,658,
5062,4792,333,273,606,
5063,3486,255,209,464,
5064,4844,332,290,622,
5065,918,81,59,140,
5066,4898,375,279,654,
5067,877,62,55,117,
5068,4709,319,268,587,
5069,3788,274,209,483,
5070,4751,350,246,596,
5073,4914,350,297,647,
5075,4860,376,286,662,
5076,4909,377,285,662,
5078,583,39,29,68,
5079,156,11,7,18,
5081,4953,340,321,661,
5082,4788,334,281,615,
5084,959,76,47,123,
5086,4816,357,260,617,
5087,4836,340,260,600,
5088,4856,311,300,611,
5089,1504,114,90,204,
5090,4956,350,272,622,
5092,4860,357,294,651,
5093,389,30,18,48,
5095,4860,376,283,659,
5097,1667,128,79,207,
5098,4909,381,299,680,
5099,4849,375,273,648,
5100,734,54,37,91,
5101,3856,229,232,461,
5102,4953,360,275,635,
5103,4798,374,301,675,
5104,4973,361,253,614,
5106,5022,379,257,636,
5108,4931,344,311,655,
5110,995,69,58,127,
5111,424,35,18,53,
5112,4781,299,300,599,
5113,3015,204,194,398,
5118,1437,114,95,209,
5119,4903,342,293,635,
5120,4842,319,294,613,
5122,4906,371,265,636,
5123,4792,369,266,635,
5124,4759,336,266,602,
5125,4774,328,273,601,
5127,4826,366,256,622,
5128,4814,356,294,650,
5130,4849,338,315,653,
5131,4771,345,284,629,
5132,769,50,45,95,
5134,4930,357,326,683,
5135,4755,334,272,606,
5136,874,52,38,90,
5137,4898,397,284,681,
5139,781,57,63,120,
5141,4911,369,266,635,
5142,4722,386,251,637,
5143,1135,85,70,155,
5144,4812,331,278,609,
5146,4868,347,264,611,
5148,820,72,47,119,
5149,4837,354,273,627,
5150,900,66,57,123,
5151,526,43,33,76,
5152,4831,360,221,581,
5153,4845,370,291,661,
5154,4818,353,255,608,
5155,4859,358,274,632,
5159,133,7,8,15,
5160,4800,338,272,610,
5161,718,52,41,93,
5163,4825,376,277,653,
5166,4852,349,260,609,
5167,4888,394,277,671,
5168,81,6,5,11,
5169,4901,356,263,619,
5170,4864,378,266,644,
5172,4896,399,249,648,
5173,4871,380,264,644,
5174,4828,324,299,623,
5175,4779,307,278,585,
5177,200,21,8,29,
5178,1565,113,68,181,
5179,4842,347,261,608,
5180,4745,349,239,588,
5181,4803,326,282,608,
5182,78,5,3,8,
5183,4973,311,309,620,
5184,4850,375,292,667,
5186,3768,273,194,467,
5187,4805,346,317,663,
5191,86,10,4,14,
5192,1311,106,66,172,
5193,477,28,31,59,
5194,4840,336,270,606,
5195,4808,334,251,585,
5196,4855,376,244,620,
5198,4729,359,260,619,
5199,4841,365,297,662,
5203,1265,91,62,153,
5204,440,29,31,60,
5205,4980,344,284,628,
5206,4741,330,258,588,
5207,4948,365,285,650,
5208,4882,395,242,637,
5209,4798,346,242,588,
5211,973,73,61,134,
5212,4679,328,256,584,
5214,682,50,32,82,
5215,324,22,18,40,
5218,746,40,36,76,
5219,605,47,33,80,
5220,404,29,27,56,
5222,4796,312,280,592,
5223,4860,346,285,631,
5224,4861,349,287,636,
5225,618,48,29,77,
5226,319,20,14,34,
5228,695,57,38,95,
5229,4705,366,271,637,
5230,4889,358,309,667,
5231,589,39,32,71,
5232,4888,354,249,603,
5233,4944,332,280,612,
5234,4982,365,258,623,
5235,4840,351,273,624,
5237,4932,345,273,618,
5238,4872,355,268,623,
5239,4740,342,273,615,
5241,5038,331,305,636,
5242,122,9,7,16,
5243,4969,382,275,657,
5244,1168,85,65,150,
5245,4900,324,275,599,
5247,4909,370,273,643,
5248,4871,339,278,617,
5249,388,33,28,61,
5250,4790,367,276,643,
5251,4839,334,262,596,
5252,4770,332,251,583,
5253,776,50,48,98,
5254,10,1,1,2,
5256,4901,366,294,660,
5257,4813,314,278,592,
5258,939,61,58,119,
5259,4802,320,269,589,
5260,5000,350,290,640,
5262,4941,344,262,606,
5263,4882,358,267,625,
5267,4830,333,311,644,
5268,4909,356,268,624,
5270,860,73,54,127,
5272,4867,332,274,606,
5273,4815,324,271,595,
5274,24,1,2,3,
5276,45,2,4,6,
5277,4849,362,300,662,
5278,4914,361,274,635,
5279,4887,362,276,638,
5280,594,63,22,85,
5282,4825,331,307,638,
5283,4974,344,241,585,
5284,1340,90,61,151,
5286,4728,324,244,568,
5287,4834,366,252,618,
5288,4896,350,258,608,
5291,4966,345,286,631,
5292,4857,346,283,629,
5294,545,32,27,59,
5295,4783,347,275,622,
5296,4803,357,283,640,
5297,4765,313,302,615,
5301,4027,268,227,495,
5304,4846,347,274,621,
5305,4873,359,250,609,
5306,4788,379,281,660,
5307,4775,335,273,608,
5308,4921,418,255,673,
5310,4840,343,273,616,
5311,4897,349,275,624,
5312,1077,62,74,136,
5315,4827,367,253,620,
5316,4023,306,204,510,
5317,4879,347,302,649,
5318,4735,349,273,622,
5321,4794,362,295,657,
5324,4878,358,271,629,
5325,4887,367,289,656,
5326,4964,349,306,655,
5327,4897,371,266,637,
5329,4743,353,287,640,
5331,767,55,47,102,
5332,4727,328,266,594,
5333,4828,375,275,650,
5335,4823,341,284,625,
5337,4933,329,298,627,
5338,739,49,51,100,
5339,4780,382,272,654,
5340,1078,72,74,146,
5342,27,3,1,4,
5343,4826,350,273,623,
5344,4847,365,292,657,
5346,4840,370,285,655,
5347,234,7,20,27,
5348,521,33,29,62,
5349,350,19,15,34,
5351,4801,344,267,611,
5352,485,37,31,68,
5353,4931,365,288,653,
5356,4795,352,282,634,
5358,4827,350,285,635,
5359,4857,343,262,605,
5361,662,44,44,88,
5363,880,59,54,113,
5364,410,22,28,50,
5365,4914,370,316,686,
5366,5006,381,287,668,
5367,4860,349,288,637,
5369,4799,366,275,641,
5370,4892,316,281,597,
5371,4869,377,231,608,
5373,4892,353,290,643,
5374,4903,339,271,610,
5375,4823,349,278,627,
5377,4841,322,298,620,
5378,4895,339,295,634,
5379,3587,281,210,491,
5380,4803,351,280,631,
5381,84,4,2,6,
5383,4771,382,252,634,
5384,534,43,23,66,
5387,4809,368,252,620,
5390,4829,340,267,607,
5392,4877,344,241,585,
5393,1815,119,120,239,
5394,961,55,56,111,
5395,4858,383,263,646,
5396,4862,368,294,662,
5399,339,24,19,43,
5400,4740,363,284,647,
5401,1547,100,100,200,
5402,181,16,11,27,
5403,4857,336,285,621,
5404,972,56,51,107,
5405,4933,381,294,675,
5406,4786,348,267,615,
5408,4855,336,291,627,
5409,4640,324,270,594,
5411,191,18,7,25,
5412,4879,372,257,629,
5414,4995,351,267,618,
5415,40,5,4,9,
5416,1393,108,82,190,
5417,4806,342,274,616,
5418,4909,352,270,622,
5419,4846,315,262,577,
5420,4931,366,271,637,
5421,4905,382,302,684,
5423,4815,310,280,590,
5426,4901,365,296,661,
5427,206,15,11,26,
5428,4898,360,284,644,
5429,3788,241,236,477,
5430,4856,371,312,683,
5431,4997,356,271,627,
5433,4832,342,253,595,
5434,4879,367,298,665,
5435,4825,366,312,678,
5436,4824,354,279,633,
5437,4971,371,273,644,
5438,4800,370,287,657,
5439,4876,324,261,585,
5440,5010,338,324,662,
5441,212,15,13,28,
5442,4766,349,272,621,
5447,4840,343,277,620,
5448,4895,350,278,628,
5450,4854,344,282,626,
5451,4955,352,287,639,
5452,4896,352,287,639,
5453,4743,325,259,584,
5454,5033,342,307,649,
5455,93,2,4,6,
5456,860,81,40,121,
5457,4847,348,303,651,
5458,4814,345,283,628,
5459,4855,345,267,612,
5460,4868,357,294,651,
5462,4794,370,265,635,
5463,162,10,12,22,
5464,4968,370,241,611,
5465,683,41,51,92,
5467,4578,345,258,603,
5469,765,57,45,102,
5470,4831,407,263,670,
5473,4927,379,273,652,
5474,4922,352,266,618,
5475,3850,252,228,480,
5476,4818,350,279,629,
5478,3682,257,222,479,
5479,4973,365,271,636,
5480,4759,330,259,589,
5481,533,37,32,69,
5483,4867,346,296,642,
5485,379,22,17,39,
5486,4847,335,280,615,
5487,4946,360,272,632,
5488,970,70,48,118,
5491,4771,353,271,624,
5492,4841,375,283,658,
5494,567,40,29,69,
5495,4990,385,265,650,
5496,4855,359,256,615,
5498,25,2,2,4,
5499,4983,351,271,622,
5500,4956,355,264,619,
5501,4992,373,240,613,
5502,4950,358,261,619,
5503,4956,365,308,673,
5505,4855,332,264,596,
5506,4758,345,265,610,
5507,4849,360,278,638,
5508,1846,133,108,241,
5509,1437,106,87,193,
5511,4862,379,306,685,
5512,4904,366,296,662,
5513,5004,374,292,666,
5514,4920,427,261,688,
5517,1617,126,102,228,
5518,1689,113,84,197,
5519,4754,321,260,581,
5521,4973,368,284,652,
5522,178,21,8,29,
5524,4848,352,258,610,
5525,4925,352,243,595,
5526,668,53,44,97,
5529,4800,356,272,628,
5530,4865,375,294,669,
5532,4861,357,306,663,
5533,4802,349,308,657,
5535,4803,364,281,645,
5537,4881,348,298,646,
5538,2237,143,140,283,
5539,1183,85,71,156,
5541,4644,371,257,628,
5542,806,55,44,99,
5543,4768,340,266,606,
5546,1118,84,65,149,
5548,141,11,6,17,
5549,4819,334,284,618,
5550,3755,262,221,483,
5551,4784,309,306,615,
5552,450,31,29,60,
5553,4785,354,251,605,
5554,4867,377,267,644,
5555,4705,367,252,619,
5556,4754,360,291,651,
5557,312,23,21,44,
5558,1273,104,64,168,
5559,4875,326,282,608,
5563,4871,367,291,658,
5564,4951,336,268,604,
5565,5000,370,283,653,
5566,4863,330,262,592,
5567,4848,317,261,578,
5568,4667,356,270,626,
5570,4912,332,308,640,
5572,4914,365,281,646,
5573,288,23,15,38,
5574,89,8,5,13,
5575,260,29,13,42,
5576,4874,369,282,651,
5577,4853,373,294,667,
5579,322,25,15,40,
5584,911,67,51,118,
5585,4830,367,287,654,
5586,4905,356,291,647,
5587,4860,344,289,633,
5589,4824,340,272,612,
5591,4871,351,287,638,
5593,3991,254,263,517,
5595,4845,336,280,616,
5596,4918,355,274,629,
5597,4884,362,256,618,
5599,4749,304,267,571,
5601,4868,382,265,647,
5602,4720,351,259,610,
5604,4869,366,277,643,
5605,4813,343,288,631,
5606,4812,355,294,649,
5607,45,2,2,4,
5608,4922,377,271,648,
5609,4736,346,256,602,
5610,4828,390,289,679,
5611,4835,359,267,626,
5613,4862,366,258,624,
5614,4719,358,271,629,
5616,170,16,10,26,
5617,4720,343,264,607,
5618,4941,341,260,601,
5619,4972,365,267,632,
5621,197,7,12,19,
5623,4949,362,291,653,
5625,3444,231,238,469,
5627,141,14,4,18,
5628,629,41,36,77,
5629,4733,340,291,631,
5632,4879,389,278,667,
5633,211,10,15,25,
5634,4886,370,268,638,
5636,4874,357,245,602,
5637,4934,353,277,630,
5638,4778,361,276,637,
5639,3833,322,205,527,
5640,4802,371,253,624,
5641,4858,362,309,671,
5642,3722,228,258,486,
5643,4794,327,283,610,
5644,4908,367,291,658,
5645,4868,369,313,682,
5646,354,30,16,46,
5647,4781,352,284,636,
5649,4969,347,323,670,
5650,2591,197,123,320,
5652,1392,104,75,179,
5653,44,4,4,8,
5654,4846,327,263,590,
5657,131,15,6,21,
5658,4775,330,235,565,
5659,4764,332,287,619,
5662,4832,363,298,661,
5664,4835,360,250,610,
5665,297,22,15,37,
5667,4724,340,260,600,
5668,4967,378,274,652,
5669,4814,356,286,642,
5670,4798,343,243,586,
5671,682,48,42,90,
5672,4821,345,271,616,
5673,4908,321,280,601,
5675,1795,106,98,204,
5676,4957,348,303,651,
5677,4730,336,287,623,
5678,4832,347,259,606,
5679,4910,393,288,681,
5680,4829,356,251,607,
5681,896,64,49,113,
5682,4930,352,249,601,
5683,417,39,20,59,
5684,226,13,13,26,
5685,4869,340,289,629,
5687,4820,331,284,615,
5688,4813,356,265,621,
5689,4923,389,303,692,
5690,4922,337,268,605,
5692,4843,315,296,611,
5693,4872,370,298,668,
5695,4796,334,272,606,
5696,4865,363,281,644,
5697,4934,365,279,644,
5700,4868,340,273,613,
5701,4870,363,266,629,
5703,3779,235,223,458,
5706,4987,377,302,679,
5708,220,11,14,25,
5711,4808,343,259,602,
5712,4837,346,298,644,
5713,4898,363,260,623,
5714,4838,355,293,648,
5715,4757,356,259,615,
5716,4800,355,264,619,
5717,4831,331,334,665,
5719,508,40,30,70,
5720,4950,379,303,682,
5721,4949,400,286,686,
5722,4894,377,270,647,
5723,4898,346,276,622,
5724,4763,322,310,632,
5726,377,25,15,40,
5728,4802,340,289,629,
5729,4949,368,284,652,
5730,4876,337,271,608,
5731,4943,374,289,663,
5733,4869,368,292,660,
5734,587,39,27,66,
5735,4910,344,285,629,
5736,5065,368,274,642,
5738,4971,370,301,671,
5739,4790,352,257,609,
5740,935,73,49,122,
5743,4918,377,276,653,
5744,4813,363,271,634,
5747,4816,354,307,661,
5748,4836,315,285,600,
5749,4946,340,283,623,
5750,4946,299,278,577,
5752,812,55,58,113,
5753,709,41,42,83,
5754,4880,367,269,636,
5755,4636,311,253,564,
5757,4774,374,259,633,
5758,4798,327,292,619,
5759,4694,330,289,619,
5760,290,21,18,39,
5761,4766,364,256,620,
5762,654,33,38,71,
5763,4906,332,276,608,
5764,4759,348,270,618,
5767,4781,375,295,670,
5768,327,20,20,40,
5769,4856,357,295,652,
5770,4979,355,263,618,
5771,2015,157,109,266,
5772,4762,369,247,616,
5775,4886,353,314,667,
5776,4881,364,274,638,
5777,4720,343,289,632,
5778,4830,335,293,628,
5779,122,13,3,16,
5783,3656,262,196,458,
5784,4765,342,291,633,
5786,4974,370,264,634,
5787,4787,346,280,626,
5788,505,28,28,56,
5789,4709,363,274,637,
5790,4789,341,242,583,
5791,4715,322,281,603,
5792,4873,354,273,627,
5793,1276,101,75,176,
5795,4810,376,272,648,
5796,4841,342,304,646,
5797,4749,361,248,609,
5798,79,7,3,10,
5799,4813,386,274,660,
5801,4814,323,261,584,
5802,4824,343,293,636,
5803,4969,357,299,656,
5806,515,27,33,60,
5807,4926,355,274,629,
5808,4817,340,261,601,
5809,4816,413,251,664,
5810,4959,356,262,618,
5811,405,30,30,60,
5812,43,3,3,6,
5814,162,13,5,18,
5815,1023,80,59,139,
5816,4806,333,274,607,
5818,2881,220,162,382,
5819,1856,136,110,246,
5821,629,39,31,70,
5823,943,63,53,116,
5824,4934,332,289,621,
5825,4766,371,286,657,
5826,4120,336,233,569,
5827,4820,367,268,635,
5831,4747,313,273,586,
5833,4970,376,306,682,
5834,4898,315,304,619,
5835,4672,356,257,613,
5836,4972,348,289,637,
5837,4944,347,264,611,
5838,4901,376,274,650,
5839,4770,352,269,621,
5840,4981,371,285,656,
5842,1535,107,67,174,
5843,4965,328,264,592,
5844,4787,337,239,576,
5845,4819,347,268,615,
5846,4729,330,293,623,
5847,4770,362,261,623,
5848,129,11,6,17,
5849,3462,228,190,418,
5850,3607,263,179,442,
5851,4842,323,261,584,
5852,409,29,14,43,
5853,379,31,26,57,
5854,4778,330,262,592,
5858,311,25,18,43,
5859,4970,348,284,632,
5861,4834,355,294,649,
5862,552,39,29,68,
5863,369,22,13,35,
5864,4759,343,287,630,
5865,4804,332,288,620,
5866,4860,359,261,620,
5867,4844,369,283,652,
5869,4865,336,251,587,
5872,4781,362,267,629,
5873,4805,318,272,590,
5874,1135,87,55,142,
5876,151,9,7,16,
5877,4949,382,261,643,
5878,4771,331,249,580,
5879,4989,388,255,643,
5880,4818,369,256,625,
5881,4820,382,238,620,
5882,303,23,11,34,
5883,4838,329,260,589,
5884,4893,334,296,630,
5885,4810,326,292,618,
5886,4893,357,292,649,
5887,4832,315,319,634,
5888,312,27,10,37,
5889,768,53,36,89,
5890,375,26,20,46,
5891,4837,357,298,655,
5892,4880,369,261,630,
5893,4857,344,307,651,
5895,4807,345,277,622,
5896,4821,342,289,631,
5897,4799,378,263,641,
5898,4783,369,248,617,
5899,4883,365,286,651,
5900,4743,354,258,612,
5902,4739,363,239,602,
5903,4778,383,272,655,
5904,4829,380,273,653,
5905,1373,91,63,154,
5906,4903,350,261,611,
5907,4844,336,312,648,
5909,4840,338,302,640,
5910,244,16,20,36,
5911,598,46,41,87,
5912,1056,78,62,140,
5913,4789,354,269,623,
5914,4881,343,293,636,
5915,1087,80,66,146,
5916,870,71,54,125,
5917,4884,358,268,626,
5918,4777,357,299,656,
5920,4846,357,286,643,
5923,132,3,8,11,
5924,4855,306,265,571,
5926,91,6,5,11,
5927,149,8,10,18,
5929,4922,395,264,659,
5930,1293,94,77,171,
5932,4864,379,262,641,
5933,1164,82,68,150,
5935,4742,336,334,670,
5936,4967,367,276,643,
5937,4901,328,309,637,
5938,4862,352,280,632,
5940,4955,352,284,636,
5942,4993,352,285,637,
5944,4879,328,308,636,
5945,865,57,56,113,
5946,4942,339,284,623,
5948,771,59,40,99,
5949,234,22,16,38,
5950,4755,331,249,580,
5952,49,4,3,7,
5953,1084,75,62,137,
5954,4749,358,279,637,
5955,4845,361,317,678,
5958,4846,369,285,654,
5959,4858,378,231,609,
5961,4845,347,286,633,
5962,4854,389,231,620,
5963,4851,320,288,608,
5964,4840,314,275,589,
5965,972,90,44,134,
5967,4896,314,294,608,
5968,4811,367,252,619,
5969,4789,385,249,634,
5970,4804,341,289,630,
5971,4915,293,305,598,
5972,4852,349,279,628,
5973,4878,353,277,630,
5976,1949,137,114,251,
5978,277,21,20,41,
5979,352,27,11,38,
5981,4742,314,279,593,
5982,4941,354,290,644,
5983,4812,360,267,627,
5984,4846,314,263,577,
5985,790,55,48,103,
5986,4760,372,280,652,
5987,4883,343,306,649,
5988,4790,337,264,601,
5989,4895,404,251,655,
5993,893,57,47,104,
5994,4902,327,295,622,
5995,4851,368,292,660,
5996,4911,360,287,647,
5997,4657,318,263,581,
5998,415,41,28,69,
5999,4954,367,303,670,
6000,3741,288,220,508,
6001,4752,387,267,654,
6002,265,21,10,31,
6003,723,39,61,100,
6004,4797,340,277,617,
6005,4910,366,272,638,
6006,4963,366,300,666,
6007,4847,324,290,614,
6008,1037,72,58,130,
6009,4889,338,313,651,
6010,4839,338,280,618,
6011,4994,342,295,637,
6012,4884,381,254,635,
6013,4869,368,280,648,
6014,4762,378,258,636,
6015,1066,82,68,150,
6017,4714,321,295,616,
6020,4855,330,257,587,
6021,4807,340,259,599,
6023,4898,341,286,627,
6025,194,13,8,21,
6026,4882,344,284,628,
6027,4955,368,262,630,
6028,4653,337,260,597,
6029,4830,356,288,644,
6030,298,24,24,48,
6031,485,29,22,51,
6032,309,21,21,42,
6034,4881,354,281,635,
6035,4858,331,289,620,
6039,4843,339,238,577,
6040,1727,120,106,226,
6041,4899,351,255,606,
6043,4966,341,259,600,
6044,506,26,29,55,
6045,294,24,16,40,
6046,4799,348,254,602,
6049,4778,350,284,634,
6050,851,56,45,101,
6051,512,33,33,66,
6052,4804,343,301,644,
6053,4968,364,283,647,
6056,4859,345,285,630,
6057,4802,349,285,634,
6058,528,36,21,57,
6059,4874,348,319,667,
6061,4692,320,240,560,
6062,540,38,33,71,
6063,4815,364,303,667,
6064,1197,100,57,157,
6065,332,20,25,45,
6068,4799,364,270,634,
6069,3990,288,227,515,
6072,4787,349,293,642,
6073,4875,384,280,664,
6077,4657,359,247,606,
6078,4880,344,256,600,
6079,4895,389,247,636,
6080,1210,96,53,149,
6081,4826,361,303,664,
6083,5001,351,292,643,
6084,4763,341,280,621,
6085,4871,370,270,640,
6086,4874,371,252,623,
6087,5001,374,267,641,
6089,4821,380,290,670,
6090,4953,353,271,624,
6092,4812,372,283,655,
6093,5001,401,276,677,
6094,71,6,4,10,
6095,535,45,40,85,
6096,4824,374,277,651,
6097,4939,400,291,691,
6099,201,10,11,21,
6100,4811,360,279,639,
6102,4743,318,257,575,
6103,4655,312,253,565,
6106,4937,355,267,622,
6107,4837,359,293,652,
6108,3588,221,238,459,
6109,4203,336,248,584,
6110,4848,380,305,685,
6111,4738,332,260,592,
6113,4880,353,291,644,
6114,4866,359,262,621,
6115,4966,380,273,653,
6116,4781,365,252,617,
6117,4892,343,264,607,
6118,4895,347,245,592,
6119,634,34,31,65,
6120,991,78,59,137,
6121,4792,362,266,628,
6123,1319,101,69,170,
6124,4671,349,255,604,
6125,4844,327,290,617,
6126,857,58,62,120,
6128,3666,289,241,530,
6129,816,71,45,116,
6130,4856,350,271,621,
6131,5004,348,294,642,
6132,3572,316,189,505,
6133,181,14,12,26,
6136,4882,331,295,626,
6137,4828,373,251,624,
6138,4890,354,287,641,
6139,4758,343,240,583,
6141,817,66,41,107,
6142,4737,335,286,621,
6143,4822,352,269,621,
6144,548,36,33,69,
6145,4823,362,265,627,
6146,162,4,10,14,
6147,20,1,1,2,
6149,4931,344,253,597,
6150,1521,103,97,200,
6151,4936,368,262,630,
6152,4921,338,284,622,
6153,1745,118,104,222,
6154,4964,360,266,626,
6155,4882,360,263,623,
6156,4650,342,274,616,
6157,257,17,13,30,
6158,745,59,27,86,
6162,4834,341,259,600,
6164,4662,371,222,593,
6165,4865,348,269,617,
6166,4906,332,294,626,
6167,855,57,42,99,
6168,4927,335,283,618,
6169,4867,401,267,668,
6170,4898,344,271,615,
6172,4857,329,277,606,
6173,4809,387,258,645,
6174,4848,348,260,608,
6175,4871,312,299,611,
6176,188,13,9,22,
6177,1408,97,80,177,
6178,4856,353,295,648,
6179,395,27,26,53,
6180,280,20,12,32,
6183,4864,375,250,625,
6184,4884,354,293,647,
6186,1037,87,56,143,
6187,3195,198,186,384,
6188,4897,349,286,635,
6189,4785,375,263,638,
6190,3391,268,206,474,
6191,4867,351,280,631,
6192,258,23,9,32,
6193,4900,355,278,633,
6194,4718,323,290,613,
6195,978,69,47,116,
6196,391,31,20,51,
6197,1005,69,67,136,
6198,4723,337,277,614,
6200,4889,330,254,584,
6202,4841,400,240,640,
6203,4867,402,237,639,
6204,4759,339,262,601,
6205,4802,386,281,667,
6207,429,31,21,52,
6208,4889,362,282,644,
6209,97,10,4,14,
6211,4785,343,270,613,
6212,4902,360,279,639,
6213,1572,116,84,200,
6214,4840,351,288,639,
6215,370,23,25,48,
6217,4851,317,273,590,
6218,4757,309,285,594,
6219,4765,370,285,655,
6220,4766,323,263,586,
6221,347,21,21,42,
6223,4697,353,252,605,
6225,4944,361,287,648,
6226,4859,318,254,572,
6228,4915,357,280,637,
6229,4743,355,261,616,
6232,3695,260,218,478,
6233,712,45,32,77,
6234,4853,379,263,642,
6235,5004,386,283,669,
6237,4815,354,261,615,
6238,908,71,43,114,
6239,1373,96,73,169,
6241,4820,367,294,661,
6242,4941,352,278,630,
6243,189,10,12,22,
6244,1151,81,69,150,
6245,4800,345,287,632,
6246,4767,354,276,630,
6247,4858,352,255,607,
6248,4719,359,275,634,
6249,4954,368,270,638,
6250,4908,379,288,667,
6252,4796,347,260,607,
6253,4898,374,260,634,
6254,1349,91,80,171,
6255,3368,245,189,434,
6256,4833,300,290,590,
6257,4993,356,275,631,
6258,4938,337,294,631,
6259,225,19,12,31,
6261,866,60,53,113,
6262,4869,338,250,588,
6263,4747,339,254,593,
6264,4731,345,266,611,
6265,1066,93,60,153,
6266,4789,350,256,606,
6267,4942,360,245,605,
6268,4915,344,275,619,
6269,551,36,41,77,
6270,586,37,32,69,
6271,4882,370,248,618,
6272,4672,342,270,612,
6273,4739,347,295,642,
6275,4803,317,291,608,
6276,4891,320,300,620,
6277,4822,352,251,603,
6278,4907,350,272,622,
6279,1180,87,95,182,
6281,4718,366,233,599,
6282,4916,359,345,704,
6284,4866,328,260,588,
6286,4940,341,262,603,
6287,4849,349,280,629,
6288,14,2,2,4,
6293,4806,347,298,645,
6294,4687,359,258,617,
6297,4863,365,259,624,
6299,19,1,2,3,
6300,4770,385,262,647,
6301,4865,364,294,658,
6302,4786,309,295,604,
6303,3741,257,216,473,
6305,4692,344,311,655,
6307,4918,356,265,621,
6308,4752,344,245,589,
6309,4840,350,275,625,
6310,4919,348,282,630,
6311,4929,354,279,633,
6312,4817,359,274,633,
6313,4902,336,295,631,
6314,3631,293,203,496,
6315,4928,339,269,608,
6316,4989,336,292,628,
6318,961,72,69,141,
6319,152,9,9,18,
6321,4935,365,270,635,
6322,4817,337,293,630,
6323,4976,348,286,634,
6324,4703,366,250,616,
6325,4882,331,262,593,
6326,620,56,31,87,
6327,999,71,51,122,
6328,206,17,10,27,
6329,4811,367,231,598,
6330,4948,409,257,666,
6331,4860,345,279,624,
6333,4809,359,321,680,
6334,4335,316,251,567,
6336,4708,319,261,580,
6339,1099,85,70,155,
6340,4852,329,257,586,
6341,303,20,13,33,
6342,4994,356,290,646,
6343,4941,381,285,666,
6344,4982,385,287,672,
6345,4698,359,272,631,
6346,783,51,43,94,
6347,4823,339,269,608,
6349,4768,377,270,647,
6350,4886,346,307,653,
6351,4803,337,289,626,
6352,4676,373,252,625,
6353,3661,259,211,470,
6355,1209,118,57,175,
6356,145,13,8,21,
6358,4821,351,304,655,
6360,4626,339,265,604,
6361,4965,321,281,602,
6362,4745,360,259,619,
6363,4829,374,246,620,
6364,4851,341,294,635,
6365,4940,323,271,594,
6366,4789,331,266,597,
6367,1313,100,58,158,
6368,4792,337,270,607,
6369,902,65,56,121,
6371,4805,345,302,647,
6372,3449,225,206,431,
6373,3872,281,233,514,
6374,4940,374,283,657,
6375,4838,364,264,628,
6376,4852,356,235,591,
6377,846,42,52,94,
6380,384,26,15,41,
6382,415,31,20,51,
6384,899,72,60,132,
6387,4859,351,266,617,
6388,4805,346,287,633,
6389,4793,358,257,615,
6391,4683,338,246,584,
6392,4925,340,251,591,
6393,4838,327,305,632,
6395,4869,387,304,691,
6398,796,55,56,111,
6400,4855,362,255,617,
6401,4793,368,262,630,
6402,4773,321,264,585,
6403,4930,341,300,641,
6404,4864,342,280,622,
6405,4950,317,282,599,
6406,4923,384,271,655,
6407,3703,291,199,490,
6408,4861,335,269,604,
6409,4070,321,247,568,
6411,4826,370,297,667,
6412,4831,365,291,656,
6413,4004,259,251,510,
6414,4857,332,307,639,
6416,4951,354,260,614,
6418,4808,354,275,629,
6419,4812,313,289,602,
6420,4909,333,311,644,
6421,316,16,17,33,
6422,4978,357,297,654,
6423,677,54,46,100,
6424,487,30,17,47,
6428,598,29,21,50,
6430,113,2,10,12,
6432,4751,346,260,606,
6433,1078,73,61,134,
6434,4816,362,267,629,
6435,724,53,38,91,
6436,3282,238,187,425,
6437,373,23,18,41,
6438,485,36,23,59,
6439,4821,376,272,648,
6440,4691,348,278,626,
6441,4777,353,282,635,
6442,4878,392,273,665,
6445,311,17,14,31,
6447,2636,222,137,359,
6448,4891,360,267,627,
6449,4814,346,329,675,
6451,4729,331,286,617,
6453,4899,359,258,617,
6454,4766,358,244,602,
6455,4564,354,248,602,
6457,1379,107,66,173,
6460,4844,374,303,677,
6461,4738,327,290,617,
6463,933,58,59,117,
6464,4743,338,246,584,
6465,4927,356,254,610,
6467,4897,323,268,591,
6468,4788,336,273,609,
6469,4907,377,285,662,
6470,4771,339,265,604,
6471,4814,343,274,617,
6472,4855,367,286,653,
6473,4911,332,283,615,
6476,46,6,4,10,
6477,112,7,8,15,
6478,4809,296,311,607,
6479,4897,367,274,641,
6480,611,37,42,79,
6481,1169,97,69,166,
6482,4850,367,266,633,
6483,4845,364,284,648,
6484,4866,390,284,674,
6487,4764,327,295,622,
6488,4823,351,282,633,
6489,4831,329,245,574,
6490,4749,319,330,649,
6491,4816,341,260,601,
6493,1241,93,65,158,
6494,4784,328,268,596,
6495,4863,423,243,666,
6496,4756,356,271,627,
6497,4754,374,254,628,
6499,4885,321,287,608,
6500,4870,362,247,609,
6503,4767,361,269,630,
6505,943,80,43,123,
6506,4886,360,302,662,
6508,4786,379,246,625,
6510,5017,363,310,673,
6512,4616,350,253,603,
6513,4759,363,263,626,
6514,4726,356,309,665,
6517,502,33,33,66,
6518,1029,69,58,127,
6519,4757,346,268,614,
6521,576,42,38,80,
6522,4871,352,299,651,
6523,4887,388,262,650,
6524,5000,391,287,678,
6526,4837,325,253,578,
6527,4864,334,270,604,
6528,1888,152,100,252,
6530,4909,390,263,653,
6531,1130,86,56,142,
6533,445,36,28,64,
6534,4781,357,275,632,
6535,4881,343,283,626,
6536,330,23,15,38,
6538,4900,358,251,609,
6539,4764,335,276,611,
6540,4914,363,241,604,
6541,4718,382,240,622,
6542,4880,418,285,703,
6543,4811,306,259,565,
6544,4780,348,255,603,
6545,4868,357,281,638,
6546,4902,360,270,630,
6547,1234,92,67,159,
6548,4803,350,282,632,
6549,3159,202,201,403,
6550,4760,356,271,627,
6551,1033,79,65,144,
6552,114,11,6,17,
6553,4804,338,281,619,
6558,4998,367,277,644,
6559,4877,396,252,648,
6561,4754,366,263,629,
6562,170,15,6,21,
6563,5055,364,279,643,
6566,4785,348,273,621,
6567,4840,337,279,616,
6568,4921,360,316,676,
6570,278,19,13,32,
6571,4733,349,235,584,
6572,3328,214,194,408,
6574,4865,346,273,619,
6576,3968,277,201,478,
6578,195,14,13,27,
6579,615,55,33,88,
6580,3639,278,202,480,
6581,4906,379,264,643,
6582,4876,346,252,598,
6583,3881,275,250,525,
6584,4798,356,260,616,
6585,1257,83,70,153,
6587,4953,359,281,640,
6588,686,37,36,73,
6590,4713,328,271,599,
6591,4923,326,299,625,
6593,4973,383,291,674,
6594,4778,316,286,602,
6595,3510,264,190,454,
6596,4897,371,284,655,
6597,4914,370,283,653,
6598,3698,272,199,471,
6599,1750,123,85,208,
6600,4695,333,280,613,
6601,469,43,20,63,
6602,4752,295,279,574,
6604,4962,362,236,598,
6606,4801,378,271,649,
6607,390,33,19,52,
6608,4891,354,284,638,
6610,1707,122,111,233,
6611,1308,90,71,161,
6612,4879,323,264,587,
6613,4816,370,297,667,
6614,4842,356,240,596,
6617,121,8,4,12,
6618,127,10,12,22,
6619,4886,361,255,616,
6620,4825,364,275,639,
6621,2304,142,127,269,
6622,4935,373,262,635,
6623,4768,334,285,619,
6624,405,37,27,64,
6625,837,57,60,117,
6626,1030,75,50,125,
6627,82,5,3,8,
6629,4631,333,271,604,
6630,4898,353,257,610,
6631,4821,376,261,637,
6632,1030,76,62,138,
6635,4956,355,292,647,
6636,4831,343,278,621,
6638,4729,330,263,593,
6639,4845,337,281,618,
6640,1030,85,61,146,
6641,4722,346,274,620,
6642,4927,356,263,619,
6644,4659,309,278,587,
6645,293,21,15,36,
6647,4834,336,299,635,
6648,4894,392,272,664,
6649,4868,344,264,608,
6650,84,5,6,11,
6651,4919,352,273,625,
6653,3736,261,200,461,
6654,4804,344,308,652,
6657,4791,332,272,604,
6658,4794,342,276,618,
6659,708,53,43,96,
6660,1347,89,88,177,
6661,47,3,1,4,
6662,4837,341,271,612,
6663,4929,348,256,604,
6664,4689,368,259,627,
6666,4813,371,248,619,
6669,4721,366,259,625,
6671,4894,343,263,606,
6672,4810,347,239,586,
6673,4834,408,259,667,
6674,4702,348,260,608,
6675,4889,385,304,689,
6676,4829,342,279,621,
6679,3892,240,243,483,
6681,4839,347,295,642,
6682,4912,305,280,585,
6685,4780,319,291,610,
6686,4906,351,285,636,
6687,1049,85,53,138,
6688,4796,371,271,642,
6689,4847,361,284,645,
6691,4870,363,251,614,
6693,4743,321,298,619,
6694,4953,403,290,693,
6696,3839,264,213,477,
6697,562,33,40,73,
6698,4777,326,275,601,
6699,657,48,44,92,
6702,1531,123,91,214,
6704,4690,348,260,608,
6705,502,36,27,63,
6706,4862,347,280,627,
6707,780,67,42,109,
6708,4928,340,274,614,
6709,4861,338,299,637,
6710,4767,333,332,665,
6711,4812,380,250,630,
6712,4771,355,278,633,
6714,406,41,19,60,
6715,4735,328,279,607,
6716,4763,367,275,642,
6717,4791,334,276,610,
6720,148,16,10,26,
6723,4789,337,280,617,
6724,4834,369,269,638,
6725,4913,379,298,677,
6726,141,8,13,21,
6727,4771,327,269,596,
6728,1624,122,100,222,
6729,1094,73,70,143,
6731,4822,348,257,605,
6732,4788,384,286,670,
6733,4883,367,246,613,
6734,4892,358,263,621,
6735,4763,334,289,623,
6736,287,28,18,46,
6737,4763,335,252,587,
6739,1731,131,84,215,
6740,4796,343,252,595,
6742,381,22,17,39,
6743,152,13,4,17,
6744,4842,347,255,602,
6749,992,75,59,134,
6750,4780,365,277,642,
6753,4830,334,292,626,
6754,4858,348,298,646,
6757,4854,318,272,590,
6758,4803,348,230,578,
6761,4954,358,289,647,
6764,4840,373,262,635,
6767,4750,337,250,587,
6768,597,53,35,88,
6769,4817,325,295,620,
6770,4834,329,269,598,
6771,4930,374,264,638,
6773,4757,327,270,597,
6774,4880,354,279,633,
6775,888,67,53,120,
6776,4887,330,280,610,
6777,343,19,28,47,
6778,4820,382,256,638,
6779,4852,361,262,623,
6780,754,50,48,98,
6782,1293,96,68,164,
6783,1082,93,61,154,
6785,4905,308,276,584,
6786,4922,346,263,609,
6788,4778,334,277,611,
6789,4837,352,278,630,
6791,392,32,19,51,
6792,256,24,15,39,
6793,4688,334,258,592,
6794,602,39,37,76,
6796,4926,328,320,648,
6797,4949,389,271,660,
6798,4876,349,278,627,
6799,19,2,1,3,
6800,38,3,1,4,
6801,249,19,9,28,
6803,4774,338,283,621,
6805,4744,367,243,610,
6808,4860,354,320,674,
6810,4894,339,286,625,
6811,4952,349,258,607,
6813,4628,405,244,649,
6814,4867,337,255,592,
6816,4831,355,281,636,
6818,1458,116,84,200,
6820,177,17,7,24,
6821,78,5,3,8,
6822,926,54,54,108,
6824,1603,112,89,201,
6826,4812,329,292,621,
6827,4931,368,250,618,
6828,799,69,40,109,
6829,4786,367,286,653,
6830,386,33,35,68,
6831,4847,371,288,659,
6832,4900,359,261,620,
6835,882,63,57,120,
6836,4942,383,289,672,
6837,4820,377,274,651,
6839,4872,369,261,630,
6841,4889,350,303,653,
6843,4824,346,271,617,
6844,4859,336,292,628,
6847,139,7,8,15,
6848,4976,358,282,640,
6849,1063,88,57,145,
6850,885,54,53,107,
6851,4689,320,268,588,
6852,4908,376,311,687,
6854,380,31,22,53,
6855,4921,346,284,630,
6857,4700,317,268,585,
6859,1285,83,84,167,
6860,4001,273,228,501,
6861,4672,343,289,632,
6862,4796,330,266,596,
6863,4999,358,286,644,
6864,434,26,26,52,
6866,4854,337,281,618,
6870,242,15,15,30,
6872,4757,357,271,628,
6873,4994,328,284,612,
6874,4882,336,300,636,
6875,592,52,34,86,
6878,292,26,16,42,
6879,4814,347,283,630,
6880,4845,364,264,628,
6882,3603,230,227,457,
6883,4852,309,271,580,
6884,4963,404,293,697,
6885,4883,347,290,637,
6886,1129,68,68,136,
6887,4911,355,276,631,
6889,4663,311,312,623,
6890,3572,258,199,457,
6891,4747,347,282,629,
6892,3305,262,177,439,
6893,4759,399,255,654,
6894,4801,312,286,598,
6895,4758,295,277,572,
6896,314,18,16,34,
6898,4938,350,253,603,
6899,4836,343,258,601,
6901,1307,75,68,143,
6902,217,16,20,36,
6903,551,36,26,62,
6904,5019,409,247,656,
6905,439,35,29,64,
6906,4692,369,237,606,
6907,4726,336,272,608,
6908,4809,339,246,585,
6909,4808,383,246,629,
6910,4924,348,278,626,
6911,4871,338,232,570,
6913,4950,341,277,618,
6916,4809,362,279,641,
6918,1086,95,56,151,
6919,4901,383,300,683,
6920,3610,305,195,500,
6921,4870,369,270,639,
6922,576,39,41,80,
6924,4712,380,242,622,
6925,1753,137,106,243,
6926,4898,344,300,644,
6927,650,55,35,90,
6928,4803,282,292,574,
6931,4703,362,271,633,
6932,4725,348,277,625,
6934,345,21,30,51,
6935,33,4,4,8,
6937,1786,127,107,234,
6939,498,33,27,60,
6940,4799,345,321,666,
6941,4905,375,249,624,
6942,4630,365,269,634,
6943,4906,352,268,620,
6944,4673,343,243,586,
6945,182,14,13,27,
6946,4884,379,305,684,
6947,4640,316,288,604,
6948,1343,75,74,149,
6949,4789,352,261,613,
6950,4856,333,292,625,
6952,4843,355,288,643,
6954,4727,359,261,620,
6959,4912,349,279,628,
6960,4844,346,268,614,
6962,4778,362,273,635,
6963,1045,66,50,116,
6964,1762,119,105,224,
6965,4841,330,286,616,
6969,3585,275,189,464,
6971,3576,258,192,450,
6972,4818,343,280,623,
6973,4835,348,281,629,
6974,4901,350,274,624,
6975,4837,291,300,591,
6976,4730,337,244,581,
6978,5006,328,283,611,
6980,4915,338,297,635,
6981,4958,338,309,647,
6982,4952,346,263,609,
6983,4739,323,291,614,
6984,4903,334,286,620,
6985,4769,361,244,605,
6988,4716,317,264,581,
6989,4820,347,278,625,
6990,4668,307,258,565,
6992,4847,327,280,607,
6994,290,22,23,45,
6996,4928,379,268,647,
6997,4944,351,277,628,
6998,4761,326,244,570,
7000,51,3,3,6,
7001,1664,128,89,217,
7002,4894,344,275,619,
7003,4903,356,290,646,
7004,588,40,35,75,
7006,4892,360,294,654,
7008,4757,337,277,614,
7009,129,10,9,19,
7012,4826,378,283,661,
7013,4699,337,247,584,
7014,4676,362,266,628,
7016,4817,311,277,588,
7018,4810,367,287,654,
7019,92,5,7,12,
7020,273,15,10,25,
7021,1346,102,86,188,
7023,4879,355,257,612,
7024,4834,345,279,624,
7025,186,16,9,25,
7027,1129,83,65,148,
7028,4935,344,282,626,
7029,79,8,2,10,
7032,4686,321,299,620,
7034,168,13,10,23,
7035,137,12,8,20,
7036,4860,357,298,655,
7037,4807,342,306,648,
7038,4671,379,273,652,
7040,564,37,33,70,
7041,4852,321,296,617,
7043,4886,322,248,570,
7044,986,70,52,122,
7045,4922,340,311,651,
7047,4823,370,291,661,
7048,936,64,51,115,
7049,256,11,11,22,
7050,1096,73,62,135,
7051,4985,386,267,653,
7053,1389,103,75,178,
7054,4543,316,257,573,
7056,4759,345,256,601,
7057,63,5,2,7,
7058,3846,271,229,500,
7059,4826,363,251,614,
7060,4879,393,276,669,
7061,4879,348,274,622,
7062,3881,277,221,498,
7063,4913,354,269,623,
7065,4848,334,269,603,
7066,4905,380,283,663,
7067,1009,78,58,136,
7069,4848,337,286,623,
7071,128,12,3,15,
7073,5046,407,268,675,
7074,18,5,2,7,
7075,393,21,35,56,
7076,4802,323,273,596,
7077,4888,367,256,623,
7078,4814,330,264,594,
7079,5020,368,295,663,
7080,4901,366,263,629,
7081,842,63,52,115,
7083,4919,350,295,645,
7085,4932,340,297,637,
7086,1490,83,102,185,
7088,4774,360,293,653,
7089,4947,380,272,652,
7092,4903,379,261,640,
7093,1498,101,70,171,
7094,627,48,23,71,
7095,3757,261,214,475,
7096,3575,270,181,451,
7097,4813,373,256,629,
7098,4817,340,283,623,
7099,4765,345,284,629,
7101,255,16,19,35,
7102,4918,367,307,674,
7103,638,52,45,97,
7104,4932,354,292,646,
7105,4798,347,266,613,
7106,36,2,2,4,
7107,4808,347,235,582,
7110,4871,292,296,588,
7111,1052,75,68,143,
7112,4806,341,277,618,
7113,4839,336,259,595,
7114,4758,381,277,658,
7115,2218,175,122,297,
7118,1226,94,73,167,
7119,4867,354,282,636,
7120,4844,338,270,608,
7122,1066,67,59,126,
7123,4797,352,283,635,
7124,4741,316,295,611,
7125,1209,75,56,131,
7127,4633,326,253,579,
7128,748,51,48,99,
7130,4909,340,276,616,
7132,4869,386,299,685,
7133,4898,356,306,662,
7134,4710,350,266,616,
7135,1017,59,55,114,
7136,4938,379,259,638,
7137,4641,331,279,610,
7138,326,26,14,40,
7139,4755,326,268,594,
7140,3259,205,187,392,
7141,4684,346,281,627,
7142,3469,229,204,433,
7144,4713,322,263,585,
7146,2007,147,104,251,
7147,4986,372,304,676,
7148,1618,120,85,205,
7149,4880,341,307,648,
7150,517,36,31,67,
7151,4940,362,260,622,
7152,4818,322,294,616,
7153,4739,306,296,602,
7154,948,77,67,144,
7157,4914,391,301,692,
7158,4875,371,254,625,
7159,54,4,3,7,
7160,4765,338,255,593,
7161,4742,347,283,630,
7162,914,73,47,120,
7164,4931,365,290,655,
7165,4674,379,247,626,
7166,4663,345,229,574,
7167,4891,350,284,634,
7170,4712,339,256,595,
7171,4894,383,290,673,
7172,4835,344,252,596,
7173,796,52,41,93,
7174,4799,382,266,648,
7175,4848,341,275,616,
7176,438,33,26,59,
7177,4848,289,304,593,
7180,4758,333,270,603,
7182,697,44,35,79,
7183,4652,331,260,591,
7184,4908,358,236,594,
7185,4822,342,256,598,
7186,4896,365,302,667,
7188,3671,287,175,462,
7189,4890,360,275,635,
7190,4780,300,266,566,
7191,4913,346,275,621,
7192,4843,355,288,643,
7193,4844,361,285,646,
7194,678,49,35,84,
7197,4857,344,285,629,
7198,4975,344,280,624,
7199,296,29,19,48,
7200,4916,356,306,662,
7202,4803,326,252,578,
7203,3440,242,197,439,
7204,1380,95,78,173,
7206,4876,340,296,636,
7209,4058,290,234,524,
7211,4874,352,266,618,
7212,3607,259,197,456,
7213,4718,332,268,600,
7214,4905,370,309,679,
7217,4817,331,261,592,
7218,4688,350,273,623,
7220,4835,350,298,648,
7221,4903,362,291,653,
7223,4842,327,264,591,
7224,4935,327,283,610,
7225,94,10,7,17,
7226,4891,341,274,615,
7230,4804,343,274,617,
7235,637,47,46,93,
7236,3276,220,187,407,
7239,4882,351,259,610,
7240,4882,359,271,630,
7241,4905,330,258,588,
7242,4730,352,272,624,
7244,4862,372,274,646,
7245,4980,357,263,620,
7246,113,11,11,22,
7248,4917,333,289,622,
7249,4911,338,290,628,
7250,4776,344,280,624,
7251,4876,362,287,649,
7253,4830,372,275,647,
7255,29,1,3,4,
7256,4637,331,258,589,
7260,4890,342,288,630,
7262,1155,101,59,160,
7263,4883,361,285,646,
7264,4894,359,288,647,
7265,4884,345,266,611,
7266,59,8,2,10,
7269,4792,357,310,667,
7270,2012,150,96,246,
7271,4790,334,283,617,
7272,4794,360,249,609,
7273,4803,330,284,614,
7274,4812,325,306,631,
7275,4679,353,261,614,
7277,1146,73,68,141,
7279,4810,334,265,599,
7280,4590,352,261,613,
7281,5007,350,264,614,
7282,4784,332,285,617,
7285,4726,367,268,635,
7286,684,61,37,98,
7287,667,45,41,86,
7288,4979,337,281,618,
7289,4827,354,246,600,
7290,4875,366,261,627,
7291,4724,320,266,586,
7293,4889,343,288,631,
7295,4995,375,297,672,
7297,4921,362,286,648,
7298,4768,361,255,616,
7299,378,28,30,58,
7300,4849,348,261,609,
7301,4863,356,308,664,
7303,4808,360,268,628,
7304,1032,76,75,151,
7307,988,69,51,120,
7309,46,5,6,11,
7311,839,54,44,98,
7313,4922,367,289,656,
7314,21,2,1,3,
7315,4644,312,232,544,
7318,4930,359,264,623,
7320,4782,373,266,639,
7323,4834,371,251,622,
7324,960,63,59,122,
7325,4661,344,267,611,
7326,879,51,48,99,
7327,4958,390,249,639,
7328,4848,370,275,645,
7329,3847,262,232,494,
7330,2355,139,157,296,
7331,4813,347,321,668,
7332,4871,346,286,632,
7333,494,33,27,60,
7336,424,31,25,56,
7338,4841,289,293,582,
7340,815,66,49,115,
7341,1121,86,54,140,
7342,4959,361,266,627,
7344,863,67,42,109,
7347,4959,375,272,647,
7348,588,43,34,77,
7349,4928,372,290,662,
7350,4862,334,277,611,
7351,4678,300,288,588,
7352,4861,386,275,661,
7353,4903,367,297,664,
7355,4987,346,285,631,
7358,3677,233,214,447,
7359,169,13,8,21,
7361,4738,362,240,602,
7362,4915,367,305,672,
7363,4806,333,279,612,
7364,4884,340,272,612,
7365,4821,352,274,626,
7366,4880,356,287,643,
7368,4779,342,289,631,
7369,1941,150,102,252,
7370,4896,362,281,643,
7371,1179,76,68,144,
7372,4917,380,299,679,
7373,4848,401,233,634,
7374,4908,361,296,657,
7375,4885,345,287,632,
7376,1658,131,85,216,
7377,4661,337,267,604,
7378,463,32,25,57,
7380,343,23,10,33,
7381,4706,349,269,618,
7383,4780,344,298,642,
7384,4948,377,279,656,
7385,905,61,50,111,
7387,4847,363,259,622,
7389,4922,339,285,624,
7390,4947,376,281,657,
7391,77,5,7,12,
7392,409,32,27,59,
7393,4962,335,285,620,
7394,1125,93,58,151,
7395,4650,330,242,572,
7396,5002,373,270,643,
7397,1172,100,70,170,
7398,4801,358,289,647,
7399,4913,335,285,620,
7401,1176,77,63,140,
7402,4777,360,273,633,
7404,4823,354,250,604,
7405,402,33,25,58,
7406,63,3,3,6,
7407,4755,336,266,602,
7409,4929,350,316,666,
7410,4746,327,274,601,
7411,4758,374,278,652,
7412,4878,371,278,649,
7413,3589,259,193,452,
7414,3590,285,199,484,
7416,5053,357,296,653,
7418,4864,375,264,639,
7420,4853,327,299,626,
7422,3656,271,211,482,
7423,4878,365,275,640,
7424,696,35,42,77,
7426,4877,332,305,637,
7427,4810,341,300,641,
7430,440,43,26,69,
7433,1270,111,69,180,
7434,393,23,25,48,
7435,4996,362,275,637,
7436,4709,345,277,622,
7438,4867,363,258,621,
7439,4734,357,232,589,
7440,4946,356,277,633,
7442,4823,335,269,604,
7443,565,41,38,79,
7444,4789,328,251,579,
7445,511,29,27,56,
7447,4700,375,252,627,
7448,4847,339,295,634,
7449,151,10,8,18,
7450,4953,376,293,669,
7451,4856,337,278,615,
7452,3373,228,215,443,
7453,427,20,24,44,
7455,4807,346,230,576,
7457,479,28,30,58,
7458,4934,373,282,655,
7459,4912,342,279,621,
7460,4743,347,287,634,
7461,1271,93,83,176,
7462,4770,324,278,602,
7463,4692,350,265,615,
7464,46,3,4,7,
7467,4684,359,276,635,
7468,4859,404,253,657,
7469,83,2,5,7,
7471,282,27,19,46,
7472,736,53,45,98,
7473,409,37,30,67,
7474,4872,380,281,661,
7475,4727,321,289,610,
7477,4878,359,278,637,
7479,4815,352,264,616,
7480,4687,338,280,618,
7481,4797,356,287,643,
7482,4791,331,305,636,
7484,742,48,40,88,
7486,980,67,61,128,
7487,4656,332,275,607,
7488,1066,71,72,143,
7490,4849,297,298,595,
7491,4814,350,277,627,
7492,4744,378,240,618,
7493,4998,353,280,633,
7494,4954,339,294,633,
7496,741,51,43,94,
7497,4796,315,272,587,
7498,4765,353,248,601,
7500,982,69,65,134,
7501,4657,328,267,595,
7503,1240,84,61,145,
7504,4876,343,254,597,
7507,182,14,8,22,
7508,616,35,30,65,
7509,4783,354,263,617,
7511,4858,369,279,648,
7512,4826,313,328,641,
7513,586,41,27,68,
7514,4746,360,260,620,
7515,4844,342,256,598,
7516,4768,335,266,601,
7518,4840,333,250,583,
7519,1134,97,76,173,
7520,4972,343,261,604,
7522,1236,91,64,155,
7523,406,36,18,54,
7524,4717,359,256,615,
7526,4916,331,293,624,
7527,4824,349,267,616,
7528,812,60,48,108,
7529,4838,392,291,683,
7530,4882,360,294,654,
7531,563,24,29,53,
7533,4831,315,270,585,
7534,4828,351,298,649,
7535,4887,371,271,642,
7537,4809,370,272,642,
7540,4619,310,248,558,
7541,4814,363,265,628,
7543,350,24,18,42,
7544,4833,368,279,647,
7545,4949,362,268,630,
7546,4855,314,289,603,
7548,4802,343,247,590,
7549,529,42,34,76,
7551,3483,260,199,459,
7552,1210,64,83,147,
7554,4828,361,264,625,
7556,4909,405,255,660,
7557,510,34,35,69,
7558,4867,345,247,592,
7559,265,23,14,37,
7563,4752,337,280,617,
7564,4915,373,284,657,
7565,4918,339,296,635,
7569,120,12,3,15,
7570,4999,350,278,628,
7571,4935,363,288,651,
7572,4810,355,266,621,
7573,4898,332,296,628,
7574,1166,92,66,158,
7575,4914,303,245,548,
7578,808,69,41,110,
7579,4676,345,277,622,
7580,4871,338,267,605,
7581,520,29,37,66,
7582,5016,360,290,650,
7585,4729,383,242,625,
7586,4992,379,273,652,
7587,4985,338,285,623,
7588,784,81,42,123,
7589,3725,245,207,452,
7590,4902,348,261,609,
7591,5044,365,289,654,
7592,4995,416,295,711,
7593,4925,328,275,603,
7595,3863,250,206,456,
7596,4937,368,266,634,
7597,4867,343,275,618,
7598,4754,340,241,581,
7600,4741,353,262,615,
7602,3387,207,188,395,
7603,1597,123,85,208,
7604,4898,329,293,622,
7605,4833,380,253,633,
7606,4808,336,256,592,
7607,4883,336,268,604,
7608,4713,366,254,620,
7609,4890,346,286,632,
7611,679,55,38,93,
7612,4843,372,298,670,
7614,4876,321,298,619,
7615,4817,316,262,578,
7616,4828,396,281,677,
7619,4840,320,263,583,
7621,4970,360,276,636,
7622,4908,356,271,627,
7623,4757,334,243,577,
7624,1009,78,60,138,
7625,4859,359,249,608,
7628,4909,340,269,609,
7629,53,3,3,6,
7630,4879,353,269,622,
7631,4824,339,288,627,
7632,4669,311,271,582,
7633,4884,331,303,634,
7634,4961,366,279,645,
7635,47,3,1,4,
7636,286,15,13,28,
7638,4944,356,284,640,
7639,4909,378,297,675,
7640,4765,363,276,639,
7641,4830,352,247,599,
7642,4902,342,289,631,
7643,609,44,41,85,
7644,4852,343,256,599,
7645,4923,329,300,629,
7646,86,8,9,17,
7648,4895,372,265,637,
7649,4841,333,281,614,
7650,4864,329,278,607,
7651,4919,345,263,608,
7652,406,33,25,58,
7653,4871,340,280,620,
7656,4890,340,290,630,
7657,4778,330,253,583,
7658,4835,334,270,604,
7659,4809,341,297,638,
7660,4807,339,256,595,
7661,4816,372,284,656,
7662,689,39,45,84,
7663,4796,322,282,604,
7665,631,49,42,91,
7666,4834,342,290,632,
7667,4772,358,255,613,
7670,4838,364,286,650,
7672,4778,357,276,633,
7675,4850,351,280,631,
7676,4787,355,263,618,
7678,4824,351,306,657,
7679,4770,321,268,589,
7680,495,47,28,75,
7682,4839,314,268,582,
7683,4852,348,251,599,
7684,4762,313,274,587,
7685,3731,276,195,471,
7686,968,64,52,116,
7687,1205,83,62,145,
7688,1750,137,102,239,
7689,4858,342,254,596,
7690,4943,357,279,636,
7691,4897,367,307,674,
7693,395,33,20,53,
7694,5005,347,269,616,
7697,4785,315,290,605,
7698,4742,396,255,651,
7699,387,34,17,51,
7700,4877,322,265,587,
7701,4958,350,287,637,
7702,4802,346,317,663,
7703,4945,375,282,657,
7704,4717,333,259,592,
7705,1428,101,72,173,
7706,4630,337,239,576,
7707,4666,324,261,585,
7709,4906,356,236,592,
7710,4802,357,274,631,
7711,543,41,27,68,
7713,4832,327,274,601,
7714,246,14,18,32,
7715,4752,325,285,610,
7716,4866,385,298,683,
7717,4877,353,253,606,
7718,1135,86,64,150,
7719,4879,360,294,654,
7720,181,16,12,28,
7721,538,37,38,75,
7722,283,17,15,32,
7723,4850,359,291,650,
7724,4883,346,312,658,
7725,4850,357,260,617,
7726,4763,345,279,624,
7727,330,26,14,40,
7729,4859,323,274,597,
7730,4817,365,256,621,
7731,3709,250,178,428,
7732,4915,349,289,638,
7733,4810,323,262,585,
7734,4785,371,289,660,
7735,4863,344,247,591,
7737,4709,349,304,653,
7738,692,52,39,91,
7740,4861,336,270,606,
7741,4689,356,267,623,
7744,994,66,60,126,
7746,60,10,4,14,
7748,4857,358,242,600,
7749,4887,339,288,627,
7750,4811,361,257,618,
7752,320,17,17,34,
7753,4769,337,265,602,
7754,4709,355,234,589,
7755,615,40,26,66,
7756,4992,330,277,607,
7759,4801,373,290,663,
7760,128,13,10,23,
7761,4701,340,288,628,
7763,888,83,47,130,
7765,4748,337,300,637,
7766,4923,403,274,677,
7769,4001,311,231,542,
7770,4693,342,278,620,
7772,4761,351,263,614,
7773,4861,376,255,631,
7775,3669,246,216,462,
7779,40,3,3,6,
7781,4784,336,285,621,
7782,4973,434,275,709,
7783,626,43,45,88,
7784,767,50,40,90,
7785,4835,355,280,635,
7786,4724,345,254,599,
7789,4839,374,267,641,
7790,4914,344,286,630,
7791,4837,359,268,627,
7792,3486,260,179,439,
7793,518,43,23,66,
7794,4915,332,261,593,
7795,4828,365,277,642,
7796,4636,339,257,596,
7797,4864,343,266,609,
7798,4790,358,245,603,
7799,4906,388,255,643,
7801,4927,367,242,609,
7802,4694,314,300,614,
7804,4868,352,261,613,
7805,1553,119,103,222,
7809,860,66,59,125,
7810,4911,347,267,614,
7812,4900,344,295,639,
7814,1308,94,80,174,
7816,4866,331,266,597,
7817,4889,350,293,643,
7818,4847,332,275,607,
7819,4751,350,242,592,
7820,546,37,45,82,
7821,1257,92,77,169,
7822,2078,159,116,275,
7823,4849,315,284,599,
7824,4913,311,267,578,
7826,4927,388,258,646,
7827,4856,363,258,621,
7828,4806,351,307,658,
7829,4806,340,291,631,
7830,679,61,41,102,
7831,4752,354,296,650,
7832,4928,356,295,651,
7833,4838,365,276,641,
7836,4858,394,250,644,
7837,4676,355,261,616,
7839,4978,355,304,659,
7840,4696,330,260,590,
7842,4927,358,296,654,
7844,3736,254,216,470,
7845,838,47,45,92,
7846,4843,349,314,663,
7847,4918,352,272,624,
7850,4757,342,249,591,
7851,958,55,64,119,
7852,5001,356,273,629,
7853,213,17,12,29,
7855,4881,371,267,638,
7856,4827,341,296,637,
7857,4912,347,299,646,
7858,4807,356,244,600,
7860,4743,338,239,577,
7862,1209,77,67,144,
7864,4914,334,256,590,
7867,4972,375,277,652,
7868,4826,352,279,631,
7869,4953,371,272,643,
7870,4927,404,274,678,
7872,4916,372,280,652,
7873,4753,350,275,625,
7874,4790,358,264,622,
7875,738,50,29,79,
7876,4833,326,278,604,
7877,4772,319,284,603,
7878,44,1,2,3,
7879,1096,58,56,114,
7880,4977,326,267,593,
7881,4865,353,264,617,
7882,4941,377,275,652,
7883,4884,366,286,652,
7884,4937,383,274,657,
7885,4851,287,269,556,
7886,4745,343,263,606,
7887,4912,353,320,673,
7888,4847,306,315,621,
7889,4743,345,280,625,
7890,4881,305,288,593,
7891,4889,394,245,639,
7892,4760,361,274,635,
7895,4757,354,270,624,
7896,4868,338,262,600,
7899,4820,349,260,609,
7900,4774,368,279,647,
7901,4803,324,269,593,
7903,4979,382,290,672,
7904,878,61,54,115,
7905,4762,329,286,615,
7906,116,11,7,18,
7907,4859,366,277,643,
7909,4828,371,283,654,
7910,4938,345,258,603,
7911,4829,346,285,631,
7912,4926,358,292,650,
7913,3788,258,241,499,
7914,4840,327,273,600,
7915,1283,102,64,166,
7916,4864,382,284,666,
7917,251,16,13,29,
7918,4927,352,271,623,
7919,1166,93,54,147,
7920,4862,302,274,576,
7921,4874,347,275,622,
7923,4677,333,264,597,
7924,4814,380,272,652,
7925,4750,378,265,643,
7926,4885,391,266,657,
7927,1057,91,56,147,
7929,4834,377,253,630,
7930,1231,79,81,160,
7933,4770,328,293,621,
7934,498,32,34,66,
7935,4774,346,274,620,
7936,4880,354,286,640,
7937,4842,360,279,639,
7938,4839,313,285,598,
7939,2938,195,138,333,
7940,1169,85,65,150,
7943,133,11,10,21,
7945,423,27,30,57,
7948,4808,320,288,608,
7949,744,42,34,76,
7951,4859,344,251,595,
7952,4959,360,287,647,
7953,4903,317,269,586,
7954,4873,341,285,626,
7955,4819,362,268,630,
7956,274,22,25,47,
7957,2500,196,135,331,
7958,4851,320,275,595,
7959,1096,78,54,132,
7960,568,48,29,77,
7961,4842,342,264,606,
7962,4915,328,296,624,
7964,4961,417,290,707,
7965,4902,362,258,620,
7966,4928,373,249,622,
7967,4999,366,267,633,
7968,73,6,2,8,
7969,4862,346,255,601,
7970,4696,364,279,643,
7971,4958,343,294,637,
7973,3636,258,205,463,
7975,4733,336,275,611,
7977,4819,347,261,608,
7978,4870,329,297,626,
7979,4756,362,282,644,
7980,4870,385,248,633,
7981,4169,270,265,535,
7982,4856,358,279,637,
7983,4983,401,249,650,
7985,185,11,7,18,
7986,344,18,22,40,
7987,4933,377,300,677,
7988,4672,332,259,591,
7989,834,54,46,100,
7992,4786,360,294,654,
7993,3836,298,188,486,
7995,4650,320,287,607,
7999,4945,373,294,667,
8000,1170,84,66,150,
8002,4869,358,280,638,
8004,4719,308,280,588,
8005,4797,335,274,609,
8006,4885,355,252,607,
8009,4563,294,247,541,
8010,3565,259,183,442,
8011,4866,360,274,634,
8014,1304,72,80,152,
8016,4759,327,265,592,
8017,4900,367,261,628,
8018,4882,380,283,663,
8021,4868,346,255,601,
8024,4688,320,286,606,
8025,4066,282,239,521,
8026,900,65,46,111,
8027,4955,357,259,616,
8028,4937,382,289,671,
8029,4807,358,288,646,
8031,166,10,6,16,
8032,4845,353,271,624,
8033,1258,94,79,173,
8034,4894,342,285,627,
8037,4767,355,271,626,
8038,4930,359,280,639,
8039,4872,342,302,644,
8040,205,15,6,21,
8041,4781,332,260,592,
8042,1405,108,69,177,
8044,4892,354,267,621,
8045,3006,236,148,384,
8046,833,72,46,118,
8047,1312,80,86,166,
8048,4885,354,276,630,
8049,106,7,8,15,
8050,101,8,7,15,
8051,4860,308,325,633,
8053,4794,382,291,673,
8056,4798,316,281,597,
8057,222,8,13,21,
8059,4888,376,308,684,
8060,4859,370,254,624,
8062,1452,97,78,175,
8063,1318,92,64,156,
8064,4712,323,289,612,
8067,4703,293,272,565,
8068,4705,381,263,644,
8071,4817,338,283,621,
8072,4903,366,292,658,
8073,4965,391,262,653,
8074,4780,371,253,624,
8075,4831,350,251,601,
8076,4931,385,269,654,
8078,4867,356,273,629,
8080,3631,278,168,446,
8081,1668,130,85,215,
8082,4716,364,265,629,
8083,4896,395,257,652,
8084,4860,327,295,622,
8085,4787,329,268,597,
8086,413,30,14,44,
8088,4790,316,277,593,
8089,174,14,13,27,
8090,4846,340,315,655,
8091,613,39,34,73,
8092,181,13,11,24,
8094,4838,328,275,603,
8097,4879,359,272,631,
8099,112,15,8,23,
8100,409,30,26,56,
8101,4659,336,274,610,
8102,83,6,4,10,
8103,4862,330,294,624,
8104,4878,376,285,661,
8105,4849,359,288,647,
8108,1767,119,103,222,
8110,681,50,37,87,
8111,1840,117,114,231,
8113,353,33,17,50,
8114,4801,337,262,599,
8115,5034,354,292,646,
8116,4811,336,308,644,
8117,3742,262,210,472,
8118,4859,379,273,652,
8121,4945,349,295,644,
8123,1687,115,111,226,
8124,4769,362,272,634,
8126,720,48,51,99,
8127,300,29,16,45,
8129,128,15,4,19,
8130,238,15,13,28,
8132,4801,317,272,589,
8134,4881,386,264,650,
8135,203,9,9,18,
8137,833,63,47,110,
8138,4880,316,333,649,
8139,4779,315,270,585,
8140,618,46,43,89,
8142,636,52,37,89,
8144,488,30,30,60,
8146,4776,323,261,584,
8147,4830,359,262,621,
8148,807,58,50,108,
8149,3537,275,224,499,
8150,4846,318,266,584,
8151,4711,336,256,592,
8152,4945,327,289,616,
8153,1199,81,60,141,
8154,497,38,31,69,
8155,4785,309,275,584,
8156,4874,357,270,627,
8157,4798,304,264,568,
8158,69,9,5,14,
8159,4860,345,298,643,
8161,4756,316,274,590,
8162,1305,106,75,181,
8163,1180,83,64,147,
8164,687,46,32,78,
8165,1593,118,98,216,
8166,1213,70,81,151,
8167,4799,337,262,599,
8169,4882,368,276,644,
8170,208,14,12,26,
8171,408,30,26,56,
8172,4849,363,264,627,
8173,800,68,38,106,
8174,4891,376,280,656,
8175,4762,330,286,616,
8178,4734,327,242,569,
8183,4770,365,259,624,
8185,4861,323,314,637,
8186,4751,331,294,625,
8187,4989,360,251,611,
8188,1181,85,70,155,
8189,1175,82,51,133,
8190,4931,369,280,649,
8191,4676,351,268,619,
8192,4821,345,279,624,
8196,4821,335,266,601,
8197,4809,350,259,609,
8198,4757,346,265,611,
8200,4796,318,255,573,
8201,524,28,30,58,
8202,4871,342,307,649,
8203,4734,354,251,605,
8205,1116,87,62,149,
8207,4887,340,270,610,
8208,4848,338,258,596,
8209,4854,361,301,662,
8210,4833,338,288,626,
8211,1080,86,46,132,
8212,4764,382,289,671,
8214,4827,340,281,621,
8216,4922,386,261,647,
8217,4962,368,263,631,
8218,4892,322,313,635,
8220,4851,355,268,623,
8221,4909,366,292,658,
8222,4779,307,270,577,
8223,4949,350,299,649,
8224,4791,356,257,613,
8225,4689,312,275,587,
8226,4166,306,250,556,
8228,4876,359,257,616,
8229,4828,326,256,582,
8230,786,66,48,114,
8232,4900,345,294,639,
8233,4887,381,277,658,
8234,1290,100,76,176,
8235,4843,339,303,642,
8238,4997,355,302,657,
8240,4928,344,282,626,
8241,4832,341,243,584,
8242,4786,331,265,596,
8243,4835,319,274,593,
8244,5058,370,299,669,
8247,3477,264,179,443,
8248,4815,351,267,618,
8250,483,38,36,74,
8251,4869,355,227,582,
8252,4807,331,295,626,
8253,68,7,3,10,
8254,3722,270,201,471,
8255,4818,340,293,633,
8257,4897,363,295,658,
8258,4865,365,292,657,
8259,95,10,8,18,
8260,4895,357,300,657,
8261,195,20,11,31,
8262,570,48,38,86,
8264,1258,82,69,151,
8265,39,5,1,6,
8267,4815,365,286,651,
8268,4811,308,278,586,
8269,4851,350,269,619,
8270,1141,98,62,160,
8271,3760,248,262,510,
8273,174,10,18,28,
8274,4807,347,265,612,
8276,4835,333,275,608,
8277,3681,278,196,474,
8278,4704,319,268,587,
8279,4802,316,248,564,
8280,4750,322,294,616,
8282,4884,345,298,643,
8283,4896,375,240,615,
8284,4769,360,255,615,
8285,695,56,43,99,
8286,771,57,41,98,
8287,4973,364,271,635,
8288,4887,349,304,653,
8290,4881,382,298,680,
8291,1040,64,60,124,
8292,767,54,40,94,
8293,4819,367,289,656,
8294,4838,357,283,640,
8295,1562,113,73,186,
8296,4789,375,288,663,
8298,4818,352,241,593,
8299,4787,368,308,676,
8300,4757,349,261,610,
8301,298,23,17,40,
8302,1865,137,86,223,
8303,814,59,55,114,
8304,4907,353,290,643,
8305,4791,346,232,578,
8306,482,41,30,71,
8307,4870,362,278,640,
8308,4844,343,283,626,
8309,478,24,20,44,
8310,4848,324,273,597,
8312,322,22,28,50,
8313,1131,84,54,138,
8314,4935,382,255,637,
8315,1571,118,90,208,
8318,4734,298,298,596,
8319,643,42,30,72,
8320,4827,342,304,646,
8322,3431,242,215,457,
8326,4871,346,305,651,
8327,4918,355,285,640,
8328,4926,370,264,634,
8329,4797,376,281,657,
8330,1324,106,76,182,
8332,1271,103,81,184,
8333,3241,246,162,408,
8334,98,9,8,17,
8335,4866,350,298,648,
8336,3796,238,191,429,
8338,4831,368,262,630,
8344,4795,347,293,640,
8345,4896,355,280,635,
8346,4794,358,257,615,
8348,4776,343,261,604,
8349,3825,240,226,466,
8350,4864,314,275,589,
8351,4845,391,279,670,
8354,4770,349,265,614,
8355,4798,345,289,634,
8357,4956,342,282,624,
8358,1443,112,93,205,
8359,4688,352,290,642,
8362,2656,181,164,345,
8363,4893,353,285,638,
8364,4889,320,284,604,
8365,4969,356,291,647,
8366,4866,343,287,630,
8367,4986,394,276,670,
8368,4902,338,279,617,
8369,572,42,33,75,
8370,4830,363,281,644,
8371,4914,312,279,591,
8372,4789,353,274,627,
8373,4801,334,289,623,
8374,4986,338,289,627,
8375,4987,357,319,676,
8376,4843,346,279,625,
8377,4863,364,269,633,
8378,4785,365,245,610,
8380,1324,88,71,159,
8381,474,34,30,64,
8384,4819,342,273,615,
8386,4889,314,282,596,
8387,4896,381,257,638,
8388,4735,368,223,591,
8389,4888,360,258,618,
8391,4970,341,267,608,
8392,4910,337,285,622,
8393,481,31,27,58,
8394,4731,358,264,622,
8395,4905,338,288,626,
8396,4649,346,268,614,
8398,4919,348,277,625,
8399,3563,273,189,462,
8400,193,10,12,22,
8401,4741,331,251,582,
8402,4776,340,268,608,
8404,2663,192,149,341,
8406,715,54,41,95,
8407,779,62,44,106,
8408,3291,245,190,435,
8409,4780,363,251,614,
8410,4830,354,289,643,
8412,4949,340,270,610,
8413,4711,350,246,596,
8414,4759,336,275,611,
8415,23,5,1,6,
8416,1335,91,72,163,
8417,4771,363,276,639,
8418,660,43,38,81,
8419,4747,368,268,636,
8420,175,11,14,25,
8422,250,15,13,28,
8423,4969,364,286,650,
8424,841,63,50,113,
8425,534,42,22,64,
8426,4846,328,287,615,
8428,4994,349,296,645,
8429,4757,373,260,633,
8430,1160,82,56,138,
8431,224,15,16,31,
8432,4803,335,269,604,
8433,4893,376,280,656,
8434,4884,369,273,642,
8435,4849,326,285,611,
8436,477,38,37,75,
8437,898,71,66,137,
8440,4849,380,278,658,
8442,4814,300,277,577,
8443,642,46,47,93,
8444,4812,322,281,603,
8445,4634,384,256,640,
8449,4837,381,274,655,
8450,678,39,33,72,
8451,4850,379,258,637,
8452,4698,336,294,630,
8453,971,70,45,115,
8455,961,83,65,148,
8457,4895,404,264,668,
8458,4934,330,277,607,
8459,389,33,14,47,
8460,4860,325,278,603,
8461,4852,384,280,664,
8462,1539,128,86,214,
8463,4729,328,271,599,
8464,4960,357,307,664,
8466,462,40,26,66,
8467,850,68,54,122,
8468,4877,365,287,652,
8469,337,20,10,30,
8471,4901,381,273,654,
8473,937,50,65,115,
8474,418,32,23,55,
8475,1447,116,77,193,
8476,3175,186,225,411,
8477,4744,326,309,635,
8478,4826,329,285,614,
8479,4786,332,303,635,
8480,3583,234,233,467,
8481,4869,385,262,647,
8482,78,9,3,12,
8483,689,43,34,77,
8484,4920,323,304,627,
8485,1580,117,59,176,
8487,4853,339,244,583,
8491,4745,341,281,622,
8492,161,8,9,17,
8493,3387,267,205,472,
8494,1122,90,62,152,
8495,4823,351,248,599,
8497,4932,388,307,695,
8498,4815,356,277,633,
8500,5001,366,272,638,
8501,4793,322,269,591,
8505,594,43,21,64,
8506,5007,339,287,626,
8507,4900,360,248,608,
8509,4679,323,276,599,
8510,4947,374,264,638,
8511,4678,346,278,624,
8512,132,13,7,20,
8516,4835,323,277,600,
8517,4687,319,289,608,
8519,4995,362,296,658,
8520,4976,367,281,648,
8521,4927,342,268,610,
8523,4903,357,295,652,
8525,4856,382,283,665,
8526,4922,369,283,652,
8528,4811,322,274,596,
8529,189,11,4,15,
8530,659,45,39,84,
8531,428,31,25,56,
8532,4644,342,261,603,
8535,4961,377,275,652,
8537,4838,393,276,669,
8539,4895,341,275,616,
8541,4790,352,287,639,
8542,4789,328,282,610,
8547,4931,365,275,640,
8548,4837,370,260,630,
8549,500,36,21,57,
8550,237,12,12,24,
8551,482,33,25,58,
8552,4849,347,274,621,
8553,4812,369,293,662,
8554,99,8,9,17,
8555,4810,382,284,666,
8556,4872,415,274,689,
8557,4662,323,265,588,
8559,939,70,62,132,
8560,4814,355,286,641,
8561,4913,373,290,663,
8562,4751,340,281,621,
8563,466,35,17,52,
8565,1096,77,60,137,
8566,4787,343,272,615,
8570,4811,367,265,632,
8572,4901,363,271,634,
8573,4901,373,251,624,
8574,348,22,23,45,
8575,4218,297,212,509,
8576,4653,344,236,580,
8578,336,27,19,46,
8579,4774,342,264,606,
8580,4820,344,275,619,
8581,4680,331,241,572,
8582,182,15,13,28,
8583,4785,351,263,614,
8584,4816,370,276,646,
8585,4738,329,267,596,
8586,1703,125,109,234,
8587,4857,324,275,599,
8588,4870,375,293,668,
8589,178,13,11,24,
8591,298,22,9,31,
8592,4812,348,267,615,
8593,4965,354,305,659,
8594,4869,374,265,639,
8595,4795,360,300,660,
8597,399,32,20,52,
8598,4865,347,274,621,
8599,4927,344,298,642,
8600,4814,341,272,613,
8601,4831,330,289,619,
8602,4963,358,276,634,
8603,4855,352,283,635,
8605,4764,339,267,606,
8606,4827,304,285,589,
8607,4753,333,242,575,
8608,265,11,9,20,
8609,4861,355,264,619,
8611,4689,371,236,607,
8612,4913,330,274,604,
8613,4778,328,262,590,
8614,201,10,15,25,
8616,4808,342,297,639,
8617,4816,331,270,601,
8618,3621,289,191,480,
8621,1021,73,55,128,
8622,4813,382,291,673,
8624,787,54,47,101,
8626,4844,383,262,645,
8628,1350,86,76,162,
8629,623,45,30,75,
8631,544,44,30,74,
8632,4801,371,267,638,
8633,4830,326,247,573,
8635,145,7,14,21,
8636,4620,349,258,607,
8637,4777,322,268,590,
8639,4883,338,267,605,
8641,4871,365,273,638,
8642,4738,352,275,627,
8643,4950,352,282,634,
8644,4802,349,299,648,
8645,4796,352,262,614,
8646,991,64,60,124,
8647,4954,366,288,654,
8648,4910,341,262,603,
8650,4773,376,279,655,
8652,4782,377,261,638,
8653,518,42,33,75,
8654,4965,352,296,648,
8656,830,62,56,118,
8658,4813,392,226,618,
8659,4922,373,276,649,
8660,4844,340,238,578,
8661,4950,367,294,661,
8662,241,15,16,31,
8663,4910,358,244,602,
8666,43,4,3,7,
8667,4769,354,277,631,
8669,4696,396,249,645,
8670,4870,347,299,646,
8671,4894,334,283,617,
8672,4898,332,269,601,
8673,4847,357,271,628,
8675,4995,322,275,597,
8676,4856,387,283,670,
8678,887,54,53,107,
8679,4998,391,265,656,
8680,4853,337,300,637,
8681,4925,378,276,654,
8682,4827,337,240,577,
8684,4769,331,273,604,
8685,391,25,29,54,
8686,4898,318,302,620,
8687,4637,353,284,637,
8688,4896,329,295,624,
8689,4798,353,271,624,
8690,1255,95,72,167,
8692,4744,326,284,610,
8693,5023,341,292,633,
8694,4686,343,251,594,
8695,1054,88,51,139,
8696,1110,79,62,141,
8697,4909,346,253,599,
8698,4764,320,256,576,
8700,4750,290,279,569,
8701,4791,356,271,627,
8703,5062,389,317,706,
8704,4892,379,250,629,
8705,3574,276,218,494,
8706,4764,356,274,630,
8709,4105,267,242,509,
8712,4694,329,279,608,
8713,743,57,31,88,
8714,4892,347,269,616,
8715,4771,335,261,596,
8717,4833,344,291,635,
8719,4788,339,314,653,
8721,1603,112,98,210,
8722,682,51,35,86,
8723,4831,358,275,633,
8724,4872,346,270,616,
8726,4869,374,258,632,
8727,4628,319,255,574,
8728,261,25,9,34,
8729,5006,388,304,692,
8731,142,16,8,24,
8733,2034,131,117,248,
8735,4799,379,246,625,
8737,4894,341,290,631,
8738,661,40,40,80,
8739,4803,332,292,624,
8740,4821,366,288,654,
8742,4900,360,288,648,
8743,4897,340,258,598,
8744,4823,364,267,631,
8746,4834,329,287,616,
8747,4876,349,263,612,
8748,1323,113,71,184,
8749,4811,337,317,654,
8752,178,11,11,22,
8755,4894,372,311,683,
8756,4873,344,252,596,
8757,144,7,9,16,
8758,251,17,13,30,
8759,4759,337,284,621,
8760,1003,76,58,134,
8761,4762,359,287,646,
8762,379,24,27,51,
8763,4758,335,287,622,
8764,509,43,26,69,
8765,4749,332,287,619,
8766,4920,320,272,592,
8767,4866,364,321,685,
8768,4927,389,251,640,
8769,245,10,8,18,
8771,3619,273,222,495,
8772,141,10,7,17,
8773,122,6,11,17,
8778,493,28,37,65,
8779,4726,347,278,625,
8780,4898,375,268,643,
8781,4985,320,306,626,
8783,589,47,38,85,
8785,914,59,52,111,
8788,4800,388,259,647,
8789,4913,386,286,672,
8790,4921,378,269,647,
8791,4788,328,280,608,
8793,4862,322,307,629,
8794,1625,125,103,228,
8796,4742,353,244,597,
8797,869,80,52,132,
8798,1216,95,57,152,
8799,4854,360,286,646,
8800,4746,375,273,648,
8801,511,35,22,57,
8804,1948,153,115,268,
8805,4783,359,257,616,
8806,350,21,17,38,
8807,4725,383,267,650,
8808,1031,76,61,137,
8810,4938,341,294,635,
8811,4736,323,267,590,
8812,1658,121,96,217,
8814,268,21,12,33,
8815,4832,349,311,660,
8817,4914,338,282,620,
8818,4988,358,291,649,
8819,4765,325,277,602,
8820,4953,350,298,648,
8821,4848,346,298,644,
8822,4842,362,268,630,
8824,4774,355,287,642,
8825,4901,381,257,638,
8826,4952,359,296,655,
8827,4785,329,267,596,
8829,604,53,30,83,
8830,4655,360,232,592,
8832,488,40,25,65,
8833,4938,342,288,630,
8834,4781,355,277,632,
8835,1244,96,67,163,
8836,190,17,5,22,
8838,4838,366,276,642,
8839,4860,312,268,580,
8840,4770,341,300,641,
8842,4822,357,284,641,
8843,4924,354,274,628,
8844,4856,336,282,618,
8846,4941,362,254,616,
8847,1018,61,63,124,
8849,2936,215,174,389,
8852,4884,367,272,639,
8853,1136,90,53,143,
8854,4795,365,264,629,
8855,4839,311,259,570,
8856,4965,341,299,640,
8858,4880,336,281,617,
8859,4831,357,285,642,
8862,196,16,6,22,
8863,3551,259,228,487,
8864,4740,356,289,645,
8865,4962,377,279,656,
8866,4782,289,301,590,
8867,4907,339,265,604,
8870,4898,371,269,640,
8871,166,15,9,24,
8872,300,24,16,40,
8873,167,12,14,26,
8875,4849,358,250,608,
8876,4762,332,267,599,
8877,3793,278,191,469,
8878,4858,353,284,637,
8879,4923,325,297,622,
8880,4860,367,305,672,
8882,4788,360,276,636,
8883,4898,373,273,646,
8885,39,3,2,5,
8886,4898,358,309,667,
8887,4793,356,265,621,
8888,493,23,23,46,
8889,4725,325,270,595,
8890,4910,343,284,627,
8891,4744,317,277,594,
8892,4781,379,260,639,
8893,4945,317,268,585,
8894,4789,373,245,618,
8898,4965,388,284,672,
8899,4847,371,267,638,
8902,4457,293,267,560,
8903,535,38,31,69,
8906,4795,316,278,594,
8907,1334,101,74,175,
8908,94,7,6,13,
8909,1290,93,69,162,
8910,4824,384,276,660,
8911,98,8,6,14,
8912,4806,327,290,617,
8913,264,13,22,35,
8915,2685,179,153,332,
8918,3699,265,213,478,
8919,4845,316,288,604,
8920,4882,312,290,602,
8921,1264,88,71,159,
8922,4724,338,307,645,
8925,759,43,34,77,
8927,677,53,40,93,
8928,4854,345,269,614,
8929,4762,343,250,593,
8930,4894,363,264,627,
8931,3334,245,194,439,
8932,4879,344,301,645,
8933,603,52,42,94,
8935,4795,311,257,568,
8937,1581,119,87,206,
8938,4925,411,245,656,
8939,4855,352,269,621,
8940,418,29,19,48,
8941,4959,375,285,660,
8942,1508,103,88,191,
8943,1290,97,65,162,
8945,1331,77,64,141,
8947,4682,359,311,670,
8948,3620,235,232,467,
8949,4872,356,256,612,
8950,4994,381,279,660,
8951,1381,116,77,193,
8952,54,2,2,4,
8953,4209,320,246,566,
8954,4804,327,267,594,
8955,4795,346,252,598,
8956,4909,353,306,659,
8957,4832,371,239,610,
8958,4802,346,285,631,
8959,4814,395,264,659,
8961,4871,357,278,635,
8962,4904,353,298,651,
8963,4918,346,269,615,
8964,3988,289,215,504,
8965,720,49,50,99,
8966,4834,360,265,625,
8967,4947,384,286,670,
8968,4467,313,268,581,
8971,293,14,18,32,
8972,4923,358,270,628,
8973,832,59,63,122,
8974,626,46,36,82,
8975,3783,260,207,467,
8976,4869,351,274,625,
8977,677,53,39,92,
8978,4819,330,249,579,
8979,4962,363,265,628,
8980,4955,356,254,610,
8981,4812,389,264,653,
8982,4755,318,271,589,
8983,4744,326,272,598,
8984,4842,326,282,608,
8985,4849,332,257,589,
8986,1412,113,83,196,
8988,4861,295,282,577,
8990,1279,75,68,143,
8992,4806,360,282,642,
8993,4882,345,283,628,
8994,675,46,30,76,
8995,4984,372,278,650,
8997,229,17,21,38,
8998,4878,389,272,661,
8999,622,38,31,69,
9000,4715,374,245,619,
9001,4826,321,263,584,
9002,4897,353,267,620,
9003,4950,366,271,637,
9004,4901,401,299,700,
9005,1051,60,67,127,
9006,292,22,24,46,
9008,4765,328,276,604,
9009,377,31,26,57,
9010,153,16,8,24,
9011,4883,356,274,630,
9012,4853,358,284,642,
9014,3631,316,166,482,
9015,4760,382,272,654,
9016,4922,345,261,606,
9019,4870,322,299,621,
9021,4867,305,259,564,
9023,3802,211,227,438,
9024,1608,133,91,224,
9025,533,31,28,59,
9027,4791,365,273,638,
9030,4896,365,258,623,
9031,4751,328,286,614,
9032,57,9,1,10,
9034,444,49,24,73,
9035,4877,328,287,615,
9042,4748,350,271,621,
9043,386,32,13,45,
9044,4859,347,294,641,
9045,1041,72,52,124,
9046,4683,319,255,574,
9047,4797,331,290,621,
9048,120,9,6,15,
9050,4925,353,294,647,
9051,4779,366,255,621,
9053,661,41,49,90,
9055,4858,378,262,640,
9056,4743,334,269,603,
9058,4894,403,271,674,
9059,4850,357,270,627,
9060,4879,359,278,637,
9061,4833,372,259,631,
9062,159,10,8,18,
9063,592,22,34,56,
9065,5008,380,291,671,
9067,3446,251,212,463,
9071,967,55,54,109,
9072,4802,361,261,622,
9073,461,34,34,68,
9074,1044,80,68,148,
9075,4809,357,308,665,
9076,4852,355,277,632,
9077,4816,365,281,646,
9079,4852,350,261,611,
9082,4824,357,262,619,
9083,4706,323,270,593,
9085,4932,336,293,629,
9086,595,42,26,68,
9090,511,43,32,75,
9093,4698,347,273,620,
9094,502,36,31,67,
9095,179,16,9,25,
9098,4912,338,266,604,
9099,5009,349,262,611,
9100,942,56,61,117,
9103,4947,341,300,641,
9104,3272,278,171,449,
9105,4715,367,264,631,
9106,1243,94,65,159,
9107,4773,324,275,599,
9109,1163,71,60,131,
9110,4876,377,239,616,
9112,4944,368,272,640,
9114,754,56,47,103,
9115,4789,355,275,630,
9116,4902,363,268,631,
9117,4789,320,271,591,
9118,4950,346,302,648,
9119,4705,346,252,598,
9121,1005,67,54,121,
9122,4952,339,269,608,
9125,4791,350,295,645,
9126,4672,333,231,564,
9128,4870,353,275,628,
9129,3996,260,195,455,
9130,4872,334,266,600,
9132,4802,347,289,636,
9133,4857,354,257,611,
9136,4853,344,250,594,
9137,4825,356,267,623,
9138,4945,346,261,607,
9139,4772,337,259,596,
9141,4877,316,264,580,
9142,4811,345,275,620,
9145,1028,69,55,124,
9146,4878,354,279,633,
9147,55,4,1,5,
9148,41,5,2,7,
9149,4788,374,272,646,
9150,1042,86,61,147,
9153,4919,374,295,669,
9154,4892,351,272,623,
9158,1703,108,116,224,
9159,4887,322,264,586,
9160,4902,367,290,657,
9161,4785,359,258,617,
9162,1198,82,74,156,
9163,4888,328,294,622,
9165,4865,368,270,638,
9166,4887,332,247,579,
9169,1271,93,58,151,
9172,4938,360,280,640,
9176,4769,367,288,655,
9177,1596,119,77,196,
9178,505,44,29,73,
9180,4924,406,277,683,
9181,4851,387,298,685,
9182,4783,342,252,594,
9183,4835,362,285,647,
9185,5068,353,275,628,
9186,4716,332,244,576,
9189,220,15,12,27,
9191,4752,340,257,597,
9192,4804,323,271,594,
9193,4906,377,264,641,
9194,4642,361,247,608,
9195,4791,373,284,657,
9196,203,12,7,19,
9197,749,67,49,116,
9198,4920,326,292,618,
9199,4819,380,260,640,
9201,4804,387,268,655,
9202,4720,325,285,610,
9203,832,66,55,121,
9206,4897,391,222,613,
9207,4982,399,283,682,
9208,4930,387,268,655,
9210,4946,369,302,671,
9211,4880,343,274,617,
9212,4775,340,254,594,
9213,62,7,5,12,
9215,4906,396,273,669,
9217,4893,341,276,617,
9218,386,20,22,42,
9222,620,35,42,77,
9226,4935,320,225,545,
9227,4822,344,282,626,
9228,4845,337,277,614,
9229,4852,367,259,626,
9230,495,35,36,71,
9231,4816,346,283,629,
9233,4810,346,261,607,
9234,4794,356,271,627,
9235,371,32,22,54,
9237,4835,355,273,628,
9238,4701,363,262,625,
9241,4985,368,301,669,
9242,407,33,20,53,
9243,1171,82,82,164,
9244,4874,364,297,661,
9245,285,17,15,32,
9246,4802,364,275,639,
9247,353,26,22,48,
9248,3765,258,247,505,
9249,4782,339,241,580,
9251,4840,339,276,615,
9252,840,66,38,104,
9253,4854,375,255,630,
9254,1371,110,85,195,
9255,160,15,12,27,
9256,1279,80,70,150,
9257,1097,85,64,149,
9259,4867,374,246,620,
9262,4925,354,274,628,
9263,4807,360,283,643,
9264,4969,346,287,633,
9265,4666,343,243,586,
9266,4823,384,265,649,
9267,4749,354,314,668,
9269,904,61,50,111,
9270,4809,356,267,623,
9271,1052,74,58,132,
9272,773,62,38,100,
9273,1090,74,72,146,
9274,1596,107,88,195,
9277,4834,335,244,579,
9278,1046,76,64,140,
9280,4945,373,311,684,
9281,4867,328,290,618,
9283,727,47,45,92,
9284,4799,364,268,632,
9285,4782,366,235,601,
9286,4771,359,263,622,
9287,230,19,11,30,
9288,4868,333,289,622,
9290,4914,348,295,643,
9292,4780,356,260,616,
9293,4796,374,296,670,
9295,4713,365,276,641,
9296,4885,357,265,622,
9297,4839,361,266,627,
9298,4787,348,267,615,
9299,4795,340,279,619,
9300,4834,379,258,637,
9301,4942,365,307,672,
9302,694,51,45,96,
9304,4943,369,251,620,
9305,3545,255,191,446,
9307,2152,167,124,291,
9309,102,9,6,15,
9310,3598,276,191,467,
9311,4940,351,248,599,
9312,387,26,17,43,
9313,4911,367,263,630,
9314,4877,345,269,614,
9315,4925,362,265,627,
9316,868,70,52,122,
9317,4776,346,288,634,
9318,101,5,3,8,
9319,4877,413,262,675,
9321,4964,362,292,654,
9322,4820,374,262,636,
9323,4861,352,292,644,
9325,4865,387,277,664,
9326,4834,383,264,647,
9327,231,12,15,27,
9329,893,59,57,116,
9331,4749,370,252,622,
9332,4872,307,282,589,
9333,3433,255,200,455,
9334,4981,343,274,617,
9335,3552,269,217,486,
9336,4865,355,270,625,
9337,890,64,53,117,
9338,4886,374,287,661,
9339,4849,332,265,597,
9340,4829,359,269,628,
9341,4920,335,276,611,
9342,1167,67,65,132,
9343,4860,322,261,583,
9344,4991,347,307,654,
9345,580,49,30,79,
9346,4894,419,256,675,
9347,5011,349,294,643,
9348,834,58,47,105,
9349,4879,341,286,627,
9350,4693,329,272,601,
9352,3363,240,183,423,
9354,662,58,42,100,
9355,845,53,36,89,
9356,4757,362,250,612,
9357,4795,348,288,636,
9358,4933,343,293,636,
9360,4702,344,293,637,
9362,314,21,14,35,
9364,4740,343,264,607,
9365,4772,327,281,608,
9368,4820,347,286,633,
9369,4796,359,292,651,
9370,4909,336,312,648,
9371,4906,368,266,634,
9372,802,58,35,93,
9373,32,2,2,4,
9374,235,9,21,30,
9378,4779,341,286,627,
9380,4853,334,291,625,
9381,4760,321,317,638,
9383,4900,413,282,695,
9384,950,62,63,125,
9385,4721,393,260,653,
9387,275,25,9,34,
9388,217,18,15,33,
9389,3689,233,196,429,
9390,4701,309,262,571,
9392,83,5,4,9,
9393,4769,332,281,613,
9394,4845,375,247,622,
9395,53,6,1,7,
9396,4145,256,272,528,
9397,4775,353,263,616,
9398,4822,372,269,641,
9399,4685,296,273,569,
9400,4916,365,280,645,
9402,108,7,5,12,
9404,4724,324,247,571,
9406,280,24,16,40,
9408,4866,378,257,635,
9410,4713,366,244,610,
9411,2620,209,138,347,
9413,1108,72,56,128,
9414,1115,82,57,139,
9417,4875,397,239,636,
9418,3197,194,166,360,
9419,4919,357,274,631,
9421,4862,365,252,617,
9422,4758,329,254,583,
9423,4845,380,280,660,
9424,955,57,57,114,
9425,4725,331,282,613,
9426,4788,293,259,552,
9427,4797,384,268,652,
9428,423,39,17,56,
9429,4827,377,280,657,
9431,4872,333,305,638,
9434,4719,343,260,603,
9436,4916,392,278,670,
9437,1430,105,90,195,
9438,4811,352,293,645,
9439,4884,361,276,637,
9441,5021,365,282,647,
9442,774,58,45,103,
9443,299,20,15,35,
9444,4839,368,282,650,
9445,4906,353,265,618,
9446,4788,379,260,639,
9447,4843,380,290,670,
9448,4788,369,248,617,
9450,3711,280,215,495,
9451,1226,87,71,158,
9452,3976,283,220,503,
9453,756,61,45,106,
9454,3836,263,210,473,
9455,4784,339,261,600,
9456,1330,112,69,181,
9458,4722,382,252,634,
9459,4939,303,328,631,
9460,4879,341,288,629,
9461,4993,364,281,645,
9462,4871,351,271,622,
9463,4899,366,306,672,
9465,5004,378,299,677,
9466,2813,196,155,351,
9468,4916,342,286,628,
9469,370,23,18,41,
9470,4675,329,309,638,
9472,4855,342,272,614,
9473,4837,348,282,630,
9474,4803,352,282,634,
9475,4890,342,301,643,
9476,4875,355,294,649,
9478,4762,367,261,628,
9479,4793,371,267,638,
9480,4910,353,274,627,
9481,1087,75,60,135,
9482,4891,366,268,634,
9483,4720,322,243,565,
9484,4816,342,252,594,
9485,4953,357,276,633,
9487,841,64,39,103,
9489,29,5,2,7,
9490,387,28,18,46,
9491,4874,362,311,673,
9492,4771,340,270,610,
9493,4777,367,275,642,
9495,270,20,14,34,
9496,4901,363,309,672,
9497,35,3,2,5,
9498,1316,84,84,168,
9502,4791,302,278,580,
9503,472,27,32,59,
9504,1043,81,62,143,
9505,3876,277,197,474,
9506,4774,342,290,632,
9507,4948,354,295,649,
9508,1020,77,65,142,
9510,4775,334,254,588,
9512,4692,316,288,604,
9513,4845,353,281,634,
9514,4855,311,265,576,
9515,4941,381,285,666,
9517,4745,361,257,618,
9518,3668,258,213,471,
9519,4846,364,295,659,
9520,4827,374,292,666,
9521,4790,366,250,616,
9522,4912,348,289,637,
9523,3909,247,224,471,
9524,29,4,1,5,
9529,4828,363,269,632,
9530,4833,351,284,635,
9532,4804,352,255,607,
9533,833,63,48,111,
9534,313,18,16,34,
9535,4799,365,272,637,
9536,4918,362,268,630,
9537,4856,379,263,642,
9538,1472,122,84,206,
9539,4865,369,274,643,
9540,4777,326,287,613,
9542,287,15,10,25,
9543,4773,344,251,595,
9544,1058,71,62,133,
9545,4839,338,288,626,
9546,4819,382,254,636,
9548,98,8,6,14,
9549,468,35,26,61,
9550,4781,330,279,609,
9551,4797,341,277,618,
9553,4834,349,256,605,
9556,506,47,21,68,
9557,4922,349,284,633,
9558,5038,371,288,659,
9559,4835,338,281,619,
9560,712,58,37,95,
9561,4827,322,276,598,
9563,4910,396,280,676,
9564,4590,320,260,580,
9565,1151,85,79,164,
9566,4809,349,275,624,
9567,4785,311,311,622,
9569,4847,339,287,626,
9570,4796,355,276,631,
9572,4859,345,257,602,
9573,4775,369,251,620,
9574,4827,368,278,646,
9576,4765,330,292,622,
9577,4726,342,279,621,
9580,4955,381,260,641,
9581,569,36,34,70,
9582,957,74,61,135,
9583,4703,368,235,603,
9584,4869,350,302,652,
9585,4844,332,248,580,
9587,4804,353,241,594,
9589,665,46,35,81,
9593,4245,333,213,546,
9594,4899,374,313,687,
9595,1704,136,108,244,
9596,161,16,7,23,
9597,4881,362,281,643,
9598,4884,350,266,616,
9599,1296,94,83,177,
9600,4791,359,283,642,
9601,4706,344,251,595,
9602,4789,374,293,667,
9603,4896,328,308,636,
9604,4783,358,302,660,
9607,1427,114,83,197,
9610,459,31,22,53,
9611,839,51,40,91,
9612,469,35,30,65,
9614,1725,128,95,223,
9615,4890,371,283,654,
9617,4824,325,283,608,
9619,159,9,12,21,
9620,4822,366,265,631,
9621,4820,345,281,626,
9622,4667,329,251,580,
9624,66,4,4,8,
9625,593,44,47,91,
9627,973,93,57,150,
9628,4814,360,279,639,
9629,1646,117,95,212,
9630,2164,172,144,316,
9632,979,74,57,131,
9633,253,12,12,24,
9636,258,18,19,37,
9637,179,14,16,30,
9639,1428,95,89,184,
9640,403,34,21,55,
9641,4928,373,263,636,
9642,23,1,1,2,
9643,998,68,66,134,
9644,1464,115,79,194,
9645,4831,343,277,620,
9647,912,64,50,114,
9650,1154,82,63,145,
9651,4864,371,277,648,
9653,4906,344,252,596,
9654,4906,369,277,646,
9655,4776,364,266,630,
9657,4595,336,258,594,
9658,305,19,15,34,
9659,4932,345,268,613,
9660,4837,362,280,642,
9661,4871,382,289,671,
9662,290,16,21,37,
9664,50,5,1,6,
9668,4799,320,259,579,
9669,4884,358,280,638,
9670,4994,369,311,680,
9671,4848,370,282,652,
9672,553,42,27,69,
9674,760,59,41,100,
9675,131,10,5,15,
9679,4933,344,291,635,
9681,4754,349,262,611,
9682,4761,339,279,618,
9685,4803,368,261,629,
9686,4954,380,306,686,
9687,4944,391,258,649,
9688,4884,393,249,642,
9689,3572,236,214,450,
9690,4867,355,294,649,
9691,4806,381,277,658,
9692,4812,350,305,655,
9693,4706,335,283,618,
9696,3668,309,196,505,
9697,4925,332,276,608,
9698,5036,361,259,620,
9699,4922,412,289,701,
9701,622,45,39,84,
9702,4786,340,268,608,
9704,4956,349,298,647,
9705,4911,347,263,610,
9706,4727,297,265,562,
9707,65,2,3,5,
9708,189,12,9,21,
9709,3666,235,224,459,
9711,683,68,35,103,
9712,188,18,11,29,
9714,4853,348,265,613,
9715,4870,389,274,663,
9716,1210,71,70,141,
9717,2146,153,142,295,
9718,4720,381,260,641,
9719,4921,339,295,634,
9720,1251,88,66,154,
9721,873,60,47,107,
9722,4815,315,267,582,
9723,4799,372,259,631,
9727,4764,341,249,590,
9728,356,23,19,42,
9729,4745,364,279,643,
9730,4913,343,265,608,
9731,1810,121,139,260,
9733,4814,347,316,663,
9734,459,34,20,54,
9735,490,35,23,58,
9736,4855,345,276,621,
9737,4823,363,293,656,
9738,5004,349,280,629,
9739,1264,88,61,149,
9740,700,38,51,89,
9742,4929,375,283,658,
9745,675,59,40,99,
9746,4824,387,272,659,
9747,4801,325,268,593,
9748,2601,202,130,332,
9750,4924,347,267,614,
9752,4930,332,295,627,
9754,4891,350,284,634,
9755,1111,79,64,143,
9757,4943,352,255,607,
9758,329,18,18,36,
9759,4788,371,300,671,
9760,4729,344,269,613,
9761,4767,348,261,609,
9762,4969,362,275,637,
9764,4838,353,271,624,
9765,4928,348,271,619,
9767,4788,349,279,628,
9768,4816,377,287,664,
9769,1185,83,65,148,
9772,4834,370,288,658,
9773,4827,353,261,614,
9774,4964,364,284,648,
9775,777,57,39,96,
9776,4895,350,269,619,
9777,4838,349,301,650,
9778,3543,286,197,483,
9779,4753,339,274,613,
9780,4692,327,247,574,
9781,4869,364,272,636,
9782,679,56,47,103,
9783,4765,341,263,604,
9784,4917,355,269,624,
9785,1716,115,105,220,
9786,4825,360,276,636,
9787,4728,335,277,612,
9788,4910,332,303,635,
9790,4909,356,275,631,
9791,4753,328,289,617,
9792,4861,338,294,632,
9793,4783,351,267,618,
9794,4822,362,308,670,
9796,47,2,6,8,
9798,31,5,1,6,
9799,4883,317,263,580,
9800,4910,342,261,603,
9802,4765,293,260,553,
9806,923,80,51,131,
9807,1305,88,71,159,
9808,4894,372,287,659,
9809,432,26,27,53,
9813,1296,108,51,159,
9815,824,72,44,116,
9816,4823,384,268,652,
9817,1096,91,66,157,
9818,329,25,13,38,
9819,4920,352,291,643,
9820,1055,73,42,115,
9822,4933,359,263,622,
9823,4866,346,274,620,
9825,512,37,30,67,
9826,4712,365,248,613,
9827,577,42,32,74,
9828,4864,355,291,646,
9829,4760,337,329,666,
9830,964,72,51,123,
9831,1064,79,49,128,
9832,3759,282,199,481,
9833,322,29,14,43,
9835,4810,352,264,616,
9836,128,15,7,22,
9837,480,43,27,70,
9838,4843,339,278,617,
9840,4853,359,291,650,
9841,4801,348,275,623,
9842,801,67,61,128,
9843,4739,325,245,570,
9844,860,68,52,120,
9845,4608,338,255,593,
9846,787,66,45,111,
9847,4822,351,282,633,
9848,4768,347,289,636,
9849,5061,393,296,689,
9850,4870,342,286,628,
9851,4827,339,316,655,
9853,132,7,8,15,
9854,4768,361,254,615,
9855,4850,314,291,605,
9856,4825,356,279,635,
9857,4944,355,270,625,
9859,3503,248,193,441,
9860,4862,335,248,583,
9861,526,45,31,76,
9862,4774,328,285,613,
9863,4911,349,272,621,
9864,4816,364,280,644,
9865,4905,353,284,637,
9866,195,7,10,17,
9868,86,7,2,9,
9869,665,59,33,92,
9870,4767,338,282,620,
9873,4878,342,292,634,
9874,55,3,3,6,
9875,1954,137,122,259,
9876,163,10,12,22,
9877,4934,335,249,584,
9878,4885,376,279,655,
9879,4777,344,282,626,
9880,4934,361,289,650,
9881,4887,392,270,662,
9882,1083,75,54,129,
9884,91,12,3,15,
9885,3621,283,189,472,
9887,1379,102,68,170,
9888,4807,320,255,575,
9889,4785,335,258,593,
9891,4710,372,253,625,
9892,4810,354,256,610,
9895,4900,385,265,650,
9898,4904,347,284,631,
9900,3100,185,190,375,
9902,4836,382,252,634,
9903,1029,82,69,151,
9904,4847,363,284,647,
9905,3636,216,206,422,
9906,480,45,18,63,
9907,4908,360,281,641,
9908,345,23,22,45,
9910,4024,311,222,533,
9911,4838,401,297,698,
9916,4952,353,279,632,
9917,4905,331,320,651,
9918,1583,104,94,198,
9919,298,19,18,37,
9920,1241,95,58,153,
9921,4647,348,283,631,
9922,96,6,3,9,
9923,4782,386,249,635,
9924,3228,244,177,421,
9925,793,67,56,123,
9926,4921,352,270,622,
9927,4928,360,284,644,
9929,239,16,13,29,
9930,4860,363,278,641,
9931,4717,374,240,614,
9932,641,54,27,81,
9934,4830,384,258,642,
9935,228,22,10,32,
9936,4756,352,267,619,
9937,4927,338,279,617,
9938,4757,357,294,651,
9939,4887,362,272,634,
9940,735,65,46,111,
9943,3243,235,150,385,
9945,4729,347,249,596,
9948,4755,329,266,595,
9949,4883,317,327,644,
9950,4841,364,275,639,
9952,4728,357,297,654,
9953,3660,243,222,465,
9954,712,53,38,91,
9955,3739,262,222,484,
9957,1230,88,84,172,
9958,4997,387,276,663,
9960,1242,75,62,137,
9961,4781,342,304,646,
9962,970,53,62,115,
9963,4734,327,254,581,
9965,2356,158,132,290,
9966,4891,382,275,657,
9967,4846,355,259,614,
9968,4808,351,249,600,
9970,955,76,56,132,
9971,547,37,25,62,
9973,4902,355,286,641,
9975,574,40,28,68,
9976,4990,337,307,644,
9977,4875,373,276,649,
9978,163,10,12,22,
9979,4943,376,273,649,
9980,4820,330,285,615,
9982,4753,329,281,610,
9983,4766,359,271,630,
9985,942,59,54,113,
9987,4889,349,299,648,
9988,4793,347,277,624,
9989,29,5,1,6,
9990,4766,307,263,570,
9991,1453,95,92,187,
9992,2565,201,139,340,
9993,4904,321,278,599,
9996,3603,291,202,493,
9997,737,48,37,85,
9998,4842,352,246,598,
