eventID,numPhotons,numReachedDown,numReachedUp,numPE,
0,3138,214,200,414,
1,3275,262,192,454,
2,3187,209,187,396,
3,3278,236,193,429,
4,3180,228,178,406,
5,39,2,3,5,
6,3287,230,197,427,
7,3221,219,186,405,
9,3247,228,181,409,
10,3205,246,184,430,
11,789,49,54,103,
12,3104,215,195,410,
13,3369,239,210,449,
14,3188,242,182,424,
15,3203,237,160,397,
16,3289,257,204,461,
17,3197,258,189,447,
18,3260,231,170,401,
19,3229,235,171,406,
20,3064,204,127,331,
21,3204,240,201,441,
22,3246,279,172,451,
23,3325,262,187,449,
24,3207,229,198,427,
25,3262,233,206,439,
26,3233,227,179,406,
27,3237,221,175,396,
28,3137,212,189,401,
29,3270,238,199,437,
31,3271,244,189,433,
32,3245,234,180,414,
33,3141,221,177,398,
34,3269,211,184,395,
35,3264,237,181,418,
36,3219,203,201,404,
37,3206,198,177,375,
38,3210,231,176,407,
39,3300,239,180,419,
40,3345,260,168,428,
41,3356,242,198,440,
42,3190,216,162,378,
43,3236,221,195,416,
44,3254,261,170,431,
45,3173,228,188,416,
46,3347,256,222,478,
48,3192,253,176,429,
49,3311,239,207,446,
50,3091,225,190,415,
51,3245,252,182,434,
52,3277,242,189,431,
53,3252,240,183,423,
54,3211,215,194,409,
55,3134,243,159,402,
56,3236,234,186,420,
57,3063,222,163,385,
58,3292,271,173,444,
59,3165,213,187,400,
60,3256,263,180,443,
61,3243,227,167,394,
62,3154,223,183,406,
63,3178,229,169,398,
64,3210,229,191,420,
65,3143,254,157,411,
66,3285,220,188,408,
67,3263,238,184,422,
68,3178,257,197,454,
69,3189,232,184,416,
70,3220,242,167,409,
71,3146,232,163,395,
72,3243,223,176,399,
73,3184,219,175,394,
75,3232,223,182,405,
76,3262,216,193,409,
77,3134,213,185,398,
78,3244,263,181,444,
79,3314,216,194,410,
80,3221,228,203,431,
81,3279,220,165,385,
82,3149,223,192,415,
83,3221,238,182,420,
84,3219,238,191,429,
85,3118,212,162,374,
86,3279,228,201,429,
87,3134,237,192,429,
88,3188,266,165,431,
89,3229,262,173,435,
90,3196,249,154,403,
91,3220,241,187,428,
92,3158,199,166,365,
94,3205,219,167,386,
95,3188,226,199,425,
96,3220,235,172,407,
97,3264,238,184,422,
98,3018,228,178,406,
99,3180,251,185,436,
100,3288,254,190,444,
101,157,10,7,17,
102,3144,280,182,462,
103,3282,228,178,406,
104,3141,217,194,411,
105,3176,232,169,401,
107,3272,223,189,412,
108,3121,230,181,411,
110,3221,240,195,435,
111,3126,229,185,414,
112,3219,229,202,431,
113,3108,237,166,403,
114,3224,246,169,415,
117,276,24,19,43,
118,3043,211,154,365,
119,3205,219,194,413,
120,3278,242,194,436,
121,3103,240,141,381,
122,3200,218,184,402,
123,3252,226,205,431,
125,3174,220,189,409,
126,3211,225,196,421,
127,3189,214,193,407,
128,3242,282,186,468,
129,3158,228,175,403,
130,3101,244,181,425,
131,3287,243,189,432,
132,3256,245,171,416,
133,3222,228,162,390,
134,3231,254,186,440,
135,3255,230,167,397,
136,2531,188,129,317,
137,3138,205,196,401,
138,3254,210,196,406,
139,3318,273,183,456,
140,3111,184,162,346,
141,3152,227,199,426,
142,3197,206,170,376,
143,3258,231,173,404,
144,3261,253,170,423,
145,3231,237,198,435,
147,3219,251,174,425,
148,3167,231,178,409,
149,3295,239,182,421,
150,3196,229,183,412,
151,3225,212,185,397,
152,3203,234,193,427,
153,3178,225,192,417,
154,3182,231,179,410,
155,3106,198,167,365,
156,3289,248,194,442,
157,3164,195,178,373,
158,3235,240,169,409,
159,3196,224,179,403,
160,3241,227,172,399,
161,334,24,28,52,
162,3219,244,199,443,
163,3267,236,181,417,
165,3233,222,211,433,
166,3222,236,180,416,
167,3240,224,202,426,
168,3099,241,195,436,
169,3195,256,165,421,
170,3136,190,197,387,
171,3338,223,186,409,
172,3206,224,172,396,
174,3179,246,165,411,
175,176,12,13,25,
176,3220,219,197,416,
177,3238,240,202,442,
178,3143,236,168,404,
179,3284,234,172,406,
180,3267,256,169,425,
182,3273,249,191,440,
183,3226,215,188,403,
184,3280,218,207,425,
185,3229,215,193,408,
186,3237,220,165,385,
187,3253,222,196,418,
188,3219,235,191,426,
189,3200,233,180,413,
190,3127,224,171,395,
193,3184,222,142,364,
194,3171,240,199,439,
195,3268,257,161,418,
196,3198,247,173,420,
197,2478,181,134,315,
198,3277,235,187,422,
199,3080,255,169,424,
200,503,35,43,78,
201,3226,218,182,400,
202,3229,238,187,425,
203,3124,196,179,375,
204,3247,214,217,431,
205,3213,227,176,403,
206,3178,254,145,399,
208,166,9,6,15,
209,3226,234,193,427,
210,3314,224,172,396,
211,3263,256,177,433,
213,567,45,45,90,
214,3203,229,177,406,
215,3295,233,175,408,
216,3200,251,203,454,
217,3250,241,196,437,
218,3197,240,191,431,
219,3185,251,176,427,
220,3233,239,174,413,
221,3244,246,176,422,
222,3288,231,175,406,
223,3246,224,200,424,
224,3338,228,185,413,
225,2689,171,140,311,
226,3085,218,156,374,
227,3220,273,150,423,
228,3307,254,176,430,
229,3146,236,167,403,
230,3302,261,184,445,
231,3318,240,209,449,
232,3238,252,188,440,
233,3246,235,196,431,
234,78,4,11,15,
235,3201,234,167,401,
236,3208,232,189,421,
237,3193,224,181,405,
238,3207,246,179,425,
239,3292,259,173,432,
240,3232,212,177,389,
241,3271,233,156,389,
242,3180,235,191,426,
243,3082,234,160,394,
244,3205,265,181,446,
245,3229,230,188,418,
246,3230,205,180,385,
247,3283,240,222,462,
248,3215,229,196,425,
249,3239,226,187,413,
250,3183,263,192,455,
251,3304,255,213,468,
252,3219,229,205,434,
253,3111,239,199,438,
254,3312,248,205,453,
255,3245,219,207,426,
256,3155,242,144,386,
257,3150,239,178,417,
258,3135,242,153,395,
259,3244,220,180,400,
261,3258,212,200,412,
262,3197,235,179,414,
264,233,20,14,34,
265,3217,225,179,404,
266,3259,237,183,420,
267,3239,242,189,431,
268,3310,248,210,458,
269,3242,257,182,439,
270,3293,212,198,410,
271,3182,230,187,417,
272,3209,218,192,410,
273,3325,264,192,456,
274,3181,244,178,422,
275,3346,263,188,451,
276,2611,190,142,332,
277,3291,246,194,440,
278,3360,242,176,418,
279,3241,235,208,443,
280,3219,226,180,406,
281,3237,270,180,450,
282,3201,218,171,389,
284,3175,227,186,413,
285,3243,239,181,420,
286,3203,204,180,384,
287,3332,245,197,442,
289,3279,268,179,447,
291,3301,249,175,424,
292,3240,244,197,441,
293,314,18,16,34,
294,3273,233,169,402,
295,3242,241,195,436,
296,3246,206,173,379,
297,3214,238,168,406,
298,3113,243,168,411,
299,3275,252,168,420,
300,3218,221,190,411,
301,3249,227,193,420,
302,3276,224,198,422,
303,3296,260,205,465,
305,3178,235,185,420,
306,3137,231,178,409,
307,3228,208,191,399,
308,3194,256,168,424,
309,3097,214,194,408,
310,3205,289,189,478,
311,3245,255,177,432,
313,3190,225,193,418,
314,3218,237,209,446,
315,107,6,5,11,
316,3197,251,178,429,
317,3198,243,184,427,
318,3370,245,189,434,
319,3247,230,191,421,
320,3237,239,203,442,
321,3215,233,179,412,
322,3289,248,179,427,
323,3207,254,173,427,
324,3249,218,152,370,
325,3182,233,182,415,
326,3258,243,183,426,
327,3137,210,171,381,
328,3223,228,195,423,
329,3249,239,175,414,
330,3213,218,165,383,
331,3215,197,166,363,
333,3147,252,170,422,
334,3116,222,202,424,
335,3234,243,178,421,
336,3237,238,178,416,
337,3154,226,189,415,
338,3165,233,180,413,
339,2484,181,143,324,
340,3202,226,175,401,
341,3149,218,193,411,
342,3224,210,196,406,
343,3107,220,200,420,
344,3233,252,196,448,
345,3177,213,188,401,
346,3237,217,198,415,
347,3283,239,176,415,
348,3154,226,181,407,
349,3065,212,178,390,
350,3126,246,191,437,
351,3177,239,196,435,
352,3217,228,173,401,
353,3140,242,158,400,
354,3196,248,198,446,
355,3192,228,174,402,
356,3336,239,192,431,
358,3123,214,169,383,
359,3150,217,174,391,
360,3306,232,200,432,
361,3293,264,178,442,
362,3124,216,171,387,
363,3202,233,190,423,
364,3070,224,176,400,
366,3226,252,175,427,
367,3192,249,179,428,
368,3241,241,176,417,
369,3336,220,216,436,
370,3226,206,193,399,
371,3194,218,186,404,
372,3170,258,164,422,
373,362,31,19,50,
374,23,1,1,2,
375,3239,236,193,429,
376,3211,247,200,447,
377,3111,206,180,386,
378,3285,238,177,415,
380,3299,260,181,441,
381,3196,245,167,412,
382,3177,226,211,437,
383,3215,237,193,430,
384,3249,261,172,433,
385,3236,250,174,424,
386,3121,243,158,401,
387,3266,226,216,442,
388,3239,256,196,452,
389,3319,217,187,404,
391,3269,228,189,417,
392,3278,259,200,459,
393,3213,228,196,424,
394,3298,260,198,458,
395,3223,264,179,443,
396,3237,220,196,416,
397,3268,238,171,409,
398,3231,213,179,392,
399,3183,232,174,406,
401,2865,209,160,369,
402,3170,226,192,418,
403,3130,231,181,412,
404,3275,221,194,415,
405,182,10,13,23,
406,3180,244,183,427,
407,3259,250,194,444,
408,3338,237,203,440,
409,3156,218,187,405,
410,3222,223,210,433,
411,3179,237,159,396,
412,3137,248,175,423,
413,311,15,22,37,
414,3313,226,223,449,
415,3179,201,179,380,
416,3211,216,194,410,
417,3188,228,192,420,
418,3254,226,182,408,
419,3131,231,157,388,
420,3245,227,187,414,
421,3120,238,172,410,
422,3144,231,192,423,
423,3185,235,176,411,
424,3217,259,181,440,
426,3203,215,172,387,
427,3301,214,171,385,
428,3299,223,182,405,
429,3235,236,194,430,
430,3186,238,159,397,
431,3259,248,207,455,
433,3171,218,193,411,
434,3079,209,175,384,
435,3242,221,191,412,
436,3251,244,168,412,
437,3272,228,206,434,
438,3227,255,191,446,
439,3217,221,190,411,
440,3199,250,193,443,
441,3234,250,180,430,
442,3208,252,191,443,
443,3125,231,177,408,
444,3216,222,201,423,
446,3270,237,223,460,
447,3191,221,170,391,
448,3148,241,196,437,
449,3039,236,159,395,
451,3069,243,170,413,
452,3287,247,169,416,
453,3307,248,159,407,
454,3264,229,195,424,
455,3274,266,176,442,
456,3144,213,175,388,
457,3247,249,196,445,
459,3246,231,147,378,
460,3093,211,197,408,
461,3099,233,177,410,
462,3224,257,193,450,
463,3220,215,163,378,
464,3279,236,178,414,
465,3121,223,162,385,
466,3186,209,187,396,
467,3230,239,191,430,
468,3201,228,188,416,
469,3235,235,171,406,
470,3196,236,172,408,
472,3149,242,177,419,
473,3284,228,211,439,
474,3229,231,181,412,
475,3206,261,182,443,
476,3146,198,180,378,
477,3218,212,212,424,
479,3309,234,191,425,
480,3195,242,162,404,
481,3181,211,191,402,
482,3284,258,175,433,
483,3324,268,173,441,
484,3214,224,192,416,
485,3294,233,176,409,
486,3330,234,203,437,
487,3098,220,187,407,
488,3182,241,177,418,
489,3226,214,189,403,
490,3356,248,175,423,
493,3254,239,172,411,
494,3289,255,169,424,
495,3294,235,210,445,
496,3165,226,161,387,
497,3196,244,183,427,
499,3349,249,189,438,
500,3250,251,203,454,
501,3231,223,188,411,
502,3272,246,199,445,
503,3189,247,181,428,
504,3203,234,188,422,
505,3302,220,190,410,
506,3315,240,197,437,
507,3253,229,179,408,
508,3226,232,173,405,
509,3132,243,190,433,
510,3172,233,166,399,
511,3286,229,184,413,
512,3224,240,167,407,
513,213,15,18,33,
514,3228,217,196,413,
515,3255,248,182,430,
516,3278,244,203,447,
517,3351,247,190,437,
518,3223,248,186,434,
519,3122,230,218,448,
520,3279,211,149,360,
521,3290,254,168,422,
523,3278,239,207,446,
524,3113,217,164,381,
525,3192,211,189,400,
526,3126,234,177,411,
527,3243,253,170,423,
528,3307,233,203,436,
529,3220,260,203,463,
530,3221,226,200,426,
531,3121,213,188,401,
532,3156,230,171,401,
533,3238,236,186,422,
534,3327,247,189,436,
535,3199,262,175,437,
536,3267,222,192,414,
537,3270,258,207,465,
538,3238,254,190,444,
539,3100,209,194,403,
540,3225,222,197,419,
541,3140,232,216,448,
542,3209,241,177,418,
543,3222,236,166,402,
544,3264,242,192,434,
545,3207,242,176,418,
546,3146,225,200,425,
547,3282,238,182,420,
548,3232,229,186,415,
549,3287,238,201,439,
550,3200,239,161,400,
551,3194,221,158,379,
552,129,8,10,18,
553,3223,226,191,417,
554,3234,218,177,395,
555,3378,248,212,460,
556,3071,243,185,428,
557,3213,223,242,465,
558,3201,243,163,406,
559,3194,229,166,395,
560,3242,251,189,440,
562,3115,217,185,402,
563,3099,219,161,380,
564,3101,248,169,417,
565,3135,214,173,387,
567,3284,245,184,429,
570,3182,234,185,419,
571,3202,248,177,425,
572,3067,251,167,418,
573,3156,221,195,416,
574,3265,235,204,439,
575,3265,252,198,450,
576,3198,208,172,380,
577,3268,231,167,398,
578,3173,238,193,431,
579,3164,222,202,424,
580,3240,280,174,454,
581,3293,255,152,407,
582,3201,239,173,412,
583,3257,253,180,433,
584,3181,237,177,414,
585,3116,250,193,443,
586,3193,205,203,408,
587,3223,230,180,410,
588,3243,255,184,439,
589,3129,224,176,400,
590,3121,235,181,416,
591,3164,219,181,400,
592,3078,253,159,412,
593,3109,230,151,381,
594,3109,240,190,430,
595,3286,246,196,442,
596,3256,233,172,405,
597,3191,215,162,377,
598,3082,229,153,382,
599,3209,241,163,404,
600,3181,223,190,413,
601,3278,213,198,411,
602,3206,216,180,396,
603,3215,231,172,403,
604,3308,250,197,447,
605,3221,227,188,415,
606,3269,254,169,423,
607,3194,234,162,396,
608,3129,241,189,430,
609,3253,254,190,444,
610,3149,222,180,402,
611,3198,218,189,407,
612,3154,237,180,417,
613,3196,237,200,437,
614,138,12,10,22,
615,3214,275,193,468,
616,3225,244,186,430,
617,3324,252,169,421,
618,3274,234,187,421,
619,3033,204,166,370,
620,3003,212,179,391,
621,3300,236,178,414,
622,3279,201,183,384,
623,3088,216,151,367,
624,3246,240,176,416,
625,3189,226,196,422,
626,3152,205,188,393,
627,3220,248,189,437,
628,3326,254,206,460,
629,3161,240,171,411,
630,3224,220,208,428,
631,3265,250,206,456,
632,3104,239,163,402,
633,3276,245,168,413,
634,329,32,19,51,
636,292,23,22,45,
637,224,9,12,21,
638,3177,241,176,417,
639,30,1,1,2,
640,3127,213,176,389,
641,3314,232,189,421,
642,3259,237,184,421,
644,3175,203,162,365,
645,3297,285,186,471,
646,3257,218,217,435,
647,3178,220,187,407,
648,3141,229,182,411,
650,86,8,3,11,
651,3131,238,160,398,
652,3209,235,181,416,
653,3296,254,168,422,
654,3024,242,164,406,
655,3170,204,172,376,
657,3175,226,176,402,
658,3142,237,171,408,
659,3191,205,171,376,
660,3208,233,162,395,
661,3316,232,192,424,
662,3329,257,198,455,
663,3331,245,172,417,
664,3266,249,186,435,
665,3070,220,185,405,
666,3176,219,183,402,
667,3212,234,177,411,
668,3192,229,200,429,
669,3227,255,146,401,
670,3181,239,204,443,
671,3342,238,173,411,
673,3138,215,178,393,
675,3068,201,196,397,
676,3240,233,172,405,
677,3242,253,169,422,
679,3248,231,174,405,
680,3193,218,213,431,
681,3268,236,191,427,
682,3244,237,171,408,
683,3255,225,184,409,
684,3235,244,182,426,
685,2548,187,135,322,
686,3198,236,184,420,
688,3242,242,199,441,
689,3264,237,179,416,
690,3293,253,199,452,
691,3241,253,184,437,
692,3245,218,184,402,
693,3174,226,177,403,
694,3306,260,211,471,
695,3280,242,176,418,
696,3283,215,172,387,
697,3263,220,188,408,
698,3190,259,181,440,
699,3345,236,193,429,
700,3172,217,206,423,
701,3247,255,171,426,
702,3306,247,190,437,
703,3177,258,187,445,
704,3210,221,174,395,
705,3232,227,163,390,
706,3177,239,173,412,
707,3229,225,181,406,
708,2394,181,113,294,
709,3204,231,192,423,
711,3226,222,194,416,
712,3243,227,188,415,
713,3251,261,187,448,
715,3207,220,194,414,
716,3162,230,171,401,
717,3213,248,197,445,
718,3211,223,202,425,
719,3241,265,148,413,
720,3157,210,197,407,
721,3304,229,182,411,
722,3197,248,186,434,
723,3243,217,166,383,
724,3317,230,202,432,
725,3164,188,188,376,
726,3197,237,177,414,
727,3225,238,183,421,
728,3250,230,165,395,
729,3191,228,191,419,
730,3270,242,186,428,
731,3133,222,177,399,
733,191,15,7,22,
734,3280,229,170,399,
735,3172,210,158,368,
736,3294,257,191,448,
737,3261,226,190,416,
738,466,28,26,54,
739,3123,237,200,437,
740,3263,246,179,425,
741,3273,233,194,427,
742,3283,255,174,429,
743,166,17,9,26,
744,3128,233,185,418,
745,3131,210,184,394,
746,3193,244,158,402,
747,3280,251,178,429,
748,3223,220,151,371,
749,3203,233,184,417,
750,3308,232,183,415,
751,3156,235,200,435,
752,3149,223,180,403,
753,3218,252,175,427,
755,3259,252,180,432,
756,3223,229,160,389,
757,3134,222,200,422,
758,3285,251,179,430,
759,3353,232,184,416,
760,3200,238,165,403,
761,3158,173,212,385,
762,3123,213,190,403,
763,3027,226,170,396,
764,3212,247,161,408,
765,73,9,5,14,
766,211,13,14,27,
767,3200,233,177,410,
768,3338,208,202,410,
770,3273,273,179,452,
771,3246,213,191,404,
772,3331,226,218,444,
773,3145,211,195,406,
774,3164,237,178,415,
775,35,2,2,4,
777,3266,231,198,429,
778,3250,223,205,428,
779,3243,240,176,416,
780,3229,209,200,409,
781,3209,230,162,392,
782,3164,218,181,399,
783,3152,232,183,415,
784,3296,258,188,446,
785,3247,234,167,401,
786,3273,256,168,424,
787,3214,228,182,410,
788,3278,240,166,406,
789,3119,216,167,383,
790,3205,218,183,401,
791,3262,243,198,441,
792,3243,221,197,418,
794,3169,204,174,378,
795,3299,226,189,415,
796,3264,219,196,415,
797,3122,266,182,448,
798,3187,230,181,411,
799,3123,233,179,412,
800,3208,234,162,396,
801,3244,233,173,406,
802,3198,239,184,423,
803,3081,234,168,402,
804,3191,220,195,415,
805,3187,216,196,412,
806,2483,172,147,319,
807,3253,241,203,444,
808,3134,219,192,411,
809,3382,224,175,399,
810,3170,226,191,417,
811,3115,205,158,363,
812,3266,216,183,399,
813,2644,184,139,323,
814,3238,192,176,368,
815,3176,215,188,403,
817,3229,265,192,457,
818,3196,237,202,439,
820,3072,221,163,384,
822,3205,231,206,437,
823,3263,223,206,429,
824,3185,238,164,402,
825,3208,222,204,426,
826,3090,217,164,381,
828,3250,256,200,456,
830,3163,217,177,394,
831,3196,240,172,412,
832,3315,261,179,440,
833,3157,232,166,398,
834,3238,249,211,460,
836,3320,256,182,438,
837,3254,241,184,425,
838,3264,234,176,410,
839,3146,211,191,402,
840,3204,242,221,463,
841,3180,266,174,440,
842,3147,196,183,379,
843,3097,231,187,418,
844,3222,241,163,404,
845,3162,260,138,398,
846,3199,219,191,410,
847,3217,213,174,387,
848,3122,197,208,405,
849,3166,217,179,396,
851,3160,225,196,421,
852,3200,233,194,427,
853,3233,221,184,405,
854,3172,228,184,412,
855,58,4,4,8,
856,3252,213,183,396,
857,3195,246,200,446,
858,3245,257,176,433,
859,3327,250,200,450,
860,3178,246,172,418,
861,3148,226,192,418,
862,3315,245,181,426,
863,3219,238,212,450,
864,3172,228,191,419,
865,3346,249,195,444,
866,3320,260,203,463,
867,3223,248,219,467,
868,3185,229,193,422,
869,3185,225,173,398,
870,3204,244,185,429,
871,3291,242,199,441,
872,3313,242,229,471,
873,3151,198,181,379,
875,3210,240,181,421,
876,3267,241,185,426,
877,3219,249,175,424,
878,3344,237,193,430,
879,3255,229,186,415,
881,3272,221,218,439,
882,3348,252,193,445,
883,3258,242,162,404,
884,3167,218,167,385,
886,3185,214,217,431,
887,3061,226,176,402,
888,3184,242,206,448,
889,3182,228,188,416,
890,3259,228,208,436,
891,3097,219,162,381,
892,3123,258,173,431,
893,3206,249,176,425,
894,3191,219,186,405,
895,3273,214,202,416,
896,3172,246,185,431,
897,3186,252,185,437,
898,3273,238,170,408,
899,3334,253,198,451,
900,3260,207,203,410,
901,3245,266,219,485,
902,3173,230,189,419,
903,3226,229,159,388,
904,3146,233,192,425,
905,390,36,26,62,
906,3253,243,196,439,
907,3339,241,180,421,
908,3224,209,194,403,
909,3245,228,179,407,
911,146,9,7,16,
913,3176,211,161,372,
914,3175,208,191,399,
915,3195,227,186,413,
916,3208,224,180,404,
917,3179,232,176,408,
918,3350,223,191,414,
919,3250,217,189,406,
920,3306,266,178,444,
921,3180,231,181,412,
922,3236,260,194,454,
923,3199,231,195,426,
924,3174,240,201,441,
925,253,18,13,31,
926,3180,247,166,413,
927,174,11,9,20,
928,3205,226,173,399,
929,3247,226,186,412,
930,3286,248,196,444,
932,3232,224,198,422,
933,3256,233,171,404,
934,3202,223,188,411,
935,3292,238,188,426,
936,3174,215,195,410,
937,3206,218,188,406,
938,3362,240,210,450,
940,2425,152,130,282,
941,3187,241,172,413,
942,3042,233,166,399,
943,3344,251,191,442,
944,3200,214,171,385,
945,3195,225,175,400,
946,3161,215,201,416,
948,3126,228,174,402,
949,3247,244,180,424,
950,3246,228,187,415,
951,3210,240,204,444,
952,3205,229,167,396,
953,3194,249,157,406,
954,3160,245,186,431,
955,3104,211,185,396,
956,3323,230,186,416,
957,3153,234,182,416,
958,3279,231,188,419,
959,3335,250,192,442,
960,3078,214,182,396,
961,3337,268,179,447,
962,3289,215,192,407,
963,3350,227,189,416,
964,3163,260,169,429,
965,3132,220,157,377,
966,3281,240,190,430,
967,3272,265,186,451,
968,3210,273,165,438,
969,3258,230,190,420,
970,2750,192,161,353,
971,3078,213,185,398,
972,90,6,6,12,
973,3095,214,169,383,
974,3286,252,195,447,
975,3127,226,175,401,
976,3210,229,181,410,
977,3242,210,202,412,
978,3212,224,183,407,
979,3174,225,193,418,
980,3242,245,201,446,
981,3220,210,208,418,
982,3214,228,179,407,
983,3226,228,202,430,
985,3184,249,158,407,
986,3279,245,166,411,
987,3273,213,210,423,
988,3165,257,153,410,
989,425,28,31,59,
991,3197,230,197,427,
992,3140,240,196,436,
993,3207,233,192,425,
994,3305,233,195,428,
995,3154,197,198,395,
996,3271,230,189,419,
997,3150,249,165,414,
998,3262,228,211,439,
1000,3209,208,188,396,
1001,3282,200,191,391,
1002,3282,240,212,452,
1003,2870,197,152,349,
1004,3322,241,184,425,
1005,3147,213,150,363,
1006,3251,220,173,393,
1007,3334,245,184,429,
1008,3217,233,176,409,
1010,3139,224,176,400,
1012,3141,263,158,421,
1013,3190,226,185,411,
1014,3260,266,196,462,
1015,3182,222,172,394,
1016,3154,222,175,397,
1017,3211,237,171,408,
1018,3226,222,185,407,
1020,3186,215,177,392,
1021,3199,242,183,425,
1022,3214,261,197,458,
1023,3225,207,186,393,
1024,3142,232,185,417,
1025,3263,252,206,458,
1026,3264,227,176,403,
1027,3240,219,195,414,
1028,3197,237,180,417,
1029,3175,239,181,420,
1030,3172,238,183,421,
1031,3286,244,176,420,
1032,3233,209,178,387,
1033,3145,220,191,411,
1034,3189,216,190,406,
1035,3231,237,176,413,
1036,279,18,25,43,
1037,3136,230,171,401,
1038,3178,198,199,397,
1039,3155,254,166,420,
1040,3193,238,184,422,
1044,3154,216,182,398,
1045,3204,223,167,390,
1046,3239,236,177,413,
1047,3257,226,188,414,
1048,3240,243,167,410,
1049,3271,211,203,414,
1050,3130,218,190,408,
1051,3263,235,180,415,
1052,2612,179,125,304,
1054,3236,259,182,441,
1055,3236,224,189,413,
1056,3127,206,207,413,
1058,3197,219,162,381,
1059,3271,246,171,417,
1060,3187,226,204,430,
1061,3156,211,163,374,
1062,3214,250,202,452,
1063,3219,220,196,416,
1064,3110,250,164,414,
1065,3289,265,169,434,
1066,3258,216,175,391,
1067,199,17,14,31,
1068,3146,229,175,404,
1069,3220,220,188,408,
1070,3217,235,155,390,
1071,3175,227,179,406,
1072,3267,232,201,433,
1073,3200,245,183,428,
1074,3231,249,195,444,
1075,3119,189,199,388,
1076,3226,260,188,448,
1077,3208,236,172,408,
1078,3138,221,168,389,
1079,3239,262,190,452,
1080,3200,244,191,435,
1081,3095,247,152,399,
1082,3225,213,180,393,
1083,3247,220,193,413,
1084,3254,208,191,399,
1085,3257,207,195,402,
1086,3336,224,205,429,
1088,3234,245,173,418,
1089,3189,241,169,410,
1090,3287,233,183,416,
1091,3209,215,208,423,
1092,3221,231,197,428,
1094,3142,257,155,412,
1095,3147,214,162,376,
1096,3089,224,184,408,
1097,3346,225,205,430,
1098,3205,290,172,462,
1099,3244,208,204,412,
1100,3215,239,180,419,
1101,3203,238,186,424,
1103,3267,242,215,457,
1105,3290,250,195,445,
1106,3246,233,184,417,
1107,3064,199,198,397,
1108,3259,229,194,423,
1109,3176,263,167,430,
1110,3280,231,194,425,
1111,3269,248,202,450,
1112,3181,208,190,398,
1113,3219,242,180,422,
1114,3185,221,201,422,
1115,3266,239,188,427,
1116,3224,232,169,401,
1117,3257,253,177,430,
1118,3226,251,200,451,
1120,3326,222,198,420,
1121,3310,248,193,441,
1122,3272,260,203,463,
1123,3327,246,207,453,
1124,3209,218,164,382,
1125,3216,234,192,426,
1126,3256,229,202,431,
1127,3156,232,191,423,
1128,3183,249,188,437,
1129,3313,253,202,455,
1130,3241,219,184,403,
1131,3194,204,188,392,
1132,3080,206,175,381,
1133,3365,264,192,456,
1134,3322,230,203,433,
1135,3259,238,175,413,
1136,3289,230,183,413,
1138,3258,243,179,422,
1139,3072,230,185,415,
1140,3210,234,168,402,
1141,3099,225,173,398,
1142,3087,205,156,361,
1143,3224,230,178,408,
1144,2663,194,152,346,
1145,3259,249,179,428,
1146,3250,222,192,414,
1147,3228,241,185,426,
1148,3186,204,195,399,
1149,3140,227,180,407,
1150,3188,212,171,383,
1151,3172,225,203,428,
1152,3231,230,194,424,
1153,3087,226,179,405,
1154,3379,259,193,452,
1155,526,34,30,64,
1156,3428,270,184,454,
1157,3079,231,192,423,
1158,3177,238,163,401,
1159,3271,241,182,423,
1160,3163,225,173,398,
1161,3302,255,202,457,
1162,3228,225,198,423,
1163,3338,214,199,413,
1164,3340,232,188,420,
1165,3273,230,207,437,
1166,3253,232,197,429,
1167,3325,241,192,433,
1168,3183,241,175,416,
1169,3266,250,175,425,
1170,3102,230,183,413,
1171,3206,229,200,429,
1172,3246,225,191,416,
1173,3190,229,162,391,
1174,3088,223,145,368,
1175,3322,233,187,420,
1176,3233,219,165,384,
1177,3251,236,216,452,
1178,48,3,5,8,
1179,3186,250,180,430,
1180,3201,228,178,406,
1181,3180,217,167,384,
1182,3232,236,178,414,
1183,3231,205,175,380,
1185,2510,180,115,295,
1186,3201,198,209,407,
1187,3208,246,201,447,
1188,3227,226,189,415,
1189,3252,268,190,458,
1190,3210,235,191,426,
1191,3237,231,217,448,
1192,3179,250,168,418,
1193,3192,194,195,389,
1194,3180,268,167,435,
1195,3287,255,178,433,
1196,3259,211,179,390,
1197,3160,234,169,403,
1198,3288,253,178,431,
1200,3195,223,175,398,
1201,3185,218,177,395,
1202,3234,228,194,422,
1203,3148,214,183,397,
1204,3158,235,180,415,
1205,3208,251,170,421,
1206,3241,219,184,403,
1207,3289,237,189,426,
1208,3301,237,199,436,
1209,3162,230,175,405,
1211,3248,245,183,428,
1212,3255,224,182,406,
1213,3214,217,188,405,
1214,3183,248,192,440,
1215,3200,239,163,402,
1216,3176,221,173,394,
1219,3171,229,179,408,
1221,3154,221,181,402,
1222,72,8,4,12,
1223,3207,216,171,387,
1224,3296,228,198,426,
1225,3227,230,191,421,
1226,3114,216,176,392,
1228,3165,227,177,404,
1229,3195,241,180,421,
1230,3172,267,171,438,
1231,57,4,3,7,
1232,3202,243,176,419,
1233,3146,231,187,418,
1234,3230,275,198,473,
1235,3197,245,168,413,
1236,3166,238,193,431,
1237,3266,224,183,407,
1238,3309,259,163,422,
1239,3157,234,172,406,
1240,3272,225,166,391,
1241,3177,217,183,400,
1242,3170,188,203,391,
1243,3041,237,199,436,
1245,3183,215,192,407,
1246,3252,210,193,403,
1247,3219,246,172,418,
1248,3169,232,192,424,
1249,3250,239,174,413,
1250,3171,224,190,414,
1252,3267,209,175,384,
1253,3183,219,199,418,
1254,3275,240,197,437,
1256,3124,239,194,433,
1257,3132,214,190,404,
1258,3268,256,180,436,
1260,3251,252,197,449,
1261,3226,229,204,433,
1262,3237,198,185,383,
1263,3214,224,187,411,
1264,3275,224,195,419,
1265,3315,271,172,443,
1266,3366,244,193,437,
1267,3234,234,195,429,
1268,3115,224,145,369,
1269,3191,213,182,395,
1270,3224,257,192,449,
1271,3129,241,173,414,
1272,3353,237,172,409,
1273,3242,223,183,406,
1274,3275,245,183,428,
1275,3111,218,174,392,
1276,3143,238,179,417,
1277,3247,255,174,429,
1278,314,21,16,37,
1279,3241,232,199,431,
1280,3175,251,197,448,
1281,3204,243,193,436,
1282,3363,251,191,442,
1283,3182,223,188,411,
1284,3309,262,172,434,
1285,3267,221,211,432,
1286,3201,238,170,408,
1287,3122,244,163,407,
1288,3243,247,196,443,
1289,3141,226,187,413,
1290,165,9,11,20,
1291,3313,252,178,430,
1292,3102,237,162,399,
1293,3130,242,157,399,
1294,3322,228,186,414,
1295,3263,248,183,431,
1296,543,41,28,69,
1297,3265,218,204,422,
1298,2672,188,141,329,
1299,3168,249,170,419,
1300,3183,224,181,405,
1301,3281,219,184,403,
1302,3214,230,188,418,
1303,3298,222,212,434,
1304,3244,234,211,445,
1305,3354,246,211,457,
1306,3211,245,180,425,
1307,3229,212,183,395,
1308,3280,226,216,442,
1309,3217,223,182,405,
1311,3247,290,195,485,
1312,3258,228,174,402,
1313,3216,212,196,408,
1314,3259,246,166,412,
1315,3126,233,178,411,
1316,3170,213,203,416,
1317,3189,236,175,411,
1318,3087,202,185,387,
1319,3212,223,165,388,
1320,3343,238,183,421,
1321,3236,228,183,411,
1322,3280,220,197,417,
1323,657,65,47,112,
1324,3157,240,176,416,
1325,3090,214,169,383,
1326,3284,230,163,393,
1327,3160,220,194,414,
1329,3308,216,188,404,
1330,3112,255,168,423,
1331,3222,249,213,462,
1332,3182,224,187,411,
1333,3303,257,180,437,
1334,3289,259,158,417,
1336,3318,202,160,362,
1337,3283,227,205,432,
1338,3243,233,183,416,
1339,3298,212,184,396,
1340,43,4,3,7,
1341,315,36,16,52,
1342,3188,253,183,436,
1343,3198,254,195,449,
1344,3239,271,196,467,
1345,3239,254,187,441,
1346,3111,225,172,397,
1347,3254,231,202,433,
1348,3181,225,173,398,
1349,3207,233,157,390,
1350,3169,252,189,441,
1351,3232,232,187,419,
1352,3307,256,196,452,
1353,3239,226,180,406,
1354,3317,260,193,453,
1356,3252,217,236,453,
1357,3300,243,197,440,
1358,3200,231,165,396,
1359,3284,210,185,395,
1360,3226,248,191,439,
1363,2753,167,169,336,
1364,3138,227,176,403,
1365,3313,268,173,441,
1366,3162,217,204,421,
1367,3351,230,183,413,
1369,3191,228,204,432,
1370,3300,286,166,452,
1371,3338,270,163,433,
1372,3134,213,198,411,
1374,3160,253,176,429,
1375,3086,257,176,433,
1376,3267,238,195,433,
1377,3151,214,178,392,
1378,3196,238,198,436,
1379,3178,218,183,401,
1380,3204,229,190,419,
1381,3117,231,212,443,
1382,3065,217,173,390,
1383,3212,241,184,425,
1385,3282,240,203,443,
1386,3193,242,164,406,
1387,3236,210,168,378,
1388,3161,216,193,409,
1389,3179,235,161,396,
1390,3241,223,185,408,
1391,3270,254,190,444,
1392,3247,259,171,430,
1393,3144,224,191,415,
1394,120,10,7,17,
1395,3273,246,210,456,
1396,3158,230,182,412,
1397,3135,237,170,407,
1398,3177,202,164,366,
1399,3338,256,166,422,
1400,3148,219,178,397,
1401,3239,236,162,398,
1402,3274,254,183,437,
1403,3231,216,206,422,
1404,3192,216,192,408,
1405,3301,219,188,407,
1406,3184,225,171,396,
1407,3336,261,172,433,
1408,3151,215,190,405,
1409,3253,214,207,421,
1410,3179,248,184,432,
1411,3145,211,188,399,
1412,3193,225,171,396,
1414,3218,214,176,390,
1415,3140,212,172,384,
1416,3168,247,176,423,
1417,3233,225,178,403,
1418,3210,230,177,407,
1419,3047,209,196,405,
1420,3331,228,208,436,
1421,2612,172,134,306,
1422,3205,226,175,401,
1423,3194,238,197,435,
1424,3147,220,203,423,
1425,3200,248,164,412,
1426,3251,223,164,387,
1427,3227,237,186,423,
1428,3226,226,173,399,
1429,3193,211,188,399,
1430,3242,250,162,412,
1431,3122,238,192,430,
1432,3101,242,193,435,
1433,3192,214,160,374,
1434,3219,209,170,379,
1435,3167,243,181,424,
1436,3146,223,168,391,
1437,3244,219,183,402,
1438,3253,272,184,456,
1439,3221,246,178,424,
1440,3148,238,189,427,
1441,3191,205,177,382,
1442,3140,220,163,383,
1445,3343,228,195,423,
1446,3110,227,169,396,
1447,3175,211,176,387,
1449,3214,243,185,428,
1450,3264,218,179,397,
1451,3224,223,171,394,
1452,3167,234,159,393,
1453,2265,167,110,277,
1454,3173,249,184,433,
1455,3191,229,182,411,
1456,3250,285,199,484,
1457,3208,237,164,401,
1458,3211,209,174,383,
1459,3383,230,198,428,
1460,3167,244,186,430,
1461,3228,240,202,442,
1462,3176,226,198,424,
1463,179,11,11,22,
1464,3207,226,199,425,
1465,3178,221,196,417,
1466,488,24,30,54,
1467,3141,232,174,406,
1468,3303,224,179,403,
1469,3092,210,191,401,
1470,3032,219,176,395,
1471,3134,205,197,402,
1473,3153,216,186,402,
1474,3242,212,187,399,
1475,3182,228,180,408,
1476,3288,245,162,407,
1477,3193,248,166,414,
1478,3300,232,206,438,
1479,3298,235,178,413,
1480,3127,237,164,401,
1481,3223,222,194,416,
1482,3199,204,186,390,
1483,3204,266,189,455,
1484,3185,226,201,427,
1485,3083,225,186,411,
1486,3134,244,178,422,
1487,3105,228,170,398,
1488,3211,201,171,372,
1490,3191,224,166,390,
1491,3204,243,189,432,
1492,3137,221,165,386,
1493,3241,263,194,457,
1494,3256,212,185,397,
1495,71,4,6,10,
1498,3283,225,197,422,
1499,3301,251,195,446,
1500,3201,220,160,380,
1501,3236,242,195,437,
1502,3124,214,184,398,
1503,3209,246,162,408,
1504,3262,240,167,407,
1505,3265,234,200,434,
1507,3206,244,202,446,
1508,3202,212,185,397,
1509,3153,227,181,408,
1510,3126,211,185,396,
1511,3216,246,163,409,
1512,3237,247,183,430,
1513,3079,238,183,421,
1514,3304,246,226,472,
1515,184,9,12,21,
1516,3243,245,202,447,
1517,2586,191,145,336,
1518,3252,241,202,443,
1519,3091,208,182,390,
1520,3216,238,184,422,
1521,3271,238,188,426,
1522,3277,227,184,411,
1523,3152,223,188,411,
1524,3234,227,207,434,
1525,3175,265,180,445,
1526,3201,241,194,435,
1527,3274,208,195,403,
1528,3257,227,168,395,
1529,3119,219,179,398,
1530,3161,233,153,386,
1531,3205,243,178,421,
1532,3260,239,213,452,
1533,3180,237,153,390,
1534,3154,253,188,441,
1535,3100,223,198,421,
1536,3142,271,185,456,
1537,3231,219,176,395,
1538,3179,219,209,428,
1539,3259,250,180,430,
1541,3280,227,183,410,
1542,3265,260,165,425,
1543,3296,233,204,437,
1544,3187,240,192,432,
1545,3274,223,185,408,
1546,3080,221,197,418,
1547,3269,244,170,414,
1548,3218,232,212,444,
1549,247,15,10,25,
1550,3147,241,184,425,
1551,3147,225,173,398,
1552,3063,202,167,369,
1554,3220,231,186,417,
1555,3112,252,186,438,
1556,3248,219,197,416,
1557,3136,217,169,386,
1558,3115,213,173,386,
1559,3281,242,173,415,
1560,3204,237,178,415,
1562,3219,243,173,416,
1563,3307,241,203,444,
1564,3106,219,180,399,
1565,3140,258,164,422,
1566,3177,245,171,416,
1567,157,11,7,18,
1568,3208,221,180,401,
1569,3230,220,180,400,
1570,3288,244,175,419,
1571,3300,261,178,439,
1572,3091,257,173,430,
1573,3105,209,201,410,
1574,3115,226,176,402,
1575,3144,249,165,414,
1576,3261,254,179,433,
1577,3329,247,194,441,
1579,3255,245,154,399,
1581,3189,248,171,419,
1582,3234,223,188,411,
1583,3210,259,167,426,
1584,3151,218,180,398,
1585,3233,223,192,415,
1586,3241,238,181,419,
1587,3201,221,170,391,
1588,3072,220,166,386,
1589,2655,178,149,327,
1590,3055,224,161,385,
1591,3233,235,172,407,
1592,3216,243,164,407,
1593,3205,220,168,388,
1594,2633,180,157,337,
1595,3146,262,182,444,
1596,3206,211,167,378,
1597,3227,231,179,410,
1598,3231,251,189,440,
1599,3247,251,198,449,
1600,3192,219,180,399,
1602,3304,232,184,416,
1603,3105,227,168,395,
1604,3244,225,186,411,
1605,3259,246,180,426,
1606,3221,251,170,421,
1607,3321,228,193,421,
1608,3248,259,190,449,
1609,3181,230,182,412,
1610,3217,257,191,448,
1611,3304,260,165,425,
1612,3278,236,177,413,
1613,3232,240,184,424,
1614,66,3,3,6,
1615,3173,215,180,395,
1616,3237,223,186,409,
1617,43,2,5,7,
1618,3284,256,197,453,
1619,3200,215,168,383,
1620,3252,224,189,413,
1621,3210,231,207,438,
1622,3245,240,195,435,
1623,3249,238,184,422,
1624,3131,220,189,409,
1625,3138,236,164,400,
1626,3250,258,200,458,
1629,3222,239,147,386,
1630,3296,250,187,437,
1631,3309,204,196,400,
1632,3253,266,179,445,
1633,3203,256,185,441,
1634,3165,243,152,395,
1635,3213,236,204,440,
1636,3078,232,204,436,
1637,3259,212,214,426,
1638,3051,222,165,387,
1639,3292,228,212,440,
1640,3213,204,189,393,
1641,3194,230,192,422,
1643,3157,215,190,405,
1644,3235,241,175,416,
1645,3239,253,214,467,
1646,3215,224,184,408,
1647,3266,235,184,419,
1648,3223,217,196,413,
1649,3223,238,167,405,
1650,3313,223,191,414,
1651,3141,211,206,417,
1652,35,1,2,3,
1653,3177,233,179,412,
1654,3268,231,181,412,
1655,3090,239,185,424,
1656,53,2,2,4,
1657,7,1,1,2,
1658,3114,217,167,384,
1660,3096,216,167,383,
1661,3329,235,180,415,
1662,3251,240,206,446,
1663,3058,240,163,403,
1664,3288,236,180,416,
1665,3261,226,176,402,
1667,3188,242,162,404,
1669,3260,265,181,446,
1670,3154,225,158,383,
1671,3165,249,178,427,
1672,3187,258,203,461,
1673,3229,243,191,434,
1674,3135,241,180,421,
1675,3178,207,192,399,
1676,3248,224,178,402,
1677,3185,216,197,413,
1678,3214,231,199,430,
1679,3220,269,155,424,
1680,3102,237,176,413,
1681,3268,244,183,427,
1682,3232,258,170,428,
1683,3264,229,179,408,
1684,3220,204,166,370,
1685,3205,234,184,418,
1686,3232,229,182,411,
1687,3262,235,190,425,
1688,3202,228,179,407,
1690,3153,230,158,388,
1691,3268,224,177,401,
1692,3390,252,214,466,
1693,3177,210,193,403,
1694,3151,231,195,426,
1695,3182,238,199,437,
1697,92,7,6,13,
1698,3253,224,177,401,
1699,3226,239,182,421,
1700,3382,267,189,456,
1701,3282,233,225,458,
1702,3273,262,184,446,
1703,3169,232,176,408,
1704,3149,216,191,407,
1705,3172,244,178,422,
1706,3205,229,169,398,
1707,3148,228,174,402,
1708,3295,212,204,416,
1709,3206,243,183,426,
1710,3173,235,169,404,
1711,3112,241,168,409,
1712,3168,223,193,416,
1713,3192,209,199,408,
1714,3145,245,156,401,
1715,3177,268,194,462,
1716,3244,204,175,379,
1717,3256,210,196,406,
1718,3225,263,190,453,
1719,3121,233,169,402,
1720,3129,229,202,431,
1721,3260,229,189,418,
1722,3133,241,174,415,
1723,3145,240,207,447,
1724,3185,228,200,428,
1725,3150,230,185,415,
1726,3279,230,190,420,
1727,3274,226,175,401,
1728,3177,220,199,419,
1729,3195,241,190,431,
1730,3185,193,167,360,
1731,3249,257,178,435,
1732,3238,243,189,432,
1733,3166,247,203,450,
1734,3204,254,159,413,
1735,3159,229,162,391,
1736,3214,235,195,430,
1737,3292,260,175,435,
1738,3356,257,178,435,
1739,3251,263,166,429,
1740,3293,237,229,466,
1741,3277,238,189,427,
1742,3305,239,207,446,
1743,3300,240,190,430,
1744,3230,237,181,418,
1746,3230,245,203,448,
1747,3139,229,170,399,
1748,308,25,10,35,
1749,3118,218,170,388,
1750,3173,231,169,400,
1751,3267,238,175,413,
1753,3272,221,191,412,
1754,3181,202,182,384,
1755,3125,236,188,424,
1756,3158,234,218,452,
1757,3082,205,185,390,
1758,3216,239,173,412,
1759,3263,261,203,464,
1760,3274,225,185,410,
1761,3112,243,147,390,
1762,3152,216,173,389,
1763,3198,234,172,406,
1764,3151,246,163,409,
1765,3194,257,161,418,
1766,3183,233,162,395,
1767,3215,218,170,388,
1769,3259,257,197,454,
1770,3235,246,177,423,
1771,3246,202,176,378,
1772,3194,225,193,418,
1773,3112,235,167,402,
1774,3214,248,161,409,
1775,3240,237,167,404,
1776,3208,208,208,416,
1777,3219,224,198,422,
1778,3257,242,176,418,
1779,3226,225,182,407,
1780,3252,229,190,419,
1781,3160,224,164,388,
1782,3341,229,173,402,
1783,3197,228,184,412,
1784,556,50,24,74,
1785,3270,243,189,432,
1786,3157,249,172,421,
1787,2435,179,129,308,
1788,3115,245,158,403,
1789,3071,231,163,394,
1790,3247,253,192,445,
1791,220,10,16,26,
1792,334,27,13,40,
1793,3216,258,175,433,
1794,3174,227,170,397,
1795,3229,221,191,412,
1796,3280,235,190,425,
1797,3231,216,217,433,
1798,3234,271,197,468,
1800,3134,217,180,397,
1801,3218,247,193,440,
1802,3017,227,165,392,
1803,3244,220,198,418,
1804,3176,205,160,365,
1805,3173,252,186,438,
1806,3204,236,179,415,
1807,3268,225,186,411,
1808,626,44,41,85,
1809,3194,250,203,453,
1810,3141,233,175,408,
1811,3205,246,180,426,
1812,3318,231,171,402,
1813,3240,249,187,436,
1814,3302,252,185,437,
1815,3117,237,158,395,
1816,3178,229,176,405,
1817,3116,201,192,393,
1818,135,14,8,22,
1819,2651,233,123,356,
1821,3254,251,171,422,
1822,3264,254,207,461,
1824,3165,230,177,407,
1825,3151,236,175,411,
1826,3274,263,181,444,
1827,3043,223,150,373,
1828,3188,227,194,421,
1829,2602,184,165,349,
1831,3283,242,174,416,
1832,3324,224,197,421,
1833,3145,258,178,436,
1834,3169,206,177,383,
1835,3229,232,178,410,
1836,478,43,18,61,
1837,3151,220,177,397,
1838,3274,215,197,412,
1839,3158,206,197,403,
1840,3265,231,178,409,
1841,428,31,29,60,
1842,3298,238,186,424,
1843,3219,218,184,402,
1844,3237,259,171,430,
1845,3101,206,170,376,
1846,3233,226,179,405,
1847,3269,243,188,431,
1848,3079,231,180,411,
1849,3202,212,197,409,
1850,3056,210,171,381,
1851,3259,236,183,419,
1852,3133,231,153,384,
1853,3199,236,192,428,
1854,3198,240,194,434,
1855,3285,259,178,437,
1856,3166,237,194,431,
1858,3244,215,182,397,
1859,3249,245,191,436,
1860,3262,215,184,399,
1862,3265,244,207,451,
1863,3236,241,191,432,
1864,3175,207,174,381,
1865,2730,174,169,343,
1866,3122,210,176,386,
1867,3210,232,184,416,
1868,3075,206,200,406,
1869,3190,225,197,422,
1870,3176,243,170,413,
1871,3179,240,183,423,
1872,3283,225,190,415,
1874,3124,215,165,380,
1875,3219,236,174,410,
1876,3179,236,172,408,
1877,3149,228,197,425,
1878,3230,243,189,432,
1879,3199,230,188,418,
1880,3092,233,172,405,
1881,3160,218,182,400,
1882,3222,239,182,421,
1883,3220,249,195,444,
1884,3199,227,194,421,
1885,3275,247,156,403,
1886,3277,259,193,452,
1887,3224,258,183,441,
1888,3148,243,200,443,
1889,3221,238,184,422,
1890,3179,244,183,427,
1891,3146,236,177,413,
1892,3252,242,174,416,
1893,3295,223,197,420,
1894,3290,261,189,450,
1895,3366,240,206,446,
1896,3181,230,185,415,
1897,3177,238,170,408,
1898,3076,228,178,406,
1899,3160,233,177,410,
1900,220,14,10,24,
1901,3199,234,175,409,
1902,3290,266,189,455,
1904,3202,234,177,411,
1905,3144,209,174,383,
1906,3320,270,188,458,
1907,3259,246,163,409,
1908,3242,209,183,392,
1909,3185,228,187,415,
1910,3242,257,184,441,
1911,3219,262,186,448,
1912,3206,239,190,429,
1913,3280,238,191,429,
1914,3209,218,166,384,
1915,3315,252,178,430,
1916,23,1,4,5,
1917,3207,248,187,435,
1919,3259,211,205,416,
1921,3235,246,192,438,
1922,3204,232,178,410,
1923,3227,234,166,400,
1924,3138,217,161,378,
1925,3257,231,193,424,
1926,592,33,37,70,
1927,3158,235,173,408,
1928,3181,227,181,408,
1929,3241,248,143,391,
1930,3222,233,176,409,
1931,3166,219,181,400,
1932,3391,249,191,440,
1933,3172,230,187,417,
1934,3236,251,159,410,
1935,3226,222,209,431,
1936,3172,243,177,420,
1937,3315,219,196,415,
1939,3342,241,190,431,
1941,3269,226,179,405,
1942,3199,229,196,425,
1943,3210,264,185,449,
1944,3121,207,163,370,
1945,3309,223,199,422,
1946,3132,223,169,392,
1947,3224,223,187,410,
1948,3265,248,186,434,
1949,3302,241,193,434,
1950,3269,222,186,408,
1951,3187,230,196,426,
1952,3217,248,192,440,
1953,3120,209,199,408,
1954,3290,254,188,442,
1955,3174,246,175,421,
1956,188,13,7,20,
1957,3220,223,170,393,
1958,3237,247,200,447,
1959,3207,226,177,403,
1960,3223,241,174,415,
1961,3259,229,199,428,
1962,3185,247,185,432,
1963,3276,219,173,392,
1964,104,8,10,18,
1965,3282,240,179,419,
1966,3254,270,176,446,
1967,3297,243,171,414,
1968,3287,254,194,448,
1969,3226,233,191,424,
1970,3141,231,177,408,
1971,3274,231,181,412,
1972,3131,216,177,393,
1973,3224,221,211,432,
1974,465,44,19,63,
1975,3319,247,194,441,
1976,3056,221,195,416,
1977,3088,229,170,399,
1978,3202,257,196,453,
1980,3179,223,197,420,
1981,3237,242,185,427,
1982,3052,226,181,407,
1983,3287,231,183,414,
1984,3254,236,202,438,
1985,3211,233,165,398,
1986,3215,224,187,411,
1987,3267,230,155,385,
1988,3369,237,192,429,
1989,3243,236,182,418,
1991,3296,254,188,442,
1992,3098,249,191,440,
1993,3179,214,181,395,
1994,3289,229,195,424,
1995,3343,242,182,424,
1996,3148,247,188,435,
1997,602,37,27,64,
1998,3210,201,187,388,
1999,3167,240,146,386,
2000,3207,250,163,413,
2001,3249,223,190,413,
2002,3195,237,192,429,
2003,3203,245,172,417,
2004,3207,247,183,430,
2005,3188,226,168,394,
2006,3249,205,176,381,
2007,3105,233,178,411,
2008,3297,215,167,382,
2009,3216,236,147,383,
2010,3162,227,207,434,
2011,3138,207,185,392,
2012,3212,247,171,418,
2013,3273,219,180,399,
2014,52,6,1,7,
2015,3294,249,194,443,
2016,3225,255,205,460,
2017,3132,234,172,406,
2018,3206,257,174,431,
2019,3250,216,174,390,
2020,3179,231,190,421,
2021,3230,210,201,411,
2023,3177,227,154,381,
2024,2612,173,165,338,
2026,3199,242,172,414,
2027,3250,238,181,419,
2028,3268,245,166,411,
2029,3242,241,208,449,
2030,3238,257,171,428,
2031,3210,203,193,396,
2032,3329,239,167,406,
2033,3213,199,195,394,
2034,3214,226,150,376,
2035,3155,248,161,409,
2036,335,22,20,42,
2037,3183,206,164,370,
2038,3235,265,166,431,
2039,3272,204,212,416,
2040,40,5,1,6,
2041,3264,209,199,408,
2042,3196,244,191,435,
2043,3181,250,184,434,
2045,3209,230,164,394,
2047,3079,224,161,385,
2049,2985,230,187,417,
2050,3190,224,176,400,
2051,3191,238,199,437,
2052,3252,228,177,405,
2053,3245,250,201,451,
2054,3184,229,174,403,
2055,3155,225,174,399,
2056,3278,217,218,435,
2057,3279,238,173,411,
2058,3189,215,171,386,
2059,3286,235,168,403,
2061,3238,243,178,421,
2062,3210,246,155,401,
2063,3330,249,184,433,
2065,3296,243,194,437,
2066,3114,221,171,392,
2067,3144,224,188,412,
2068,3251,227,194,421,
2069,3275,206,181,387,
2070,3138,223,176,399,
2071,3206,214,155,369,
2072,3167,212,182,394,
2073,3212,230,201,431,
2075,3191,218,191,409,
2076,3293,210,190,400,
2077,3278,249,183,432,
2078,3202,254,189,443,
2079,3221,233,211,444,
2080,3202,256,192,448,
2081,3175,230,172,402,
2083,3227,267,184,451,
2084,3222,237,192,429,
2085,83,7,2,9,
2086,3144,249,170,419,
2087,3309,247,191,438,
2088,3229,216,185,401,
2089,3186,236,168,404,
2090,3175,243,169,412,
2091,3231,227,172,399,
2092,3257,231,177,408,
2094,3237,229,216,445,
2095,3228,235,184,419,
2096,3269,247,189,436,
2097,3230,215,191,406,
2098,3229,235,170,405,
2099,3102,237,172,409,
2100,3234,242,176,418,
2101,3282,246,201,447,
2102,3174,214,188,402,
2103,3189,231,152,383,
2104,3338,259,194,453,
2105,3217,248,185,433,
2106,3213,226,173,399,
2107,3249,236,176,412,
2109,3153,235,171,406,
2110,3062,206,152,358,
2111,3166,243,168,411,
2112,3166,234,179,413,
2113,3279,241,183,424,
2114,3320,265,191,456,
2115,3239,244,169,413,
2116,3166,240,176,416,
2117,3225,241,187,428,
2118,3196,211,189,400,
2119,3330,226,178,404,
2122,3107,230,159,389,
2125,3185,249,191,440,
2126,491,42,26,68,
2127,3204,232,179,411,
2128,3355,248,172,420,
2129,3226,249,192,441,
2130,3033,207,143,350,
2131,3208,247,202,449,
2132,183,19,4,23,
2133,3234,237,194,431,
2134,3206,240,180,420,
2135,3262,238,186,424,
2136,3226,227,174,401,
2137,3233,251,198,449,
2138,736,52,48,100,
2139,3243,222,197,419,
2140,3139,232,192,424,
2141,3236,239,159,398,
2142,3118,223,182,405,
2143,3242,235,159,394,
2144,3295,230,220,450,
2145,3142,239,182,421,
2146,3354,218,203,421,
2147,3220,239,172,411,
2148,3220,253,192,445,
2149,3320,249,171,420,
2150,3274,257,171,428,
2151,3159,238,179,417,
2152,3211,236,188,424,
2153,3114,223,152,375,
2154,605,42,31,73,
2155,3184,245,176,421,
2157,3209,239,190,429,
2158,3298,237,207,444,
2159,3254,260,175,435,
2160,3084,208,168,376,
2161,3328,267,186,453,
2163,3222,227,186,413,
2164,3272,247,185,432,
2165,3348,245,197,442,
2168,3058,211,147,358,
2169,3185,242,203,445,
2170,3136,252,189,441,
2172,3206,248,182,430,
2173,3200,229,194,423,
2174,3174,235,176,411,
2175,3190,222,170,392,
2176,3300,264,189,453,
2177,3248,261,176,437,
2178,3125,242,153,395,
2179,3235,233,206,439,
2180,3300,229,184,413,
2181,3099,221,161,382,
2182,3125,222,184,406,
2183,3205,194,168,362,
2184,3216,247,160,407,
2185,3189,213,177,390,
2186,3290,236,198,434,
2188,3187,203,206,409,
2190,3182,218,204,422,
2191,3243,231,192,423,
2192,3067,226,141,367,
2193,3248,229,161,390,
2194,3199,238,190,428,
2195,3246,252,183,435,
2196,3226,218,167,385,
2197,3211,252,177,429,
2198,3319,242,167,409,
2199,3117,215,194,409,
2200,3295,249,196,445,
2201,3139,245,192,437,
2202,3254,229,179,408,
2203,3244,240,202,442,
2204,3297,224,190,414,
2205,3198,196,199,395,
2206,3136,231,176,407,
2207,279,16,21,37,
2208,3207,226,213,439,
2209,3211,232,186,418,
2210,3314,242,167,409,
2211,3305,235,196,431,
2212,3213,226,191,417,
2213,3234,242,145,387,
2214,3289,261,186,447,
2215,3142,210,195,405,
2217,3137,196,168,364,
2218,3209,225,180,405,
2219,3281,210,202,412,
2220,3189,246,194,440,
2221,3166,234,204,438,
2222,3110,224,172,396,
2223,3201,230,158,388,
2224,3135,217,156,373,
2225,3198,251,170,421,
2226,3162,248,176,424,
2228,3301,274,196,470,
2229,3186,261,171,432,
2231,3207,251,176,427,
2232,3149,262,185,447,
2235,3158,232,170,402,
2236,3172,202,178,380,
2237,3189,249,163,412,
2238,3248,245,209,454,
2239,3293,248,158,406,
2240,3271,219,209,428,
2241,3206,241,151,392,
2242,3174,236,158,394,
2243,3242,239,165,404,
2244,3219,234,188,422,
2246,3188,218,177,395,
2247,3305,250,197,447,
2248,3102,220,180,400,
2249,3102,223,170,393,
2250,3228,222,187,409,
2251,3240,220,202,422,
2252,3235,250,194,444,
2253,3225,229,177,406,
2254,3224,209,197,406,
2255,3182,229,187,416,
2256,3234,224,186,410,
2258,2795,202,146,348,
2259,3210,231,170,401,
2260,3114,220,161,381,
2261,3138,259,179,438,
2262,3191,247,189,436,
2263,3268,249,209,458,
2264,3204,231,181,412,
2265,3115,240,175,415,
2266,3194,231,190,421,
2267,3378,247,179,426,
2268,3290,252,204,456,
2269,3197,241,168,409,
2270,3231,219,200,419,
2271,3279,229,192,421,
2272,3186,226,194,420,
2273,3185,221,177,398,
2274,3226,229,195,424,
2275,3222,233,206,439,
2276,3269,222,197,419,
2277,3265,238,185,423,
2278,3130,235,174,409,
2279,3191,226,183,409,
2280,3209,249,216,465,
2281,3258,249,172,421,
2282,3272,248,180,428,
2283,3225,240,202,442,
2284,3303,230,180,410,
2285,3197,252,191,443,
2286,3167,225,174,399,
2287,3226,238,206,444,
2288,3175,213,170,383,
2289,3172,210,182,392,
2291,3221,233,193,426,
2292,3308,248,178,426,
2293,3193,200,173,373,
2294,3086,205,197,402,
2295,3156,208,178,386,
2297,3228,278,192,470,
2298,3310,219,208,427,
2299,3240,217,167,384,
2300,3238,218,175,393,
2301,3306,225,163,388,
2302,3164,238,195,433,
2305,3171,262,166,428,
2306,3268,241,206,447,
2307,3137,223,172,395,
2309,3233,229,166,395,
2310,3195,237,161,398,
2311,3167,197,187,384,
2312,2537,162,133,295,
2313,3148,240,173,413,
2314,3245,231,160,391,
2315,3209,241,183,424,
2316,3330,230,205,435,
2317,3261,238,191,429,
2318,3278,233,180,413,
2319,3274,246,176,422,
2320,3060,207,161,368,
2321,3280,261,185,446,
2322,3230,246,187,433,
2323,3234,233,163,396,
2324,3193,232,184,416,
2325,3282,234,183,417,
2326,3208,202,187,389,
2327,3227,242,189,431,
2328,3193,221,188,409,
2329,3216,194,202,396,
2331,3217,233,203,436,
2332,3169,246,179,425,
2333,3125,235,166,401,
2334,3180,208,177,385,
2335,3245,232,174,406,
2336,3153,236,181,417,
2337,3295,211,198,409,
2338,3109,232,181,413,
2339,3264,210,179,389,
2340,3189,207,175,382,
2341,3188,232,194,426,
2342,3134,227,160,387,
2343,3206,208,194,402,
2344,3182,268,172,440,
2345,3359,234,189,423,
2346,3252,223,184,407,
2347,3196,225,194,419,
2348,3262,222,178,400,
2349,3333,228,206,434,
2350,3092,225,178,403,
2351,3156,203,163,366,
2352,3307,239,185,424,
2353,735,51,51,102,
2354,3244,225,194,419,
2355,3161,211,183,394,
2356,3175,233,170,403,
2357,3170,211,157,368,
2358,3161,221,175,396,
2359,3227,233,205,438,
2360,3148,239,189,428,
2361,3126,221,200,421,
2362,3226,221,164,385,
2366,3137,237,142,379,
2367,3200,245,185,430,
2368,3331,234,188,422,
2369,3176,232,186,418,
2370,3377,233,193,426,
2371,3221,236,171,407,
2372,3262,252,157,409,
2373,3190,233,198,431,
2374,3124,235,150,385,
2375,3208,229,197,426,
2376,3238,252,182,434,
2377,3195,199,203,402,
2378,3153,212,188,400,
2379,3201,269,159,428,
2380,3148,229,176,405,
2381,3099,212,184,396,
2382,3242,234,183,417,
2384,3180,215,173,388,
2385,3243,242,205,447,
2386,3122,246,167,413,
2387,3218,217,183,400,
2388,3117,190,187,377,
2389,3238,206,189,395,
2391,3164,227,207,434,
2392,3080,218,147,365,
2393,3372,230,196,426,
2394,3157,208,162,370,
2396,3277,241,166,407,
2397,3141,251,182,433,
2398,3141,196,190,386,
2399,3229,245,186,431,
2400,2628,191,148,339,
2401,3174,232,178,410,
2403,3280,242,185,427,
2404,3174,230,165,395,
2405,3243,204,212,416,
2406,3227,257,192,449,
2407,3265,239,178,417,
2408,3231,226,205,431,
2409,3263,249,183,432,
2410,3292,221,198,419,
2411,3126,229,192,421,
2412,3212,232,188,420,
2413,3095,251,193,444,
2414,3265,248,173,421,
2415,3222,207,170,377,
2416,3263,226,184,410,
2417,3177,224,204,428,
2418,3184,232,181,413,
2419,3268,239,175,414,
2420,3139,244,165,409,
2421,3240,226,187,413,
2422,3260,243,177,420,
2423,3217,270,183,453,
2424,3126,223,181,404,
2425,3310,230,187,417,
2426,3295,233,169,402,
2427,3202,245,168,413,
2428,3296,249,195,444,
2429,46,3,4,7,
2430,3155,217,163,380,
2431,3204,246,170,416,
2432,2602,176,152,328,
2433,3307,234,169,403,
2434,3228,255,171,426,
2437,3140,225,181,406,
2438,3195,245,185,430,
2439,3246,248,206,454,
2440,3324,242,194,436,
2441,3004,228,180,408,
2442,3213,240,172,412,
2443,3214,246,191,437,
2444,3176,253,186,439,
2445,22,1,1,2,
2446,3206,212,208,420,
2447,3269,217,194,411,
2448,3202,227,191,418,
2449,3237,232,184,416,
2450,3201,237,167,404,
2451,605,45,41,86,
2452,3257,239,188,427,
2453,3214,212,179,391,
2455,3147,257,168,425,
2456,3177,206,183,389,
2457,3248,275,172,447,
2458,3266,260,168,428,
2460,3258,204,182,386,
2461,3158,227,170,397,
2462,3206,276,170,446,
2463,3236,216,179,395,
2464,3267,233,172,405,
2465,3259,234,188,422,
2466,3200,242,190,432,
2467,3267,199,174,373,
2468,3310,233,176,409,
2469,3186,224,182,406,
2470,360,26,20,46,
2471,3181,287,178,465,
2472,386,27,21,48,
2473,3244,226,187,413,
2474,3271,238,190,428,
2476,3263,221,209,430,
2477,3308,239,176,415,
2478,3178,237,187,424,
2479,3205,232,196,428,
2480,3111,215,176,391,
2481,3118,233,190,423,
2482,3192,233,156,389,
2484,3116,248,177,425,
2485,3145,221,180,401,
2486,3095,220,183,403,
2487,3081,215,182,397,
2488,331,22,16,38,
2489,3268,219,150,369,
2490,3144,215,167,382,
2491,3270,247,171,418,
2492,3157,234,184,418,
2493,3228,242,182,424,
2494,3300,240,201,441,
2495,3124,222,163,385,
2496,3163,205,194,399,
2497,3240,243,182,425,
2498,3154,241,180,421,
2500,3234,224,181,405,
2501,3109,221,173,394,
2502,3257,228,173,401,
2503,3129,226,191,417,
2505,3369,237,185,422,
2506,3013,250,174,424,
2507,3094,227,160,387,
2508,3285,243,223,466,
2509,3212,227,190,417,
2510,3309,222,196,418,
2511,3220,233,176,409,
2512,3262,210,174,384,
2513,3264,241,177,418,
2514,3241,205,172,377,
2515,3248,239,212,451,
2516,3292,232,203,435,
2517,3285,262,185,447,
2518,3170,212,191,403,
2519,3098,253,152,405,
2520,3188,247,191,438,
2521,3085,210,158,368,
2522,3213,234,194,428,
2523,3180,243,169,412,
2524,3241,222,219,441,
2525,3091,231,179,410,
2526,3224,231,178,409,
2527,3149,216,149,365,
2528,173,10,8,18,
2529,3291,227,191,418,
2531,3197,211,214,425,
2533,3205,257,182,439,
2534,3248,222,198,420,
2535,3221,235,197,432,
2536,418,31,20,51,
2537,3132,230,181,411,
2538,3222,204,196,400,
2540,2457,181,136,317,
2541,3293,246,188,434,
2542,3185,228,187,415,
2543,3108,220,158,378,
2544,3177,217,184,401,
2545,3242,266,164,430,
2546,3220,266,184,450,
2548,3259,244,176,420,
2549,3249,227,194,421,
2550,3081,256,155,411,
2551,3199,229,208,437,
2552,3227,250,188,438,
2554,3244,223,199,422,
2555,3182,261,201,462,
2556,3334,249,176,425,
2557,3273,231,180,411,
2558,3204,203,174,377,
2559,3194,249,160,409,
2560,3238,241,181,422,
2561,3275,242,188,430,
2563,3142,225,208,433,
2564,3265,252,205,457,
2565,3275,234,208,442,
2566,3207,248,184,432,
2567,3181,245,220,465,
2568,3053,208,164,372,
2569,3218,220,166,386,
2570,3248,257,187,444,
2571,3231,240,210,450,
2572,3263,219,212,431,
2573,3136,223,185,408,
2574,3137,201,195,396,
2575,3273,231,183,414,
2577,3145,240,179,419,
2578,3224,218,176,394,
2579,3256,228,178,406,
2580,3306,266,181,447,
2581,3148,239,176,415,
2582,3203,226,184,410,
2583,3274,239,176,415,
2584,3182,233,193,426,
2585,3200,221,185,406,
2586,3170,226,186,412,
2587,3228,212,193,405,
2588,3164,243,182,425,
2589,3247,266,178,444,
2590,3260,206,201,407,
2591,3149,239,177,416,
2592,3280,213,201,414,
2593,3238,264,173,437,
2594,3038,203,183,386,
2595,3280,228,197,425,
2596,3199,265,168,433,
2597,3197,259,178,437,
2598,3332,239,206,445,
2599,3157,211,172,383,
2600,3196,237,186,423,
2601,3229,210,193,403,
2602,3161,239,192,431,
2603,315,30,19,49,
2605,3156,243,179,422,
2606,3127,240,168,408,
2607,3090,224,176,400,
2608,3239,251,179,430,
2609,3235,219,210,429,
2610,3270,236,181,417,
2611,332,17,17,34,
2612,3063,215,156,371,
2613,3218,238,162,400,
2614,3350,220,197,417,
2615,3136,209,196,405,
2617,584,46,31,77,
2618,3128,234,175,409,
2619,3192,221,175,396,
2621,3119,241,187,428,
2622,3195,238,181,419,
2623,3303,239,177,416,
2624,3149,204,183,387,
2625,3205,228,187,415,
2627,3255,233,193,426,
2628,3271,231,183,414,
2629,3268,224,191,415,
2630,3219,228,184,412,
2632,3177,233,185,418,
2633,3160,239,196,435,
2634,3225,226,177,403,
2635,3170,219,194,413,
2636,3194,206,189,395,
2637,3284,227,188,415,
2638,3175,246,173,419,
2639,96,4,3,7,
2640,3150,202,194,396,
2641,3087,200,195,395,
2642,3267,244,208,452,
2643,3273,235,175,410,
2644,3254,240,174,414,
2645,3157,242,177,419,
2646,3301,242,209,451,
2647,3120,242,182,424,
2648,3247,227,180,407,
2649,3177,220,167,387,
2652,3315,230,217,447,
2653,3200,240,188,428,
2654,828,61,53,114,
2655,2900,237,167,404,
2656,3264,266,188,454,
2657,3244,246,202,448,
2658,3261,238,176,414,
2659,3264,246,170,416,
2660,3215,210,181,391,
2661,3291,241,183,424,
2662,3294,229,191,420,
2663,3252,259,203,462,
2664,3178,242,184,426,
2665,3278,251,195,446,
2666,3143,235,171,406,
2667,3406,243,211,454,
2669,3259,230,187,417,
2670,3145,229,188,417,
2671,3281,230,186,416,
2672,32,2,2,4,
2673,3236,242,188,430,
2674,3297,214,173,387,
2675,3126,253,174,427,
2676,3213,229,174,403,
2677,3354,244,190,434,
2678,3197,235,209,444,
2679,3285,234,239,473,
2680,3180,236,176,412,
2681,3255,260,179,439,
2682,3231,223,190,413,
2683,3287,262,209,471,
2684,3234,260,182,442,
2685,3227,229,163,392,
2686,3154,228,196,424,
2687,3188,257,186,443,
2688,3325,237,182,419,
2689,3243,240,211,451,
2691,3200,223,191,414,
2692,3237,231,187,418,
2693,3204,239,163,402,
2694,427,25,26,51,
2695,3182,239,203,442,
2696,3234,247,177,424,
2697,3147,217,174,391,
2698,3236,225,169,394,
2699,3270,254,163,417,
2700,3260,239,186,425,
2704,3060,228,192,420,
2705,3082,223,170,393,
2706,3198,232,166,398,
2707,3237,273,191,464,
2708,3275,256,206,462,
2709,3146,232,166,398,
2710,3272,205,193,398,
2711,3252,243,211,454,
2712,3270,244,175,419,
2713,3256,216,211,427,
2714,3188,241,199,440,
2715,3136,270,175,445,
2716,3191,249,192,441,
2717,3246,233,196,429,
2718,3252,235,174,409,
2719,3015,207,180,387,
2720,3212,237,174,411,
2721,3259,237,179,416,
2722,3220,219,176,395,
2723,2930,224,151,375,
2724,3182,258,189,447,
2725,3262,241,176,417,
2726,3058,215,181,396,
2727,3306,234,201,435,
2728,3221,208,199,407,
2730,3267,216,171,387,
2731,3244,258,173,431,
2732,3156,252,165,417,
2733,3274,261,193,454,
2734,3297,272,181,453,
2736,3316,230,176,406,
2737,3261,259,176,435,
2738,3179,219,173,392,
2739,3161,240,177,417,
2740,3212,223,183,406,
2741,3274,214,197,411,
2742,3245,246,185,431,
2743,3239,251,190,441,
2744,3244,229,175,404,
2745,3266,232,182,414,
2746,3183,205,187,392,
2747,3303,268,195,463,
2748,2974,260,183,443,
2749,3292,244,174,418,
2751,3210,228,194,422,
2752,3102,236,197,433,
2753,3431,252,199,451,
2754,3253,234,202,436,
2755,274,13,20,33,
2757,3024,233,148,381,
2758,437,38,26,64,
2759,3163,231,212,443,
2760,3211,226,193,419,
2761,3343,241,184,425,
2762,3028,208,188,396,
2763,3390,250,192,442,
2764,3186,213,198,411,
2765,3199,188,168,356,
2766,3314,229,182,411,
2767,3216,201,191,392,
2769,3251,234,169,403,
2770,3120,231,177,408,
2771,3187,217,181,398,
2772,3130,227,176,403,
2773,3302,239,181,420,
2774,3217,206,181,387,
2775,3199,226,204,430,
2776,3265,231,180,411,
2777,3178,252,167,419,
2778,3254,218,194,412,
2779,3230,246,185,431,
2780,3199,247,203,450,
2781,3036,198,189,387,
2782,3201,235,196,431,
2783,3187,244,188,432,
2784,3211,202,183,385,
2785,3206,248,189,437,
2788,3146,246,165,411,
2789,3245,208,179,387,
2790,3246,227,176,403,
2791,3060,223,177,400,
2792,3260,212,171,383,
2793,3220,223,196,419,
2794,3295,236,192,428,
2795,3183,246,200,446,
2796,3214,242,195,437,
2797,3239,243,199,442,
2798,3171,215,180,395,
2799,3229,227,194,421,
2801,3171,254,194,448,
2802,3230,229,166,395,
2803,3334,238,174,412,
2804,3239,227,185,412,
2805,3181,229,202,431,
2806,3312,263,181,444,
2807,3180,233,192,425,
2808,3137,220,171,391,
2809,3209,239,183,422,
2810,3219,209,204,413,
2811,559,40,32,72,
2813,2995,241,198,439,
2814,3145,228,172,400,
2815,3266,224,184,408,
2816,3114,213,169,382,
2817,3220,226,186,412,
2818,3199,231,173,404,
2819,3146,223,177,400,
2820,3289,260,185,445,
2821,3324,255,172,427,
2822,3194,255,196,451,
2823,3088,227,176,403,
2824,3188,251,156,407,
2825,3203,227,182,409,
2826,3168,227,174,401,
2827,3097,239,180,419,
2828,3115,236,196,432,
2829,3221,254,186,440,
2831,3248,235,186,421,
2832,3297,218,175,393,
2833,3253,226,183,409,
2834,3224,235,190,425,
2835,3132,220,188,408,
2836,3180,232,189,421,
2837,3222,253,196,449,
2838,3245,260,172,432,
2839,3115,234,202,436,
2840,3219,233,156,389,
2841,3151,236,178,414,
2842,3233,237,180,417,
2843,3279,233,205,438,
2844,3154,240,174,414,
2845,3272,220,199,419,
2846,3195,200,191,391,
2847,3157,224,177,401,
2848,3274,215,196,411,
2849,3040,231,178,409,
2850,3201,261,205,466,
2851,3235,229,184,413,
2852,3144,238,174,412,
2853,3273,253,198,451,
2854,3274,239,197,436,
2857,3241,231,209,440,
2858,3183,237,174,411,
2859,3135,238,182,420,
2860,3300,217,174,391,
2861,3147,236,165,401,
2863,3224,225,206,431,
2864,212,15,10,25,
2865,3252,241,195,436,
2866,3205,225,177,402,
2867,3163,212,185,397,
2869,3184,218,152,370,
2870,3071,247,166,413,
2871,3286,212,206,418,
2872,3254,257,168,425,
2873,3151,227,200,427,
2874,3225,243,188,431,
2875,3134,226,175,401,
2876,146,10,12,22,
2877,3216,231,163,394,
2878,3143,231,189,420,
2879,3166,228,205,433,
2880,3275,254,162,416,
2881,3206,239,194,433,
2882,3168,221,183,404,
2883,3137,223,203,426,
2884,3285,254,182,436,
2885,3223,265,174,439,
2886,3192,200,161,361,
2887,3274,235,195,430,
2888,3230,213,181,394,
2890,3230,198,181,379,
2891,3270,226,198,424,
2892,3243,236,203,439,
2893,3244,239,190,429,
2894,3187,256,180,436,
2895,3302,238,182,420,
2896,3226,233,178,411,
2897,3145,206,189,395,
2898,3206,240,161,401,
2899,3262,246,191,437,
2900,3174,228,190,418,
2901,3167,244,203,447,
2902,3195,260,187,447,
2903,3113,248,191,439,
2904,3370,240,180,420,
2905,3320,251,179,430,
2906,3049,231,188,419,
2907,3125,232,199,431,
2908,3281,262,198,460,
2909,3134,239,183,422,
2910,3157,227,181,408,
2911,3227,244,178,422,
2912,3160,207,166,373,
2913,3245,226,176,402,
2914,3285,223,178,401,
2915,3201,226,180,406,
2916,3202,217,207,424,
2917,3217,240,197,437,
2918,3136,239,160,399,
2919,3149,204,203,407,
2920,3123,212,185,397,
2921,3153,210,177,387,
2922,3208,245,191,436,
2923,3350,231,194,425,
2924,3305,248,190,438,
2926,3226,240,166,406,
2927,3225,251,195,446,
2928,3257,253,203,456,
2929,3091,225,167,392,
2930,3254,230,209,439,
2931,3183,237,160,397,
2932,3223,218,185,403,
2934,3185,226,203,429,
2936,3139,224,186,410,
2937,3264,220,180,400,
2938,3258,233,188,421,
2939,3294,224,187,411,
2940,3147,246,197,443,
2941,3212,226,162,388,
2942,3155,246,204,450,
2943,3222,244,169,413,
2944,3291,222,211,433,
2945,3128,214,189,403,
2946,495,46,33,79,
2947,3238,248,192,440,
2948,3147,249,178,427,
2949,3270,248,173,421,
2950,3239,247,213,460,
2951,52,5,4,9,
2952,3136,242,193,435,
2953,3226,241,201,442,
2954,3201,236,179,415,
2955,3220,223,179,402,
2956,3178,220,199,419,
2957,3192,263,190,453,
2958,3234,232,173,405,
2959,3221,224,175,399,
2960,3251,228,181,409,
2961,3140,254,181,435,
2962,3272,239,176,415,
2963,3150,215,199,414,
2964,3265,247,194,441,
2965,35,1,3,4,
2966,3185,219,185,404,
2967,3213,239,166,405,
2968,3226,255,190,445,
2969,3347,251,195,446,
2970,3287,231,197,428,
2971,3189,241,176,417,
2972,3121,225,191,416,
2973,3201,221,182,403,
2974,3268,222,182,404,
2975,3275,210,186,396,
2976,3134,199,188,387,
2977,3270,212,201,413,
2979,3202,222,178,400,
2980,3230,234,182,416,
2981,3268,258,185,443,
2982,3288,237,193,430,
2983,3198,244,165,409,
2985,3253,220,180,400,
2986,3293,237,199,436,
2987,3187,255,193,448,
2988,3343,256,199,455,
2989,3291,239,173,412,
2990,157,7,8,15,
2991,3198,240,179,419,
2992,3153,226,161,387,
2993,3212,237,205,442,
2994,3293,242,194,436,
2995,3171,255,180,435,
2997,70,5,6,11,
2998,3166,257,171,428,
2999,525,31,27,58,
3000,3253,250,178,428,
3001,3206,212,200,412,
3003,3223,240,172,412,
3004,3173,226,186,412,
3005,3063,229,173,402,
3006,2693,207,160,367,
3007,3296,261,212,473,
3008,3214,234,176,410,
3009,3163,214,159,373,
3010,3184,220,172,392,
3011,3258,248,189,437,
3012,3250,244,181,425,
3013,3321,210,202,412,
3014,3018,242,177,419,
3015,3129,246,196,442,
3016,3094,209,162,371,
3017,3184,241,179,420,
3018,3303,248,191,439,
3019,3201,242,192,434,
3020,3187,244,198,442,
3021,3118,223,218,441,
3023,3317,250,182,432,
3024,3275,253,207,460,
3025,3301,227,183,410,
3026,3292,250,182,432,
3027,3203,240,176,416,
3028,3227,246,169,415,
3029,3284,222,201,423,
3030,3211,242,197,439,
3031,3142,224,202,426,
3032,3133,220,197,417,
3033,3244,239,181,420,
3035,3244,203,172,375,
3037,3277,206,183,389,
3038,3172,230,168,398,
3039,3267,246,203,449,
3041,3260,234,169,403,
3042,3203,238,192,430,
3044,171,14,5,19,
3045,3147,214,172,386,
3047,3101,205,201,406,
3048,3272,264,177,441,
3049,3333,204,187,391,
3050,3092,221,172,393,
3051,3240,195,185,380,
3052,3222,229,174,403,
3053,3183,217,158,375,
3055,3184,221,191,412,
3056,3091,229,199,428,
3057,3242,201,202,403,
3058,3311,257,181,438,
3060,3150,221,173,394,
3061,3110,242,162,404,
3063,3296,237,184,421,
3064,3220,236,190,426,
3065,3191,214,183,397,
3067,3164,230,169,399,
3068,3109,244,174,418,
3069,3175,218,197,415,
3070,3257,238,197,435,
3072,3219,229,182,411,
3073,3304,254,198,452,
3074,3262,234,191,425,
3076,3210,261,186,447,
3077,3213,237,189,426,
3078,3297,240,197,437,
3079,3186,217,211,428,
3081,3108,240,201,441,
3082,3275,248,185,433,
3083,3191,248,175,423,
3084,573,31,40,71,
3085,3362,238,188,426,
3086,3206,228,183,411,
3087,3250,248,183,431,
3088,3148,212,204,416,
3089,3226,240,190,430,
3090,3267,249,176,425,
3091,3144,247,154,401,
3092,3328,217,183,400,
3093,3205,237,203,440,
3094,3129,229,199,428,
3095,3274,219,202,421,
3096,3229,223,214,437,
3097,3256,227,189,416,
3098,3231,225,181,406,
3099,3190,233,177,410,
3100,3256,233,183,416,
3102,3207,230,184,414,
3103,3182,258,189,447,
3104,3212,205,207,412,
3105,3256,231,195,426,
3106,3189,243,167,410,
3107,3158,234,173,407,
3109,3209,246,151,397,
3110,3218,227,175,402,
3111,3097,242,168,410,
3112,3133,233,171,404,
3113,3170,227,180,407,
3114,3249,230,171,401,
3115,3292,277,176,453,
3116,3244,241,178,419,
3117,3224,242,190,432,
3118,3354,229,196,425,
3120,3151,221,183,404,
3121,3219,239,192,431,
3122,3120,250,194,444,
3124,3171,203,173,376,
3125,3120,252,164,416,
3126,3225,231,187,418,
3127,3136,224,174,398,
3128,3286,251,170,421,
3129,3276,233,189,422,
3130,3247,237,187,424,
3131,3261,258,157,415,
3132,3273,238,196,434,
3133,3241,261,194,455,
3134,3292,237,179,416,
3135,3264,240,204,444,
3136,3125,240,176,416,
3137,107,8,7,15,
3138,3098,209,181,390,
3140,3256,230,186,416,
3141,3240,241,178,419,
3142,3184,246,184,430,
3143,3246,240,167,407,
3145,3244,260,187,447,
3146,3197,206,185,391,
3147,3262,214,181,395,
3148,3128,227,170,397,
3149,3295,210,204,414,
3150,3200,250,182,432,
3151,3172,247,155,402,
3152,3190,245,166,411,
3153,3255,235,196,431,
3154,3226,218,196,414,
3155,3308,218,196,414,
3156,3281,245,178,423,
3157,3167,242,199,441,
3158,3299,249,187,436,
3159,3155,223,187,410,
3160,3295,211,204,415,
3161,3262,235,202,437,
3162,3143,203,185,388,
3163,3072,222,175,397,
3164,3263,234,164,398,
3165,3251,248,177,425,
3166,3272,247,177,424,
3167,3020,252,166,418,
3168,3145,241,179,420,
3169,3248,246,167,413,
3170,155,16,6,22,
3171,2605,197,142,339,
3172,3213,233,183,416,
3174,537,46,29,75,
3175,3217,241,218,459,
3176,3295,238,202,440,
3177,3224,223,173,396,
3178,3153,224,184,408,
3179,3116,244,179,423,
3180,2677,207,124,331,
3181,3164,213,158,371,
3182,3289,255,205,460,
3183,3199,238,192,430,
3184,25,3,2,5,
3185,3221,237,181,418,
3187,3248,234,166,400,
3188,3218,230,184,414,
3190,3199,206,190,396,
3191,3239,227,171,398,
3192,3248,212,202,414,
3193,3277,235,197,432,
3194,3240,234,197,431,
3195,134,12,7,19,
3196,269,18,14,32,
3197,3148,236,183,419,
3198,3324,267,215,482,
3199,3283,238,197,435,
3200,3229,225,186,411,
3201,3239,231,191,422,
3202,3200,225,185,410,
3203,3203,202,200,402,
3204,3164,224,201,425,
3205,3320,260,181,441,
3206,3290,211,177,388,
3207,3218,234,171,405,
3208,3203,238,211,449,
3210,3208,260,177,437,
3212,3205,220,200,420,
3213,3127,223,174,397,
3214,3197,199,171,370,
3216,3081,195,193,388,
3217,3040,193,163,356,
3218,3210,232,191,423,
3219,3155,214,175,389,
3220,3260,200,185,385,
3221,3227,268,195,463,
3223,3128,208,167,375,
3224,3147,262,166,428,
3225,3186,238,175,413,
3226,3109,241,159,400,
3227,3210,229,186,415,
3228,3345,261,164,425,
3229,3113,233,172,405,
3230,3219,217,184,401,
3231,3122,205,171,376,
3232,3147,204,151,355,
3233,3228,244,194,438,
3234,3175,248,191,439,
3235,3091,238,155,393,
3236,3291,264,192,456,
3237,3205,213,194,407,
3238,3229,235,187,422,
3239,300,15,14,29,
3240,3286,213,186,399,
3241,3165,225,149,374,
3242,3185,231,179,410,
3243,3144,225,163,388,
3245,124,9,5,14,
3246,3195,216,164,380,
3247,3213,227,157,384,
3248,3275,247,200,447,
3250,3250,239,155,394,
3251,676,38,44,82,
3252,3203,226,217,443,
3253,3342,228,179,407,
3254,3271,210,192,402,
3255,3310,243,179,422,
3256,3183,225,192,417,
3257,3271,247,162,409,
3258,3381,263,196,459,
3259,3175,218,155,373,
3260,3205,266,168,434,
3261,2503,181,147,328,
3262,3206,261,205,466,
3263,3295,254,195,449,
3264,3189,233,159,392,
3265,3066,230,205,435,
3266,3215,196,176,372,
3267,3149,229,173,402,
3268,3303,255,176,431,
3270,3195,208,199,407,
3271,3256,238,157,395,
3272,3274,199,178,377,
3273,3171,268,173,441,
3274,3231,220,192,412,
3275,3070,232,169,401,
3276,3117,207,204,411,
3277,3128,211,169,380,
3278,3171,233,182,415,
3279,3261,245,165,410,
3281,3163,233,185,418,
3282,3097,221,168,389,
3283,3161,260,209,469,
3284,3133,239,174,413,
3285,3283,239,162,401,
3286,3241,213,174,387,
3287,3278,206,205,411,
3288,3177,230,169,399,
3289,3236,238,191,429,
3292,3139,248,186,434,
3293,3156,202,176,378,
3294,3138,235,191,426,
3297,3184,203,214,417,
3298,3150,235,185,420,
3299,3131,226,171,397,
3302,3232,229,189,418,
3303,3259,248,179,427,
3304,3317,246,189,435,
3305,3210,223,173,396,
3306,3203,227,151,378,
3308,3204,218,169,387,
3309,3365,289,187,476,
3310,3113,214,184,398,
3311,3234,259,183,442,
3312,3223,231,209,440,
3314,3206,221,180,401,
3315,3194,238,198,436,
3316,3230,233,182,415,
3317,3269,244,190,434,
3318,3271,253,200,453,
3319,3239,232,210,442,
3320,3216,235,174,409,
3321,3324,252,202,454,
3323,3192,249,164,413,
3324,3316,268,184,452,
3325,3308,255,177,432,
3326,3155,210,197,407,
3327,3159,238,197,435,
3328,3154,241,192,433,
3329,3166,227,160,387,
3330,3209,247,157,404,
3331,172,15,8,23,
3332,3154,238,173,411,
3333,3297,235,204,439,
3334,3185,248,187,435,
3336,3203,212,187,399,
3337,3189,239,211,450,
3338,3369,222,175,397,
3339,3272,235,184,419,
3340,3212,216,178,394,
3341,3183,212,165,377,
3342,3169,229,159,388,
3344,448,19,27,46,
3345,3235,240,180,420,
3346,3293,248,165,413,
3347,3276,239,202,441,
3349,3120,212,179,391,
3350,3179,259,200,459,
3351,3249,236,195,431,
3352,3179,228,200,428,
3353,3303,229,203,432,
3354,3301,249,182,431,
3355,3168,229,191,420,
3357,3180,203,187,390,
3358,3309,254,169,423,
3359,3084,199,172,371,
3360,3118,238,175,413,
3361,3135,231,163,394,
3363,3240,218,187,405,
3364,3182,240,171,411,
3365,3214,239,191,430,
3366,3173,226,187,413,
3367,3225,259,181,440,
3368,3214,215,187,402,
3369,3289,239,186,425,
3370,3141,207,206,413,
3371,3322,229,191,420,
3372,3338,255,211,466,
3373,467,40,16,56,
3374,3274,233,181,414,
3376,3217,216,176,392,
3377,180,11,13,24,
3378,3125,238,181,419,
3379,3243,204,176,380,
3380,3179,231,167,398,
3381,3164,245,168,413,
3382,256,19,10,29,
3383,3296,227,188,415,
3384,3127,222,185,407,
3386,3255,214,183,397,
3387,3266,230,196,426,
3388,3196,227,178,405,
3389,3171,227,161,388,
3390,3299,257,195,452,
3391,3209,225,172,397,
3392,3248,224,184,408,
3393,3036,200,206,406,
3394,3173,228,160,388,
3395,3116,242,192,434,
3396,165,15,4,19,
3399,3159,251,177,428,
3400,3193,235,189,424,
3401,3276,248,174,422,
3402,3201,227,163,390,
3403,3280,236,182,418,
3404,3129,254,172,426,
3405,3251,239,194,433,
3407,3140,207,171,378,
3408,3200,239,180,419,
3409,3213,224,188,412,
3410,3140,236,184,420,
3411,3139,229,161,390,
3412,3192,206,185,391,
3413,3097,239,150,389,
3414,3229,222,156,378,
3415,3312,250,210,460,
3416,3218,231,200,431,
3417,3226,226,192,418,
3418,3253,226,193,419,
3419,3200,284,155,439,
3420,3259,237,204,441,
3421,3173,234,166,400,
3422,3155,237,156,393,
3423,3247,251,170,421,
3425,3156,220,184,404,
3426,3226,242,182,424,
3427,3230,244,179,423,
3428,3218,244,206,450,
3429,3130,231,188,419,
3430,3135,237,175,412,
3431,3186,243,171,414,
3433,3173,236,176,412,
3434,3156,241,191,432,
3436,3259,256,197,453,
3437,3206,224,212,436,
3438,3264,222,202,424,
3439,3170,224,188,412,
3440,3329,226,162,388,
3441,3220,240,150,390,
3442,3214,248,180,428,
3443,3202,222,182,404,
3444,3263,223,197,420,
3445,3291,241,167,408,
3446,3240,222,206,428,
3448,3140,223,184,407,
3449,3241,232,191,423,
3450,3203,256,212,468,
3451,3154,213,189,402,
3452,3064,229,173,402,
3453,3135,212,192,404,
3454,3211,214,196,410,
3455,3187,236,169,405,
3456,3208,270,180,450,
3457,3235,243,206,449,
3458,3216,245,191,436,
3459,3119,237,187,424,
3460,3102,218,172,390,
3461,3119,249,187,436,
3462,3201,238,163,401,
3463,3197,221,183,404,
3464,3275,236,196,432,
3465,3160,227,173,400,
3466,3245,247,183,430,
3467,3204,221,160,381,
3468,3135,235,168,403,
3469,416,23,21,44,
3470,3147,231,182,413,
3471,3278,232,187,419,
3472,3128,248,181,429,
3473,3143,239,188,427,
3474,3247,210,180,390,
3475,3201,237,191,428,
3477,3146,222,187,409,
3478,3224,230,189,419,
3479,3230,241,172,413,
3480,3156,236,185,421,
3481,3228,218,197,415,
3482,3169,230,173,403,
3483,3136,215,181,396,
3485,3069,220,176,396,
3486,3394,260,197,457,
3487,85,10,2,12,
3489,3262,249,160,409,
3490,112,11,8,19,
3491,3208,237,162,399,
3492,3253,249,172,421,
3493,3322,239,180,419,
3494,3302,244,195,439,
3495,3235,257,178,435,
3496,3138,218,154,372,
3497,3181,260,186,446,
3498,3254,231,199,430,
3499,607,40,39,79,
3501,3255,216,196,412,
3502,3265,257,210,467,
3503,3215,249,183,432,
3504,3211,242,184,426,
3505,3242,229,183,412,
3506,3225,208,192,400,
3508,3111,220,155,375,
3509,3254,252,208,460,
3510,3240,224,204,428,
3511,3192,241,168,409,
3515,3186,228,171,399,
3516,3219,287,172,459,
3517,3151,245,167,412,
3518,3269,231,192,423,
3520,3075,219,179,398,
3521,3100,220,181,401,
3522,3217,252,180,432,
3523,3176,234,181,415,
3525,236,10,11,21,
3526,3242,218,180,398,
3527,3128,250,186,436,
3528,3325,259,206,465,
3529,3204,252,171,423,
3530,3293,253,184,437,
3531,3125,222,193,415,
3532,3260,221,179,400,
3533,3239,220,178,398,
3535,3272,236,184,420,
3536,3225,248,194,442,
3537,3285,242,186,428,
3538,3077,239,151,390,
3539,3254,242,187,429,
3540,3138,221,182,403,
3541,3166,244,200,444,
3542,3199,234,220,454,
3543,3185,211,182,393,
3544,3266,236,160,396,
3546,3229,234,180,414,
3547,3126,253,176,429,
3548,3139,235,170,405,
3549,3174,250,188,438,
3550,3154,214,194,408,
3551,3278,224,185,409,
3552,3203,234,191,425,
3553,3141,194,192,386,
3554,3199,215,166,381,
3555,3331,237,185,422,
3556,3220,248,190,438,
3557,3224,224,207,431,
3558,186,12,13,25,
3559,127,5,6,11,
3560,3225,235,175,410,
3561,3176,245,177,422,
3562,3189,236,179,415,
3563,335,21,21,42,
3564,3234,227,203,430,
3565,3347,237,196,433,
3566,3322,277,168,445,
3567,3102,222,187,409,
3568,3176,250,147,397,
3569,3235,234,199,433,
3570,3278,233,200,433,
3571,3075,218,161,379,
3572,3225,239,176,415,
3573,3193,228,161,389,
3574,3268,228,191,419,
3575,3310,239,179,418,
3576,3263,238,159,397,
3578,3221,225,187,412,
3579,3032,239,196,435,
3580,3299,227,196,423,
3581,3094,222,183,405,
3582,3184,216,180,396,
3583,3214,225,191,416,
3584,3208,231,162,393,
3585,3239,229,173,402,
3586,3241,241,180,421,
3587,3156,211,178,389,
3588,3136,243,161,404,
3589,3236,222,189,411,
3590,3187,200,179,379,
3591,3205,224,178,402,
3592,3245,206,183,389,
3594,3152,270,144,414,
3595,3253,217,190,407,
3596,3129,225,179,404,
3597,3324,249,195,444,
3598,3055,212,176,388,
3599,3243,253,167,420,
3600,3245,248,185,433,
3601,3251,204,185,389,
3602,3251,205,196,401,
3603,3145,228,192,420,
3604,3122,219,180,399,
3605,3137,208,202,410,
3607,3153,237,185,422,
3608,3242,258,189,447,
3609,3204,230,142,372,
3610,3182,250,179,429,
3611,3198,242,153,395,
3612,3251,234,183,417,
3613,3256,206,189,395,
3614,3188,220,185,405,
3615,3114,224,165,389,
3616,3137,246,176,422,
3617,3112,242,174,416,
3618,3267,230,202,432,
3619,3167,203,185,388,
3620,58,9,5,14,
3621,168,14,7,21,
3622,3255,227,216,443,
3623,3186,212,184,396,
3624,3296,218,168,386,
3626,3334,261,168,429,
3627,22,2,1,3,
3628,3273,248,184,432,
3629,3267,217,175,392,
3630,3251,237,165,402,
3631,3159,227,183,410,
3632,3144,277,159,436,
3633,2867,194,160,354,
3634,25,3,1,4,
3635,3235,224,188,412,
3636,3130,250,148,398,
3637,3234,228,215,443,
3638,3209,210,175,385,
3639,3131,238,173,411,
3641,3271,235,198,433,
3642,321,23,11,34,
3643,3167,223,194,417,
3644,3148,227,186,413,
3645,3089,246,170,416,
3646,2555,190,131,321,
3647,3075,229,182,411,
3648,3089,207,179,386,
3649,3179,204,183,387,
3650,3249,222,189,411,
3651,3293,235,173,408,
3652,3265,220,186,406,
3653,3246,237,183,420,
3654,3212,222,160,382,
3655,3221,259,176,435,
3656,3224,226,178,404,
3657,3207,236,190,426,
3658,3236,242,180,422,
3659,3183,255,185,440,
3660,3173,215,175,390,
3661,3174,233,170,403,
3662,3101,204,172,376,
3663,3220,251,177,428,
3664,3018,212,176,388,
3665,3120,232,180,412,
3666,3116,229,179,408,
3667,3192,225,176,401,
3668,3290,208,205,413,
3669,3246,232,186,418,
3670,3234,248,189,437,
3673,3185,233,171,404,
3674,3120,220,177,397,
3675,3262,227,178,405,
3676,3241,241,178,419,
3677,3144,234,159,393,
3678,3203,246,177,423,
3679,3259,257,176,433,
3680,3180,239,189,428,
3681,3213,230,172,402,
3682,3232,223,170,393,
3683,3272,239,180,419,
3684,3201,244,170,414,
3685,3264,234,163,397,
3686,3232,262,166,428,
3687,3317,251,184,435,
3689,3245,242,184,426,
3690,3212,278,165,443,
3691,3195,252,172,424,
3692,3301,246,189,435,
3693,3240,257,176,433,
3694,3296,249,200,449,
3695,3283,264,171,435,
3696,3278,252,189,441,
3698,3140,219,198,417,
3699,3240,249,208,457,
3700,3181,238,188,426,
3701,3253,246,177,423,
3702,3208,239,174,413,
3703,3253,225,179,404,
3704,3095,241,161,402,
3705,3150,229,193,422,
3706,3228,238,187,425,
3707,3114,222,187,409,
3708,3244,275,166,441,
3709,3215,234,180,414,
3710,3216,223,163,386,
3711,3211,247,216,463,
3713,3144,218,196,414,
3714,3203,219,200,419,
3715,3206,299,176,475,
3716,3089,200,160,360,
3717,3208,255,179,434,
3718,3128,241,189,430,
3719,3251,254,189,443,
3720,3182,236,174,410,
3721,3327,237,190,427,
3722,3269,223,193,416,
3723,3173,224,202,426,
3724,3205,234,186,420,
3726,3182,225,202,427,
3727,3315,253,185,438,
3728,3178,245,176,421,
3729,3337,248,155,403,
3731,3148,253,149,402,
3732,3273,231,163,394,
3733,3249,221,173,394,
3734,3114,243,167,410,
3735,3175,224,219,443,
3737,3201,211,210,421,
3738,3197,198,215,413,
3739,3227,221,177,398,
3740,3321,253,191,444,
3741,3283,232,178,410,
3743,3231,244,164,408,
3744,3327,262,181,443,
3745,3085,222,165,387,
3746,3189,237,184,421,
3747,3141,234,179,413,
3748,3334,272,195,467,
3749,3206,238,181,419,
3750,3143,211,210,421,
3751,128,7,10,17,
3752,3254,238,165,403,
3753,3257,232,171,403,
3754,3207,226,186,412,
3755,3278,239,190,429,
3756,3276,214,191,405,
3757,3130,222,155,377,
3758,3265,219,204,423,
3759,3284,228,192,420,
3760,3309,189,193,382,
3761,3200,249,171,420,
3762,3263,260,187,447,
3763,3253,237,170,407,
3764,3238,233,178,411,
3765,3346,255,177,432,
3766,3250,265,170,435,
3767,3280,238,181,419,
3768,3201,226,196,422,
3769,3263,249,190,439,
3771,3097,224,189,413,
3772,3199,240,187,427,
3773,3192,220,173,393,
3774,3163,224,208,432,
3775,3269,249,191,440,
3776,3168,259,195,454,
3777,3100,235,163,398,
3778,3100,225,172,397,
3779,3219,254,196,450,
3780,3272,243,175,418,
3781,3277,216,159,375,
3782,3256,258,202,460,
3783,3213,244,166,410,
3784,3335,245,213,458,
3785,3190,214,194,408,
3786,3303,249,198,447,
3787,3138,225,181,406,
3788,3063,255,170,425,
3789,3191,199,186,385,
3790,3317,226,168,394,
3791,3126,231,186,417,
3792,3271,245,205,450,
3793,3085,224,167,391,
3794,3229,241,174,415,
3795,3205,226,169,395,
3796,3177,229,167,396,
3797,3166,248,159,407,
3798,3250,240,190,430,
3799,3221,243,183,426,
3800,3270,245,192,437,
3801,3174,241,183,424,
3802,3188,237,171,408,
3803,15,1,1,2,
3804,3229,224,184,408,
3805,3206,234,179,413,
3806,3225,230,193,423,
3807,3352,240,186,426,
3809,546,31,28,59,
3810,3197,221,200,421,
3811,3253,227,200,427,
3812,3296,232,171,403,
3813,3274,226,211,437,
3814,3158,251,178,429,
3815,3217,230,198,428,
3816,3280,229,201,430,
3817,3278,243,187,430,
3818,3099,206,182,388,
3819,3283,239,187,426,
3820,3261,240,184,424,
3823,3117,211,156,367,
3824,3195,224,165,389,
3825,3200,215,151,366,
3826,3164,266,188,454,
3827,35,3,1,4,
3828,3299,217,166,383,
3829,3300,250,182,432,
3830,3194,235,192,427,
3831,3267,244,187,431,
3832,3155,229,189,418,
3833,3239,233,193,426,
3834,3158,228,178,406,
3835,3154,212,181,393,
3836,739,67,41,108,
3838,2695,178,154,332,
3839,182,16,18,34,
3840,3303,254,203,457,
3841,3218,208,179,387,
3842,3136,244,172,416,
3843,3139,250,188,438,
3844,524,31,21,52,
3845,204,17,14,31,
3846,3102,232,165,397,
3847,3264,231,177,408,
3848,3288,255,167,422,
3849,3289,227,204,431,
3850,3190,245,181,426,
3851,3277,227,209,436,
3852,3148,207,146,353,
3854,3177,247,193,440,
3855,198,13,11,24,
3856,3153,238,168,406,
3858,3269,249,157,406,
3859,3275,233,170,403,
3860,3197,231,193,424,
3861,3238,239,196,435,
3862,3327,280,189,469,
3863,3248,219,189,408,
3864,3255,252,194,446,
3865,3148,235,202,437,
3866,3237,226,189,415,
3867,3256,238,190,428,
3868,3344,236,185,421,
3869,409,25,24,49,
3870,3141,234,177,411,
3871,3095,219,172,391,
3872,3265,231,178,409,
3873,3192,250,175,425,
3874,3181,201,169,370,
3875,3116,238,160,398,
3876,3242,210,185,395,
3877,3220,238,189,427,
3878,3227,225,185,410,
3879,3225,257,184,441,
3880,3161,246,179,425,
3881,3213,203,203,406,
3882,3190,202,165,367,
3883,3208,242,170,412,
3884,3068,224,166,390,
3886,3138,266,194,460,
3887,3109,245,168,413,
3888,3214,240,177,417,
3889,3227,232,181,413,
3890,3228,218,207,425,
3891,3308,234,165,399,
3892,3281,230,198,428,
3893,3273,237,171,408,
3895,3217,250,180,430,
3896,3273,222,193,415,
3897,3263,229,208,437,
3898,3077,192,182,374,
3899,3209,232,172,404,
3900,3204,261,174,435,
3904,3256,223,186,409,
3905,3195,236,198,434,
3906,3163,218,171,389,
3907,3201,240,217,457,
3908,3270,257,168,425,
3909,3294,234,176,410,
3910,3122,255,178,433,
3911,3311,260,193,453,
3912,3169,241,192,433,
3913,3247,227,189,416,
3914,3153,209,175,384,
3916,3206,218,162,380,
3917,3082,228,171,399,
3918,3229,231,186,417,
3919,3273,251,166,417,
3920,3147,238,175,413,
3921,3240,253,197,450,
3922,3107,240,186,426,
3923,3183,219,151,370,
3925,3249,214,196,410,
3927,3161,199,190,389,
3928,3161,210,178,388,
3929,453,25,21,46,
3930,3187,243,214,457,
3931,3137,247,183,430,
3932,3203,244,166,410,
3933,3202,225,190,415,
3934,3225,251,166,417,
3935,3264,263,187,450,
3936,3205,228,171,399,
3937,3294,230,179,409,
3938,3061,209,149,358,
3939,3240,229,187,416,
3940,3236,251,162,413,
3941,3272,243,203,446,
3942,3220,234,192,426,
3943,3167,258,179,437,
3944,3205,238,177,415,
3945,3296,253,182,435,
3946,3227,239,200,439,
3947,3314,229,189,418,
3948,3271,235,180,415,
3949,3282,219,188,407,
3950,3220,215,209,424,
3951,3103,228,160,388,
3952,3273,226,188,414,
3953,3293,242,212,454,
3954,3288,254,202,456,
3955,3324,238,192,430,
3957,3285,232,179,411,
3958,3264,233,194,427,
3960,3280,233,184,417,
3961,3140,200,188,388,
3962,3236,230,183,413,
3963,3118,278,167,445,
3964,3241,248,167,415,
3965,3214,248,207,455,
3966,3247,233,204,437,
3967,3185,242,187,429,
3968,3173,232,192,424,
3969,3126,199,180,379,
3970,3125,235,176,411,
3971,3166,237,201,438,
3972,3294,252,173,425,
3973,3150,232,179,411,
3974,3193,219,193,412,
3975,3285,240,164,404,
3977,3170,208,178,386,
3979,3269,250,200,450,
3980,3224,257,205,462,
3981,3200,222,175,397,
3982,3248,234,158,392,
3983,3264,237,157,394,
3984,3244,238,177,415,
3985,483,41,30,71,
3986,3232,218,172,390,
3987,3191,238,183,421,
3988,3177,266,164,430,
3989,3117,241,181,422,
3990,3147,215,199,414,
3991,3196,264,188,452,
3992,3160,225,205,430,
3993,3121,217,175,392,
3994,3169,228,179,407,
3996,3218,228,191,419,
3997,3154,199,184,383,
3998,3192,243,194,437,
3999,3178,224,187,411,
4000,3135,207,164,371,
4002,3220,235,189,424,
4003,3299,229,175,404,
4004,3206,240,195,435,
4005,2629,182,159,341,
4006,3224,244,188,432,
4007,3177,239,183,422,
4008,3271,245,194,439,
4009,3268,237,185,422,
4010,3195,238,181,419,
4011,3184,220,177,397,
4012,3176,252,205,457,
4013,3215,244,183,427,
4014,3251,229,194,423,
4015,3187,206,170,376,
4016,3231,231,172,403,
4017,3226,214,166,380,
4018,3106,264,193,457,
4019,3234,217,193,410,
4020,3195,250,187,437,
4021,3256,238,180,418,
4023,3114,223,182,405,
4024,3323,237,175,412,
4026,331,19,26,45,
4027,3187,230,170,400,
4028,3189,237,179,416,
4029,3228,200,191,391,
4030,3173,236,181,417,
4031,3197,234,194,428,
4032,3258,246,188,434,
4033,3176,227,182,409,
4034,3208,243,168,411,
4035,3145,218,184,402,
4037,3209,249,181,430,
4038,3160,245,172,417,
4039,3352,223,208,431,
4040,3214,222,168,390,
4041,3313,235,177,412,
4042,3191,249,174,423,
4043,3234,253,175,428,
4044,3212,228,182,410,
4045,3140,226,189,415,
4046,3243,231,173,404,
4047,3170,224,165,389,
4048,3281,242,180,422,
4049,3069,214,162,376,
4050,3218,196,197,393,
4052,3180,242,181,423,
4053,124,9,4,13,
4055,3215,216,159,375,
4056,3229,256,186,442,
4057,3316,242,181,423,
4058,3222,241,176,417,
4059,3295,247,211,458,
4060,3232,227,173,400,
4061,3300,233,181,414,
4063,3168,218,195,413,
4064,3304,275,201,476,
4065,3222,244,200,444,
4066,3239,216,158,374,
4067,3324,246,188,434,
4068,3221,269,165,434,
4069,3223,257,165,422,
4070,3167,233,182,415,
4071,3336,223,209,432,
4072,3228,262,191,453,
4073,3271,221,171,392,
4074,3125,211,142,353,
4075,3111,229,154,383,
4077,3236,239,166,405,
4078,3266,241,182,423,
4079,3125,247,182,429,
4080,858,63,32,95,
4081,3225,217,173,390,
4082,3253,249,185,434,
4084,3254,238,170,408,
4085,3193,231,187,418,
4086,3252,229,172,401,
4087,3199,218,204,422,
4088,3241,257,164,421,
4089,3269,221,197,418,
4091,3187,210,175,385,
4092,3215,225,191,416,
4093,3135,225,181,406,
4094,3250,213,179,392,
4095,3185,232,173,405,
4096,3102,205,150,355,
4097,3131,242,198,440,
4098,3195,217,168,385,
4099,3334,239,174,413,
4100,3298,223,181,404,
4101,255,14,16,30,
4102,3147,246,170,416,
4103,3191,225,173,398,
4104,3271,217,203,420,
4105,3347,224,191,415,
4106,3270,246,160,406,
4107,3186,228,162,390,
4108,3205,243,188,431,
4109,2623,191,137,328,
4110,3207,234,176,410,
4111,3260,219,211,430,
4112,3264,232,179,411,
4113,3311,242,200,442,
4114,3250,208,169,377,
4115,3304,223,189,412,
4116,3355,242,189,431,
4117,3205,231,174,405,
4119,3261,231,170,401,
4120,3288,244,176,420,
4121,2399,167,135,302,
4123,3162,228,195,423,
4124,3257,227,188,415,
4125,3065,210,157,367,
4126,3114,212,161,373,
4127,3297,256,180,436,
4128,3109,207,155,362,
4129,3299,235,189,424,
4130,3173,248,186,434,
4131,3186,251,171,422,
4132,3298,245,189,434,
4133,3363,257,198,455,
4134,3291,238,203,441,
4135,3249,219,175,394,
4136,3172,253,185,438,
4139,3184,250,163,413,
4140,3318,250,200,450,
4141,3236,223,171,394,
4143,3215,239,214,453,
4144,3222,228,208,436,
4146,3212,243,172,415,
4147,3131,219,183,402,
4148,3128,241,166,407,
4149,3225,229,168,397,
4150,3180,233,177,410,
4151,3327,240,180,420,
4152,3215,225,171,396,
4153,3128,223,205,428,
4154,3249,263,187,450,
4155,3230,248,185,433,
4157,3091,219,160,379,
4158,3224,222,177,399,
4159,3090,223,188,411,
4160,3100,215,183,398,
4161,3293,242,181,423,
4162,3239,233,159,392,
4163,3289,221,181,402,
4164,3277,215,213,428,
4165,3185,221,171,392,
4166,3190,225,187,412,
4167,3112,216,162,378,
4168,3197,244,178,422,
4169,3102,229,158,387,
4171,3209,212,194,406,
4172,3226,242,191,433,
4173,3088,203,181,384,
4174,3212,229,194,423,
4175,3148,240,185,425,
4176,3140,208,186,394,
4177,128,8,13,21,
4178,3250,234,177,411,
4179,3265,234,197,431,
4180,3250,235,197,432,
4181,3204,244,186,430,
4182,3212,229,168,397,
4183,3176,236,188,424,
4184,3261,230,191,421,
4186,3231,237,222,459,
4187,3146,208,165,373,
4188,3215,245,187,432,
4189,3157,222,168,390,
4190,3247,239,170,409,
4191,387,24,20,44,
4192,3185,236,176,412,
4193,3212,255,194,449,
4194,3213,227,181,408,
4195,3266,242,155,397,
4196,3144,213,161,374,
4197,3248,235,164,399,
4198,3296,258,184,442,
4199,3137,206,190,396,
4200,3256,237,171,408,
4201,3158,221,195,416,
4202,3164,212,181,393,
4203,3170,221,202,423,
4204,3194,243,182,425,
4205,3248,236,171,407,
4206,3278,234,200,434,
4207,3178,237,183,420,
4208,3251,233,177,410,
4209,3319,230,183,413,
4210,3305,244,195,439,
4211,3415,245,185,430,
4212,3270,247,175,422,
4213,3186,226,191,417,
4214,284,19,15,34,
4215,3297,257,192,449,
4216,3133,218,153,371,
4217,3155,217,165,382,
4218,3198,239,186,425,
4219,3153,252,179,431,
4220,3209,233,204,437,
4221,3208,226,190,416,
4223,3126,245,168,413,
4225,3213,234,184,418,
4226,3115,237,169,406,
4227,3261,270,177,447,
4229,3208,222,168,390,
4230,3287,235,186,421,
4231,3144,205,180,385,
4232,3161,211,181,392,
4233,3174,242,176,418,
4234,568,40,24,64,
4235,3079,208,182,390,
4236,3240,218,204,422,
4237,3250,232,192,424,
4239,3304,233,191,424,
4242,3399,228,198,426,
4243,3081,233,179,412,
4244,3214,240,178,418,
4245,3212,242,171,413,
4246,3096,233,163,396,
4247,3148,233,176,409,
4248,3206,242,173,415,
4249,3261,266,174,440,
4251,3185,245,199,444,
4252,3135,217,196,413,
4253,3258,232,215,447,
4254,3178,242,194,436,
4255,3243,238,173,411,
4256,3170,236,189,425,
4257,3116,214,184,398,
4259,3236,240,193,433,
4260,3272,247,182,429,
4261,3190,220,175,395,
4262,3304,266,218,484,
4263,3204,204,191,395,
4264,3338,250,187,437,
4265,3205,246,192,438,
4267,3271,237,196,433,
4268,3279,246,168,414,
4269,3172,235,199,434,
4270,3031,238,177,415,
4272,3201,254,161,415,
4273,3301,241,217,458,
4274,593,47,40,87,
4275,3283,219,195,414,
4276,3198,247,181,428,
4277,3293,237,227,464,
4278,3225,248,195,443,
4279,3220,216,193,409,
4280,3151,209,201,410,
4281,3244,241,171,412,
4282,3196,237,186,423,
4283,3137,210,180,390,
4284,3096,201,176,377,
4285,3301,234,183,417,
4286,3280,229,168,397,
4288,3205,251,159,410,
4289,3151,221,197,418,
4290,3280,207,181,388,
4291,3276,250,175,425,
4292,256,20,12,32,
4293,3329,250,187,437,
4294,3195,242,179,421,
4295,3279,232,180,412,
4296,3223,218,195,413,
4297,3293,226,190,416,
4298,3317,230,188,418,
4299,3255,217,181,398,
4300,3200,249,175,424,
4301,3115,221,181,402,
4302,543,35,32,67,
4303,3120,243,176,419,
4304,3202,228,197,425,
4305,3230,265,186,451,
4306,3250,237,178,415,
4307,3193,235,184,419,
4308,3164,249,168,417,
4309,72,5,5,10,
4310,3171,245,183,428,
4311,3200,248,174,422,
4312,3226,234,179,413,
4313,3176,267,177,444,
4314,3140,228,176,404,
4316,3176,258,179,437,
4317,3207,224,192,416,
4318,3065,243,165,408,
4319,3250,240,195,435,
4320,3199,246,174,420,
4321,3317,238,192,430,
4322,3306,225,194,419,
4323,3128,242,185,427,
4324,3155,213,198,411,
4325,14,1,1,2,
4326,3221,240,189,429,
4327,3269,238,180,418,
4328,3264,230,219,449,
4329,3217,227,179,406,
4330,3273,244,144,388,
4332,3229,231,190,421,
4333,3179,245,189,434,
4334,3255,220,209,429,
4335,3144,206,167,373,
4336,3202,253,162,415,
4337,3305,226,200,426,
4338,3284,254,179,433,
4339,3325,235,175,410,
4340,3158,220,179,399,
4341,3174,236,199,435,
4342,3253,245,178,423,
4343,3290,244,178,422,
4344,3220,273,183,456,
4345,3360,236,185,421,
4346,3258,239,176,415,
4347,3237,256,162,418,
4348,3318,247,186,433,
4349,3192,213,171,384,
4350,3172,227,184,411,
4351,3172,244,175,419,
4352,3203,243,170,413,
4353,3122,252,194,446,
4354,3265,261,167,428,
4355,3258,232,212,444,
4356,3204,230,203,433,
4357,3215,209,189,398,
4358,3283,256,164,420,
4359,3305,215,188,403,
4360,3137,248,202,450,
4361,3261,226,199,425,
4362,3179,223,184,407,
4363,3247,211,170,381,
4364,3228,234,175,409,
4365,3255,217,221,438,
4367,3240,224,184,408,
4368,3131,219,197,416,
4369,3223,215,187,402,
4370,3253,244,177,421,
4371,3201,255,187,442,
4372,3226,268,205,473,
4373,3258,236,196,432,
4374,3346,245,175,420,
4375,3222,243,184,427,
4376,3229,242,207,449,
4377,3294,210,183,393,
4378,3309,259,185,444,
4379,3211,256,182,438,
4380,3275,219,201,420,
4381,3195,221,178,399,
4382,3251,238,157,395,
4383,3201,263,174,437,
4385,535,50,20,70,
4386,3105,218,150,368,
4388,3054,234,167,401,
4389,3245,254,168,422,
4391,3141,229,172,401,
4392,3174,226,194,420,
4393,3222,223,168,391,
4394,3213,242,193,435,
4395,3130,220,178,398,
4397,3211,260,165,425,
4398,3390,243,190,433,
4399,3172,233,181,414,
4400,3305,226,199,425,
4401,3196,258,190,448,
4402,3232,224,171,395,
4403,3330,225,186,411,
4404,3239,219,184,403,
4405,3123,220,172,392,
4406,3195,238,174,412,
4407,3124,179,181,360,
4408,3227,241,193,434,
4409,3123,224,201,425,
4410,3186,246,179,425,
4411,3160,207,174,381,
4413,3267,253,198,451,
4414,3183,241,159,400,
4415,3310,229,159,388,
4416,3278,253,196,449,
4417,3166,250,170,420,
4418,3256,213,189,402,
4419,3084,193,178,371,
4420,3336,244,176,420,
4421,3215,239,191,430,
4422,3183,223,206,429,
4423,3290,247,195,442,
4424,3330,247,183,430,
4425,3221,241,193,434,
4426,3080,212,179,391,
4427,290,20,14,34,
4428,3155,214,180,394,
4429,3216,230,193,423,
4430,3263,239,186,425,
4431,3252,205,170,375,
4432,3238,213,179,392,
4435,3202,227,186,413,
4438,3178,240,194,434,
4439,3278,246,193,439,
4440,3152,253,145,398,
4441,3264,230,186,416,
4442,3242,242,174,416,
4443,143,8,7,15,
4444,2289,174,118,292,
4445,3178,229,170,399,
4446,11,1,1,2,
4447,3263,263,177,440,
4448,3217,209,201,410,
4449,3271,250,174,424,
4450,3132,205,177,382,
4451,3205,257,166,423,
4452,2974,211,171,382,
4453,3173,232,194,426,
4454,3155,217,192,409,
4455,3173,254,188,442,
4456,3216,233,206,439,
4457,3113,264,148,412,
4458,3133,246,186,432,
4459,3210,244,197,441,
4461,3122,206,199,405,
4462,3294,222,219,441,
4463,3191,227,211,438,
4464,3217,212,169,381,
4466,148,8,7,15,
4467,3231,239,205,444,
4468,3281,247,188,435,
4469,3250,240,192,432,
4470,375,32,18,50,
4471,3241,236,155,391,
4472,3120,242,164,406,
4473,3170,216,163,379,
4474,3237,229,184,413,
4475,3268,227,200,427,
4476,3122,239,170,409,
4477,3259,239,188,427,
4478,3240,230,189,419,
4479,3296,244,212,456,
4480,3185,218,190,408,
4481,3207,219,196,415,
4482,2755,209,172,381,
4483,3319,236,167,403,
4484,3084,224,149,373,
4485,3144,258,163,421,
4486,527,34,28,62,
4487,3201,243,208,451,
4489,3315,282,204,486,
4490,3257,226,177,403,
4491,3296,223,214,437,
4492,3291,246,184,430,
4493,3149,220,177,397,
4494,3265,230,167,397,
4495,3306,259,183,442,
4496,3222,215,173,388,
4498,3314,225,183,408,
4499,3240,241,146,387,
4500,3235,243,203,446,
4501,3230,249,192,441,
4502,3272,223,164,387,
4503,3284,225,198,423,
4504,3163,215,213,428,
4505,3153,234,176,410,
4506,3239,240,186,426,
4508,3095,246,163,409,
4509,3253,231,190,421,
4510,3236,243,146,389,
4511,99,9,1,10,
4512,3238,235,190,425,
4513,3010,230,171,401,
4514,3260,241,175,416,
4515,3214,200,205,405,
4516,3232,209,189,398,
4517,3334,267,196,463,
4518,3158,217,188,405,
4519,3218,251,186,437,
4520,3240,258,197,455,
4522,3155,204,191,395,
4524,3196,232,185,417,
4525,3223,244,180,424,
4526,3284,236,181,417,
4527,3232,212,183,395,
4528,2686,189,141,330,
4529,3244,228,189,417,
4530,3213,241,197,438,
4531,3294,266,172,438,
4533,3317,239,174,413,
4534,3272,251,156,407,
4536,3179,208,185,393,
4537,3147,235,193,428,
4539,3198,264,177,441,
4540,3171,239,185,424,
4541,3181,247,174,421,
4542,3217,246,188,434,
4543,3179,232,188,420,
4544,3246,248,179,427,
4546,3064,220,163,383,
4548,3145,237,172,409,
4549,198,16,8,24,
4550,3216,241,177,418,
4551,3268,238,203,441,
4553,3326,240,217,457,
4554,3206,279,170,449,
4555,3245,231,206,437,
4558,3243,215,189,404,
4559,3236,232,191,423,
4560,3261,216,217,433,
4561,3304,262,185,447,
4563,3145,240,192,432,
4564,3132,220,186,406,
4565,3225,218,189,407,
4566,3229,189,193,382,
4567,3242,244,179,423,
4568,3186,227,200,427,
4569,3137,233,186,419,
4570,3153,223,180,403,
4571,3194,210,197,407,
4572,3128,228,161,389,
4573,3249,254,175,429,
4574,3227,235,203,438,
4575,3191,227,181,408,
4576,3213,236,193,429,
4577,3282,223,185,408,
4578,3223,242,177,419,
4579,3186,241,173,414,
4580,3168,250,186,436,
4581,3273,235,200,435,
4582,3214,214,176,390,
4583,3196,220,156,376,
4584,3247,246,217,463,
4585,2784,182,157,339,
4586,3205,230,206,436,
4587,3202,223,203,426,
4588,3290,264,189,453,
4589,3310,222,188,410,
4590,3115,253,175,428,
4591,3170,204,197,401,
4592,3258,266,181,447,
4593,3256,244,160,404,
4594,3184,217,169,386,
4595,3235,227,191,418,
4596,3261,218,168,386,
4597,94,4,9,13,
4598,3228,224,165,389,
4599,3183,234,165,399,
4600,3324,217,211,428,
4602,3256,231,185,416,
4604,3279,261,205,466,
4605,3331,239,202,441,
4606,3218,232,190,422,
4608,3157,228,158,386,
4609,3094,224,166,390,
4610,3286,241,185,426,
4611,3210,250,159,409,
4612,3132,217,161,378,
4613,3256,223,183,406,
4614,3264,228,189,417,
4615,3173,235,184,419,
4616,3240,252,195,447,
4617,3154,226,196,422,
4618,3191,245,174,419,
4619,3209,234,196,430,
4620,3178,213,163,376,
4621,3163,213,166,379,
4622,3239,228,183,411,
4623,3302,240,189,429,
4624,2553,199,145,344,
4625,3171,226,164,390,
4626,3134,241,171,412,
4627,3312,258,196,454,
4628,3232,233,170,403,
4629,3198,242,201,443,
4630,3222,218,193,411,
4631,3188,224,190,414,
4633,3282,228,197,425,
4634,3234,245,179,424,
4635,3179,247,170,417,
4636,3081,219,168,387,
4637,3263,224,191,415,
4638,3100,241,178,419,
4639,3184,221,160,381,
4640,3225,224,170,394,
4641,3301,226,177,403,
4642,3101,219,174,393,
4643,3248,218,215,433,
4645,3267,216,188,404,
4647,3062,225,177,402,
4648,3200,236,179,415,
4649,3359,268,188,456,
4652,3143,224,187,411,
4653,3242,243,179,422,
4654,3131,206,178,384,
4655,3307,250,197,447,
4656,3058,233,163,396,
4657,3210,210,183,393,
4658,3152,258,152,410,
4659,537,34,29,63,
4660,3102,220,179,399,
4661,3237,265,199,464,
4663,3085,219,150,369,
4664,3196,197,208,405,
4665,3157,245,182,427,
4666,3045,220,216,436,
4667,3270,226,181,407,
4668,3189,209,186,395,
4669,3241,228,206,434,
4670,3129,216,201,417,
4671,3181,248,179,427,
4672,3137,204,160,364,
4673,3253,263,185,448,
4675,3149,213,168,381,
4676,3203,234,190,424,
4677,3231,254,168,422,
4678,3235,238,197,435,
4679,3122,225,179,404,
4680,3191,233,169,402,
4681,3272,223,199,422,
4682,3155,199,155,354,
4683,3245,246,200,446,
4684,3126,219,190,409,
4685,3225,234,210,444,
4686,3256,218,169,387,
4687,3163,221,166,387,
4688,3159,243,174,417,
4689,569,41,31,72,
4690,3252,223,199,422,
4691,3177,209,188,397,
4692,3286,255,191,446,
4693,3163,208,168,376,
4694,3246,257,186,443,
4695,3278,228,210,438,
4696,3287,245,215,460,
4697,3271,228,187,415,
4698,3166,221,198,419,
4699,168,7,10,17,
4700,3193,224,199,423,
4701,3166,196,162,358,
4702,3291,216,196,412,
4703,3136,231,159,390,
4704,3145,237,193,430,
4705,3287,255,171,426,
4706,3252,233,169,402,
4707,3189,231,183,414,
4708,3211,246,171,417,
4709,3199,213,188,401,
4711,3166,218,177,395,
4712,3152,242,192,434,
4713,3273,198,185,383,
4714,3291,242,179,421,
4715,3106,232,190,422,
4716,3240,217,166,383,
4717,3077,218,186,404,
4718,3184,223,166,389,
4719,3262,243,185,428,
4720,3205,253,192,445,
4721,3258,239,176,415,
4722,3222,210,182,392,
4723,3116,243,187,430,
4724,3230,254,216,470,
4725,3220,206,202,408,
4726,3450,274,208,482,
4727,3141,231,178,409,
4728,3241,240,185,425,
4729,3246,241,193,434,
4731,3169,241,185,426,
4732,3317,251,184,435,
4734,3131,204,183,387,
4736,3187,237,173,410,
4737,3263,270,192,462,
4738,3202,232,192,424,
4740,3137,232,182,414,
4741,3180,230,163,393,
4742,3306,215,166,381,
4743,3221,223,174,397,
4744,3220,239,162,401,
4745,3164,240,181,421,
4746,3232,241,181,422,
4747,3221,220,182,402,
4748,3161,210,162,372,
4749,3137,237,167,404,
4750,3237,249,169,418,
4751,3130,236,152,388,
4752,3253,225,168,393,
4754,3309,252,184,436,
4756,3205,238,166,404,
4757,3156,229,172,401,
4758,3298,220,216,436,
4759,3125,221,177,398,
4760,3198,250,164,414,
4761,3280,244,185,429,
4762,3234,232,183,415,
4765,3336,266,184,450,
4766,69,2,5,7,
4767,3149,243,189,432,
4768,3242,257,174,431,
4769,3306,215,198,413,
4770,3225,226,198,424,
4771,2551,156,136,292,
4772,512,32,28,60,
4773,3133,242,197,439,
4774,3213,244,185,429,
4776,3278,242,190,432,
4777,3209,235,207,442,
4778,3262,224,194,418,
4780,62,3,3,6,
4781,3178,229,163,392,
4783,3217,238,221,459,
4784,288,24,20,44,
4785,3250,245,187,432,
4787,3244,212,177,389,
4788,3172,235,174,409,
4789,3301,250,206,456,
4790,3285,226,183,409,
4793,3162,245,174,419,
4794,3217,213,181,394,
4796,3222,263,190,453,
4797,3101,229,180,409,
4798,3247,243,200,443,
4799,3204,233,166,399,
4800,3205,207,198,405,
4801,3152,222,166,388,
4802,148,8,12,20,
4803,3318,224,196,420,
4804,3227,199,180,379,
4805,3166,226,165,391,
4806,3201,275,168,443,
4807,3329,250,194,444,
4809,3101,227,177,404,
4810,3180,201,182,383,
4811,2645,202,152,354,
4812,3150,234,199,433,
4814,3249,243,176,419,
4815,3177,237,191,428,
4816,3248,215,192,407,
4817,3186,218,183,401,
4818,3301,258,165,423,
4819,3197,265,162,427,
4820,3265,248,193,441,
4821,3347,246,208,454,
4822,3288,245,173,418,
4823,3241,218,165,383,
4824,3306,272,191,463,
4825,3273,260,181,441,
4826,3243,249,165,414,
4827,3272,271,184,455,
4828,3298,243,196,439,
4829,2562,205,142,347,
4830,20,2,1,3,
4831,3241,215,203,418,
4832,3254,229,192,421,
4833,3160,237,168,405,
4834,3289,241,159,400,
4835,3177,245,196,441,
4836,3206,209,185,394,
4837,3230,229,203,432,
4838,3275,247,175,422,
4839,3198,265,189,454,
4840,3098,208,154,362,
4842,3075,221,192,413,
4843,755,51,43,94,
4844,3251,257,197,454,
4845,3231,252,191,443,
4846,3334,274,156,430,
4847,3146,243,193,436,
4848,3247,242,199,441,
4849,3302,237,207,444,
4850,3188,213,187,400,
4851,3338,223,199,422,
4852,3220,220,178,398,
4853,2546,184,143,327,
4855,3199,202,197,399,
4856,3278,226,195,421,
4857,3228,241,189,430,
4858,3234,227,187,414,
4859,3213,214,176,390,
4860,3181,230,174,404,
4861,3199,219,171,390,
4862,3234,205,151,356,
4863,3287,260,174,434,
4864,3320,229,206,435,
4865,3271,229,163,392,
4866,3118,214,198,412,
4867,3285,280,172,452,
4868,3356,256,166,422,
4869,2675,215,151,366,
4870,3209,221,203,424,
4871,3184,211,161,372,
4872,3194,253,181,434,
4873,3180,257,193,450,
4874,3185,210,177,387,
4875,3277,263,198,461,
4877,2561,189,152,341,
4878,3138,231,169,400,
4879,3214,235,180,415,
4880,3155,204,178,382,
4881,3283,257,184,441,
4882,3145,222,193,415,
4883,3276,224,180,404,
4885,3231,250,181,431,
4887,3074,215,170,385,
4888,3194,237,175,412,
4889,3212,247,194,441,
4890,3266,239,178,417,
4891,3354,267,187,454,
4892,2797,186,154,340,
4893,3235,224,176,400,
4894,3209,239,164,403,
4895,3315,260,193,453,
4897,3215,199,183,382,
4898,3197,228,180,408,
4900,3222,235,171,406,
4901,3151,231,197,428,
4902,3219,221,189,410,
4903,431,31,17,48,
4904,3210,229,212,441,
4905,3233,233,173,406,
4906,330,24,22,46,
4907,3182,243,178,421,
4909,3251,205,188,393,
4910,341,25,22,47,
4911,3185,223,187,410,
4913,3178,207,148,355,
4914,3208,255,189,444,
4916,3167,236,190,426,
4917,3428,260,196,456,
4918,3253,222,188,410,
4919,3231,244,190,434,
4920,3134,231,157,388,
4921,29,2,1,3,
4922,3217,220,195,415,
4923,3147,221,193,414,
4924,3205,229,191,420,
4925,3200,226,159,385,
4926,3286,244,180,424,
4927,3312,255,171,426,
4928,3309,226,227,453,
4929,3262,256,180,436,
4930,3190,229,174,403,
4931,3319,249,193,442,
4932,3218,243,179,422,
4934,3193,253,172,425,
4935,3130,209,181,390,
4936,3178,227,166,393,
4937,3154,228,200,428,
4938,3164,227,177,404,
4939,3207,249,178,427,
4940,3140,202,191,393,
4941,3017,216,182,398,
4942,3232,242,190,432,
4943,3194,218,169,387,
4944,3222,226,173,399,
4945,3151,218,180,398,
4946,3154,228,164,392,
4947,3232,243,170,413,
4949,3248,228,169,397,
4950,3310,246,195,441,
4951,3054,193,180,373,
4952,3144,230,170,400,
4953,3189,224,179,403,
4954,3235,223,171,394,
4955,3191,210,178,388,
4957,3231,237,170,407,
4958,3174,230,186,416,
4959,3197,239,170,409,
4960,3079,228,163,391,
4961,3190,225,192,417,
4962,3259,225,180,405,
4963,3289,235,207,442,
4965,3222,241,192,433,
4966,3182,222,185,407,
4967,3205,240,188,428,
4968,3078,235,191,426,
4969,3107,245,160,405,
4970,3153,212,180,392,
4971,3244,239,175,414,
4972,3143,247,163,410,
4973,3229,224,203,427,
4974,3265,261,187,448,
4976,3294,249,180,429,
4977,3187,231,186,417,
4978,3234,235,182,417,
4979,3200,239,187,426,
4980,3070,197,172,369,
4981,3204,220,167,387,
4982,3220,220,207,427,
4984,3063,226,150,376,
4986,55,6,5,11,
4987,655,54,50,104,
4989,3235,253,190,443,
4990,3140,206,196,402,
4991,3138,239,161,400,
4992,3174,221,185,406,
4993,3061,247,192,439,
4994,3286,236,179,415,
4995,3381,248,206,454,
4996,3048,225,171,396,
4997,3290,234,183,417,
4998,3107,254,176,430,
4999,3179,243,205,448,
5000,3224,236,167,403,
5001,3237,223,179,402,
5002,3255,236,181,417,
5004,3175,217,182,399,
5005,3227,236,193,429,
5006,3166,192,192,384,
5007,3226,211,200,411,
5008,3252,221,199,420,
5009,3193,215,186,401,
5010,3138,243,172,415,
5011,3207,215,154,369,
5012,349,29,20,49,
5014,3258,250,177,427,
5015,3284,240,168,408,
5016,3368,257,180,437,
5017,3087,224,162,386,
5018,3140,237,193,430,
5019,3211,235,196,431,
5020,3310,235,193,428,
5022,3264,208,195,403,
5023,3242,208,177,385,
5024,3268,250,181,431,
5025,3188,245,175,420,
5026,3180,219,184,403,
5027,3093,237,190,427,
5028,3245,233,171,404,
5029,3039,215,150,365,
5030,3206,214,162,376,
5031,3110,232,178,410,
5032,3198,256,187,443,
5033,3382,237,192,429,
5034,3185,206,221,427,
5035,3241,248,180,428,
5036,3132,231,190,421,
5037,3214,244,198,442,
5038,3183,243,185,428,
5039,3171,257,175,432,
5040,3214,226,190,416,
5041,2651,195,165,360,
5042,3128,219,151,370,
5043,3232,234,195,429,
5044,3223,229,167,396,
5045,3223,221,179,400,
5048,3165,256,160,416,
5049,3244,254,177,431,
5050,3189,241,162,403,
5051,393,25,22,47,
5052,3254,247,166,413,
5053,2631,184,164,348,
5054,3182,246,177,423,
5055,3178,250,173,423,
5057,3326,224,195,419,
5058,3248,209,217,426,
5059,3250,263,194,457,
5060,3240,227,194,421,
5061,3155,214,189,403,
5062,3227,266,197,463,
5063,73,5,1,6,
5064,3196,216,193,409,
5065,3316,230,166,396,
5066,3231,234,217,451,
5067,3210,225,173,398,
5068,3241,248,188,436,
5069,3114,245,169,414,
5070,3243,258,189,447,
5071,3307,228,237,465,
5072,3231,236,166,402,
5073,3261,231,196,427,
5074,3325,232,178,410,
5075,3284,273,173,446,
5076,2621,179,141,320,
5077,3203,259,180,439,
5078,3153,223,153,376,
5079,3092,215,191,406,
5080,3152,213,181,394,
5081,3226,239,184,423,
5082,3301,245,188,433,
5084,3249,236,161,397,
5086,3238,230,204,434,
5087,3186,224,174,398,
5088,3124,238,182,420,
5089,3301,250,196,446,
5090,3232,220,177,397,
5091,3274,230,188,418,
5092,3231,254,184,438,
5093,3278,238,163,401,
5094,3108,223,176,399,
5095,57,6,3,9,
5096,3318,242,186,428,
5097,549,45,30,75,
5098,150,6,10,16,
5100,3215,237,189,426,
5101,3209,246,171,417,
5102,3258,239,190,429,
5103,3161,227,199,426,
5104,3140,227,193,420,
5105,3150,214,181,395,
5106,3258,231,173,404,
5107,3290,267,167,434,
5108,3180,232,181,413,
5111,3162,219,180,399,
5113,3275,239,168,407,
5114,3249,238,187,425,
5115,2807,212,167,379,
5116,3274,243,166,409,
5118,3214,222,187,409,
5119,3196,227,178,405,
5121,3111,216,178,394,
5126,2603,190,149,339,
5127,3200,233,172,405,
5128,3342,229,197,426,
5129,3338,227,190,417,
5130,3267,243,179,422,
5131,3234,253,182,435,
5132,3199,226,163,389,
5133,3177,234,154,388,
5135,3093,244,178,422,
5136,3168,233,185,418,
5137,3261,243,192,435,
5138,3224,240,174,414,
5139,3238,247,205,452,
5140,3263,213,182,395,
5141,50,4,4,8,
5142,3162,227,200,427,
5144,3106,204,202,406,
5145,2817,225,171,396,
5146,3097,234,170,404,
5147,3219,254,183,437,
5148,3312,256,201,457,
5149,192,14,7,21,
5150,3209,217,199,416,
5151,3222,244,167,411,
5152,3194,224,204,428,
5155,3024,226,165,391,
5156,3223,205,187,392,
5157,3362,263,201,464,
5160,3266,208,185,393,
5161,3188,245,179,424,
5162,3278,233,181,414,
5163,3116,224,183,407,
5165,3068,212,196,408,
5166,3270,226,195,421,
5167,3156,216,184,400,
5168,3289,230,166,396,
5170,3208,210,200,410,
5171,3261,234,176,410,
5172,3180,236,159,395,
5173,3296,253,187,440,
5174,3296,251,220,471,
5175,3231,231,189,420,
5176,3188,255,177,432,
5177,3093,247,151,398,
5178,3263,227,180,407,
5179,3226,217,178,395,
5180,3156,230,193,423,
5181,3236,247,186,433,
5182,3185,227,199,426,
5183,3166,211,185,396,
5184,1231,90,83,173,
5185,3346,226,195,421,
5186,3218,235,179,414,
5188,3119,230,193,423,
5189,3198,223,189,412,
5190,3293,267,179,446,
5191,3257,245,170,415,
5192,3190,241,164,405,
5193,3078,216,163,379,
5196,3259,240,184,424,
5197,3249,198,190,388,
5198,284,26,12,38,
5199,3264,266,188,454,
5200,3265,226,187,413,
5201,3233,233,176,409,
5203,3358,209,210,419,
5204,3160,207,197,404,
5205,3267,213,204,417,
5206,3156,215,194,409,
5207,3314,212,183,395,
5208,3282,227,188,415,
5209,3223,230,184,414,
5210,3143,230,164,394,
5211,3202,235,183,418,
5212,626,53,36,89,
5213,3214,241,169,410,
5214,3158,248,156,404,
5215,3300,233,181,414,
5216,161,13,8,21,
5217,3234,223,172,395,
5218,245,13,13,26,
5219,3226,243,156,399,
5220,3218,238,209,447,
5223,3244,233,203,436,
5224,3162,236,175,411,
5225,3148,262,178,440,
5226,3203,222,186,408,
5227,3223,234,179,413,
5228,3095,229,178,407,
5229,656,57,32,89,
5230,3074,222,181,403,
5231,3214,236,182,418,
5232,3314,227,203,430,
5233,3229,230,181,411,
5234,3180,213,194,407,
5236,3230,216,196,412,
5237,3090,242,176,418,
5239,3377,247,158,405,
5240,3245,232,188,420,
5241,3092,192,189,381,
5243,3245,244,173,417,
5244,3203,240,174,414,
5245,3353,222,185,407,
5246,3159,200,167,367,
5247,3166,242,190,432,
5248,3280,260,202,462,
5249,3234,225,160,385,
5250,3208,236,186,422,
5251,531,44,25,69,
5252,3191,229,210,439,
5253,3152,238,169,407,
5255,3161,250,177,427,
5256,3199,244,180,424,
5257,3344,242,190,432,
5258,3146,235,186,421,
5259,3314,237,189,426,
5260,3132,223,182,405,
5262,250,12,19,31,
5263,3190,245,169,414,
5264,3196,221,192,413,
5265,3268,224,184,408,
5266,3245,230,191,421,
5267,3312,233,178,411,
5268,3194,223,193,416,
5269,3189,238,187,425,
5270,3074,222,165,387,
5271,3187,214,188,402,
5272,3125,210,181,391,
5273,3212,215,203,418,
5274,3284,254,200,454,
5275,3223,257,187,444,
5276,33,1,1,2,
5277,3158,236,162,398,
5278,3213,250,187,437,
5279,3152,181,203,384,
5280,3213,233,173,406,
5281,55,4,3,7,
5282,3267,244,177,421,
5284,3324,241,200,441,
5285,3075,218,186,404,
5286,3182,221,169,390,
5287,3117,231,181,412,
5288,3235,216,187,403,
5289,3283,234,185,419,
5290,3356,266,203,469,
5291,3193,222,172,394,
5292,3270,239,180,419,
5293,3214,244,196,440,
5294,3154,238,203,441,
5295,3180,269,173,442,
5297,3186,236,192,428,
5298,3221,244,177,421,
5299,3183,240,167,407,
5300,3203,244,197,441,
5301,3191,220,186,406,
5302,3088,226,188,414,
5303,3099,214,163,377,
5304,2719,209,152,361,
5305,3227,233,182,415,
5306,3216,220,200,420,
5307,3181,274,145,419,
5308,3277,210,193,403,
5309,3174,210,191,401,
5310,3124,218,169,387,
5312,3172,232,183,415,
5313,3288,226,181,407,
5314,3100,207,158,365,
5315,3236,243,168,411,
5316,3175,217,217,434,
5317,3258,262,169,431,
5318,3213,275,159,434,
5319,3299,241,209,450,
5320,3230,222,181,403,
5321,3170,234,181,415,
5322,3166,232,182,414,
5323,3266,249,181,430,
5324,3163,257,160,417,
5325,3090,223,197,420,
5326,3159,235,175,410,
5327,323,22,21,43,
5328,3190,246,189,435,
5329,226,19,13,32,
5330,3155,222,162,384,
5331,3281,251,166,417,
5332,3257,268,193,461,
5333,3194,263,193,456,
5334,3270,218,176,394,
5335,3232,245,172,417,
5336,3344,232,196,428,
5337,3285,233,168,401,
5338,3225,231,184,415,
5339,3088,242,163,405,
5340,3401,248,177,425,
5341,3202,215,186,401,
5342,3324,240,216,456,
5343,3216,261,170,431,
5344,3180,223,193,416,
5345,3205,267,183,450,
5346,3183,239,168,407,
5347,3266,233,189,422,
5348,3091,218,200,418,
5349,332,21,24,45,
5350,3288,239,179,418,
5351,3196,245,145,390,
5352,3225,256,177,433,
5353,3285,259,175,434,
5354,3268,242,191,433,
5356,3334,222,192,414,
5357,3256,225,164,389,
5358,3145,235,174,409,
5359,3284,253,174,427,
5360,3165,229,204,433,
5361,3138,242,181,423,
5362,3229,249,152,401,
5363,3254,246,175,421,
5364,3221,241,189,430,
5365,3170,246,174,420,
5366,3323,246,215,461,
5367,3272,233,199,432,
5368,3277,255,183,438,
5370,3228,228,162,390,
5371,3095,210,168,378,
5372,3201,248,184,432,
5373,3195,261,203,464,
5374,3217,242,195,437,
5375,3236,241,180,421,
5376,3217,260,196,456,
5377,3227,232,205,437,
5378,3146,234,190,424,
5379,3130,248,182,430,
5380,3215,229,164,393,
5381,3238,244,167,411,
5382,3125,233,151,384,
5383,3229,241,172,413,
5384,3366,218,195,413,
5385,3263,276,174,450,
5386,3063,243,187,430,
5387,3295,263,180,443,
5388,3327,234,199,433,
5389,3278,212,188,400,
5390,3219,214,173,387,
5391,3229,245,195,440,
5392,3174,208,167,375,
5393,3289,245,163,408,
5394,3222,256,191,447,
5395,3231,224,184,408,
5396,3307,241,189,430,
5397,3320,263,167,430,
5398,3055,207,164,371,
5399,3250,249,200,449,
5400,2687,183,164,347,
5401,3253,241,171,412,
5402,3289,228,195,423,
5404,3146,215,189,404,
5406,3264,209,203,412,
5407,3310,256,171,427,
5408,3144,245,180,425,
5409,3309,260,206,466,
5411,3250,266,184,450,
5412,3195,228,183,411,
5413,3137,226,158,384,
5414,548,36,30,66,
5415,3069,231,182,413,
5416,2523,216,117,333,
5418,3202,203,192,395,
5419,3134,224,154,378,
5420,3160,225,174,399,
5422,3138,208,194,402,
5423,3228,259,170,429,
5424,3170,231,200,431,
5425,3037,227,180,407,
5426,3259,266,184,450,
5427,3150,244,174,418,
5428,3185,211,167,378,
5429,2543,163,149,312,
5430,3245,253,181,434,
5431,3139,216,173,389,
5432,3097,224,203,427,
5433,2680,191,159,350,
5434,166,12,9,21,
5435,3164,228,170,398,
5436,3223,246,162,408,
5437,3111,189,203,392,
5438,3200,241,175,416,
5439,3267,221,182,403,
5440,3208,226,168,394,
5441,3172,218,191,409,
5442,3176,230,207,437,
5443,3162,213,176,389,
5444,3134,222,185,407,
5445,3236,221,190,411,
5446,3094,222,179,401,
5448,3109,205,198,403,
5450,3179,241,183,424,
5452,3253,245,179,424,
5453,3258,234,192,426,
5454,3234,247,161,408,
5455,3223,231,181,412,
5456,3280,244,185,429,
5457,3166,240,188,428,
5458,2694,206,157,363,
5459,3244,257,200,457,
5460,3177,275,173,448,
5461,3135,258,202,460,
5462,3290,232,175,407,
5463,3175,232,193,425,
5465,3104,223,161,384,
5466,3108,210,157,367,
5467,3286,235,202,437,
5468,3164,216,185,401,
5469,3137,256,163,419,
5470,3274,233,186,419,
5471,3230,235,172,407,
5472,3195,230,183,413,
5473,3270,269,171,440,
5474,3131,213,198,411,
5476,3209,230,194,424,
5477,3261,245,210,455,
5479,3247,216,188,404,
5480,3220,222,233,455,
5481,3216,237,168,405,
5482,3250,227,174,401,
5483,3352,252,211,463,
5484,3157,237,181,418,
5486,3244,245,184,429,
5487,3218,234,190,424,
5488,3161,219,194,413,
5489,3147,221,176,397,
5490,3316,239,204,443,
5492,3139,215,182,397,
5493,3273,225,183,408,
5494,3332,256,166,422,
5495,3199,226,196,422,
5496,3329,232,225,457,
5497,3170,203,205,408,
5498,3241,243,179,422,
5499,3200,249,177,426,
5500,3217,241,181,422,
5501,3210,219,205,424,
5503,53,6,7,13,
5504,3206,215,176,391,
5505,3380,248,207,455,
5507,3068,241,177,418,
5508,3174,237,184,421,
5509,3301,237,194,431,
5510,3055,231,160,391,
5511,3212,229,191,420,
5512,3312,227,203,430,
5513,2610,169,158,327,
5514,3240,225,197,422,
5515,3191,247,181,428,
5516,3275,248,186,434,
5517,3345,235,208,443,
5518,3186,213,189,402,
5519,3166,223,192,415,
5520,3154,241,182,423,
5521,3272,236,169,405,
5522,3222,236,183,419,
5523,3207,227,172,399,
5525,3340,235,181,416,
5526,3172,253,166,419,
5527,3222,242,169,411,
5528,3160,239,165,404,
5529,3265,245,159,404,
5530,3219,241,178,419,
5531,3133,199,179,378,
5534,3198,208,192,400,
5535,3220,248,181,429,
5536,3248,242,210,452,
5537,3165,228,200,428,
5539,3291,254,173,427,
5540,3171,224,198,422,
5541,3119,202,210,412,
5542,3113,228,172,400,
5543,3282,247,200,447,
5545,2771,199,156,355,
5546,3213,243,192,435,
5547,3253,239,170,409,
5548,3211,238,193,431,
5549,3318,255,213,468,
5550,3241,259,183,442,
5551,35,2,4,6,
5552,3179,237,181,418,
5553,3170,230,159,389,
5554,3243,240,181,421,
5555,3243,226,201,427,
5556,3247,270,180,450,
5557,3283,215,201,416,
5558,3198,214,217,431,
5559,3195,228,179,407,
5560,3354,257,170,427,
5561,3227,244,171,415,
5562,3246,242,190,432,
5563,3104,230,180,410,
5564,3014,212,173,385,
5565,3243,213,190,403,
5566,3227,232,206,438,
5567,3266,244,173,417,
5568,3252,231,180,411,
5569,3284,214,183,397,
5570,3272,230,181,411,
5571,3245,235,186,421,
5572,3193,215,181,396,
5573,3177,226,180,406,
5574,232,16,18,34,
5575,3198,244,175,419,
5576,3065,232,169,401,
5577,3235,214,198,412,
5578,3232,214,170,384,
5579,3283,230,210,440,
5580,3183,215,194,409,
5581,2669,180,148,328,
5582,3118,236,197,433,
5583,3093,216,179,395,
5584,46,3,1,4,
5585,3181,233,172,405,
5586,3259,204,207,411,
5587,3286,222,197,419,
5588,3126,268,163,431,
5589,3175,216,181,397,
5590,3254,239,191,430,
5591,3075,218,164,382,
5592,3226,231,161,392,
5593,3038,199,153,352,
5594,53,4,4,8,
5595,3239,252,186,438,
5596,3098,234,179,413,
5597,3204,248,200,448,
5598,3270,232,196,428,
5599,3312,213,196,409,
5600,3339,247,165,412,
5602,3153,244,164,408,
5603,3295,256,187,443,
5604,3183,248,177,425,
5605,3115,205,170,375,
5606,3192,238,169,407,
5607,301,19,8,27,
5608,3336,250,189,439,
5609,3082,223,178,401,
5610,3233,220,183,403,
5611,3236,253,163,416,
5612,3376,261,192,453,
5613,3233,244,186,430,
5614,3184,227,201,428,
5615,3205,230,182,412,
5616,3239,237,177,414,
5617,3226,226,196,422,
5618,3263,251,169,420,
5619,3255,243,191,434,
5620,3094,231,171,402,
5621,3256,238,182,420,
5622,3231,248,189,437,
5623,3207,217,164,381,
5624,3137,225,157,382,
5625,64,7,3,10,
5626,156,14,7,21,
5627,3219,217,181,398,
5629,3294,237,183,420,
5630,3235,256,182,438,
5631,3100,240,182,422,
5632,3165,240,179,419,
5633,3307,209,194,403,
5634,400,20,24,44,
5635,3262,224,217,441,
5636,3273,227,190,417,
5637,3325,245,180,425,
5638,3245,212,173,385,
5639,479,35,31,66,
5640,3237,233,183,416,
5641,3153,211,173,384,
5643,3183,250,179,429,
5644,3177,224,193,417,
5645,3268,242,185,427,
5646,3154,233,163,396,
5648,3283,263,176,439,
5649,3169,218,174,392,
5650,3218,227,174,401,
5651,3199,240,193,433,
5652,3135,255,185,440,
5653,3248,244,166,410,
5654,3180,253,186,439,
5655,3233,239,200,439,
5656,3266,261,181,442,
5657,3210,220,179,399,
5658,3217,238,172,410,
5659,3298,262,181,443,
5660,3246,252,177,429,
5661,3225,261,195,456,
5662,3234,237,167,404,
5663,3275,231,173,404,
5664,3234,205,175,380,
5665,3163,232,164,396,
5666,3164,246,201,447,
5667,3208,204,183,387,
5668,3167,230,198,428,
5669,3243,227,206,433,
5670,3163,212,182,394,
5671,3082,223,192,415,
5672,3175,215,186,401,
5673,3206,252,186,438,
5674,3281,240,195,435,
5675,3140,217,180,397,
5676,3167,235,201,436,
5677,3169,228,183,411,
5678,3202,211,193,404,
5679,3297,227,192,419,
5680,3142,208,182,390,
5681,3181,221,172,393,
5683,3324,254,197,451,
5684,3281,224,197,421,
5685,3218,230,150,380,
5686,3081,228,176,404,
5687,3185,228,201,429,
5688,3166,235,173,408,
5689,3252,258,179,437,
5690,3285,232,191,423,
5691,3266,213,184,397,
5692,563,45,30,75,
5693,3246,266,193,459,
5694,3153,233,191,424,
5695,3207,266,171,437,
5696,3055,205,208,413,
5697,3120,226,154,380,
5698,3100,204,159,363,
5699,3228,230,182,412,
5700,3056,234,200,434,
5702,3126,212,176,388,
5704,3222,241,179,420,
5705,3223,245,178,423,
5706,295,19,14,33,
5707,3304,249,192,441,
5708,3238,238,176,414,
5710,3216,242,179,421,
5711,3190,239,183,422,
5712,3173,231,182,413,
5714,3091,241,163,404,
5715,3128,246,172,418,
5716,3169,222,191,413,
5718,3224,238,169,407,
5719,3128,228,177,405,
5720,3207,224,164,388,
5721,3352,231,203,434,
5722,3273,254,171,425,
5723,3243,245,210,455,
5724,3199,225,163,388,
5725,3180,200,174,374,
5726,3257,236,181,417,
5727,3148,225,172,397,
5728,3296,241,165,406,
5729,3295,271,187,458,
5731,3301,249,185,434,
5732,3227,236,184,420,
5733,146,9,4,13,
5734,3216,260,175,435,
5735,3113,224,166,390,
5736,3195,216,166,382,
5737,14,2,2,4,
5738,3169,226,166,392,
5740,3127,217,190,407,
5741,3281,214,226,440,
5742,3218,226,175,401,
5743,3256,258,213,471,
5744,3150,254,183,437,
5745,3185,233,191,424,
5746,3254,258,188,446,
5747,3177,221,170,391,
5748,3285,221,179,400,
5750,3236,215,192,407,
5751,3265,238,199,437,
5752,3289,234,187,421,
5753,3207,236,186,422,
5754,3169,238,180,418,
5755,3242,239,185,424,
5756,3275,207,196,403,
5758,3157,238,160,398,
5759,3255,239,181,420,
5760,3240,229,153,382,
5761,3188,230,166,396,
5762,442,34,28,62,
5763,3333,230,182,412,
5764,3278,202,210,412,
5765,3236,228,182,410,
5766,3281,231,187,418,
5767,3318,242,190,432,
5768,3297,253,189,442,
5769,3228,215,198,413,
5771,3260,242,199,441,
5772,3262,249,184,433,
5773,3218,246,174,420,
5774,3266,235,201,436,
5775,3310,245,215,460,
5776,3224,213,184,397,
5777,23,1,1,2,
5778,3146,224,187,411,
5779,3185,229,181,410,
5780,3216,241,175,416,
5781,3232,230,203,433,
5782,2698,208,126,334,
5783,3084,228,175,403,
5784,3143,194,185,379,
5785,3152,227,163,390,
5786,3202,239,181,420,
5787,3172,228,182,410,
5788,3240,206,189,395,
5789,3292,221,174,395,
5790,3218,260,190,450,
5791,3297,258,167,425,
5792,3279,240,189,429,
5793,3244,237,177,414,
5794,3277,226,171,397,
5795,3315,221,194,415,
5796,3257,219,182,401,
5797,3241,225,167,392,
5798,3251,237,163,400,
5799,3199,212,177,389,
5800,3138,231,154,385,
5801,3237,229,200,429,
5802,3226,220,177,397,
5803,3264,218,186,404,
5804,3196,223,194,417,
5805,3188,264,185,449,
5806,3228,231,185,416,
5807,3288,240,194,434,
5808,3232,249,157,406,
5809,3153,192,187,379,
5810,3308,237,190,427,
5811,3136,210,193,403,
5812,3136,220,180,400,
5813,3143,224,177,401,
5814,3230,226,199,425,
5815,3218,234,179,413,
5816,3246,268,179,447,
5817,3265,209,189,398,
5818,3213,237,179,416,
5819,3232,208,182,390,
5821,3170,213,179,392,
5822,3258,233,189,422,
5823,3278,245,172,417,
5824,3247,233,191,424,
5825,3209,247,167,414,
5826,240,18,9,27,
5827,3194,225,163,388,
5828,3242,229,193,422,
5829,3195,240,183,423,
5830,3197,214,163,377,
5831,147,15,9,24,
5832,3212,241,179,420,
5833,3280,249,205,454,
5834,3168,208,164,372,
5835,3160,215,191,406,
5836,3275,241,160,401,
5837,3225,301,181,482,
5838,3284,251,184,435,
5839,3334,242,191,433,
5840,3289,222,189,411,
5841,3225,209,161,370,
5842,3222,242,175,417,
5843,2664,193,150,343,
5844,3247,239,163,402,
5845,3212,229,182,411,
5846,3185,246,185,431,
5847,3253,242,176,418,
5848,3113,193,174,367,
5849,3205,211,213,424,
5850,3261,240,173,413,
5851,3102,255,147,402,
5852,3233,233,192,425,
5853,3100,194,174,368,
5854,3219,258,195,453,
5855,3249,266,183,449,
5856,3177,224,181,405,
5857,3253,253,192,445,
5858,3368,239,202,441,
5859,3241,249,210,459,
5860,3178,250,167,417,
5861,3081,234,184,418,
5862,3178,229,183,412,
5863,3173,234,180,414,
5864,3136,221,173,394,
5866,3293,254,209,463,
5867,3262,265,184,449,
5868,3212,244,184,428,
5869,3208,234,183,417,
5870,3266,228,223,451,
5871,3196,222,176,398,
5872,3256,222,169,391,
5873,3320,256,197,453,
5874,3249,244,181,425,
5875,3207,211,188,399,
5877,3216,225,202,427,
5878,3214,228,201,429,
5879,618,27,35,62,
5880,3280,247,173,420,
5881,3235,219,191,410,
5882,3100,222,172,394,
5883,3238,233,166,399,
5884,782,51,45,96,
5886,3168,238,155,393,
5887,3171,244,190,434,
5888,3199,246,186,432,
5889,3252,220,173,393,
5890,3221,235,206,441,
5891,136,12,11,23,
5892,3317,255,203,458,
5895,3269,246,189,435,
5896,3195,242,171,413,
5897,3263,239,214,453,
5898,3220,268,169,437,
5899,3275,236,183,419,
5900,3227,233,188,421,
5901,2940,223,172,395,
5902,3170,231,182,413,
5903,3177,228,195,423,
5904,3162,214,194,408,
5905,3167,216,169,385,
5906,3072,199,178,377,
5907,3229,237,193,430,
5908,118,9,3,12,
5909,3298,233,198,431,
5910,3274,252,178,430,
5911,3162,228,180,408,
5912,3236,242,195,437,
5913,3314,266,177,443,
5914,3274,224,182,406,
5915,3030,181,175,356,
5916,228,20,9,29,
5917,506,43,34,77,
5919,3081,231,159,390,
5920,3292,253,185,438,
5921,3258,220,163,383,
5922,3157,219,160,379,
5923,3247,202,160,362,
5924,3167,225,173,398,
5925,3174,211,191,402,
5927,3156,254,162,416,
5928,3148,212,188,400,
5929,3133,219,203,422,
5930,3222,258,179,437,
5931,3312,246,185,431,
5932,3202,222,155,377,
5933,3232,228,196,424,
5934,3296,239,175,414,
5935,3171,230,188,418,
5936,3349,239,198,437,
5937,3232,237,189,426,
5938,3146,228,180,408,
5939,3104,216,183,399,
5941,3264,243,158,401,
5942,3219,229,182,411,
5943,3260,234,178,412,
5944,3134,228,197,425,
5946,3237,226,195,421,
5947,3145,249,155,404,
5948,3269,231,183,414,
5949,3224,251,176,427,
5950,3182,231,190,421,
5951,3175,242,188,430,
5952,3332,232,187,419,
5953,3229,231,188,419,
5954,3274,211,203,414,
5955,3152,225,170,395,
5956,3203,247,188,435,
5957,3136,220,206,426,
5958,3171,243,162,405,
5959,3284,244,192,436,
5960,3197,215,177,392,
5961,3289,248,176,424,
5962,3205,215,175,390,
5963,3136,267,178,445,
5964,3272,257,175,432,
5966,3273,219,198,417,
5967,88,6,6,12,
5968,3155,224,152,376,
5969,3199,231,173,404,
5970,3172,237,168,405,
5971,3093,220,174,394,
5972,3256,249,162,411,
5973,3176,231,184,415,
5974,3227,228,177,405,
5975,3358,234,196,430,
5976,3128,217,190,407,
5977,3263,230,221,451,
5978,3066,188,206,394,
5979,3190,222,188,410,
5980,3219,251,188,439,
5981,3198,252,205,457,
5982,3172,235,173,408,
5983,3168,256,198,454,
5984,3297,228,187,415,
5985,3209,225,204,429,
5986,3252,245,192,437,
5987,3189,243,178,421,
5988,3272,233,194,427,
5989,3218,241,184,425,
5990,3240,206,188,394,
5991,3255,215,202,417,
5992,3279,241,197,438,
5993,223,19,15,34,
5994,3160,238,182,420,
5996,3296,285,172,457,
5998,3295,234,201,435,
5999,3128,214,175,389,
6000,3340,238,196,434,
6001,3133,228,179,407,
6002,3269,275,201,476,
6003,3218,240,171,411,
6004,3195,242,197,439,
6005,3018,226,174,400,
6006,3275,241,176,417,
6007,3312,228,179,407,
6008,3245,220,193,413,
6009,3205,217,185,402,
6011,3118,216,168,384,
6012,3200,229,169,398,
6013,3151,230,194,424,
6014,3236,214,171,385,
6015,3195,235,193,428,
6016,3152,223,147,370,
6017,3113,245,153,398,
6018,3246,235,173,408,
6019,3192,205,205,410,
6020,3288,225,190,415,
6021,3212,265,175,440,
6022,3239,224,176,400,
6023,3180,239,169,408,
6024,3301,231,173,404,
6025,3260,248,201,449,
6026,3263,206,188,394,
6028,3190,214,180,394,
6029,3171,239,182,421,
6030,3246,242,198,440,
6031,3192,240,185,425,
6032,3252,236,189,425,
6033,294,18,19,37,
6034,3168,241,188,429,
6035,3149,222,195,417,
6036,3136,238,160,398,
6037,3169,236,165,401,
6038,3274,242,193,435,
6039,3295,248,169,417,
6040,3285,220,167,387,
6041,3340,253,179,432,
6042,3221,209,179,388,
6043,3233,227,188,415,
6044,3212,240,188,428,
6046,3193,263,184,447,
6047,3164,218,171,389,
6048,3377,250,180,430,
6049,3074,242,165,407,
6050,3113,250,196,446,
6051,188,7,7,14,
6052,3244,234,186,420,
6053,3137,250,172,422,
6055,3155,210,186,396,
6056,3094,224,172,396,
6057,2759,204,162,366,
6058,3179,258,162,420,
6059,3092,221,160,381,
6060,3346,252,210,462,
6061,3135,253,164,417,
6062,3245,241,169,410,
6063,3197,230,170,400,
6064,3246,222,177,399,
6065,3276,240,185,425,
6067,3233,247,159,406,
6068,3261,211,170,381,
6069,2661,173,165,338,
6070,3263,239,204,443,
6071,3336,237,205,442,
6072,3285,236,174,410,
6073,3314,244,163,407,
6074,3204,230,190,420,
6076,3205,225,196,421,
6077,2788,211,160,371,
6078,3216,227,160,387,
6079,3259,245,176,421,
6080,3135,253,195,448,
6081,3132,214,190,404,
6082,3182,228,199,427,
6083,3240,255,173,428,
6084,3229,226,188,414,
6085,3132,238,186,424,
6086,3247,220,190,410,
6087,3167,219,176,395,
6089,3194,234,155,389,
6090,3170,259,151,410,
6091,70,11,5,16,
6092,3205,221,187,408,
6093,3175,215,169,384,
6094,3152,242,186,428,
6096,3288,237,204,441,
6097,3204,216,192,408,
6098,3285,234,172,406,
6099,3228,230,172,402,
6100,3205,224,173,397,
6101,3223,233,176,409,
6102,3349,250,185,435,
6103,3268,233,192,425,
6104,3269,236,182,418,
6105,3179,238,176,414,
6106,3231,201,195,396,
6107,3191,257,166,423,
6108,3220,241,180,421,
6109,3267,237,148,385,
6110,3221,241,172,413,
6111,3297,226,197,423,
6112,441,29,18,47,
6113,3292,262,191,453,
6114,3236,221,176,397,
6115,3213,227,177,404,
6116,3234,226,204,430,
6117,2712,202,151,353,
6118,3133,216,176,392,
6119,3281,261,175,436,
6121,3113,249,195,444,
6122,3157,209,188,397,
6123,3242,236,192,428,
6124,3162,226,201,427,
6125,3267,247,170,417,
6126,3279,219,167,386,
6127,3213,210,185,395,
6128,3288,247,171,418,
6129,597,43,42,85,
6130,3148,255,188,443,
6131,3243,226,161,387,
6132,3112,231,190,421,
6133,3173,229,188,417,
6134,3250,249,151,400,
6135,2488,168,134,302,
6136,3315,254,203,457,
6137,3186,231,161,392,
6138,3161,238,193,431,
6139,2610,177,171,348,
6140,3160,196,182,378,
6141,159,12,12,24,
6142,3262,231,167,398,
6143,3226,252,182,434,
6144,3139,216,181,397,
6145,3265,240,179,419,
6146,3271,249,176,425,
6148,526,41,36,77,
6149,3098,242,166,408,
6150,3208,249,172,421,
6151,3202,251,184,435,
6152,3296,257,185,442,
6153,3321,238,207,445,
6154,3255,240,194,434,
6155,3235,269,199,468,
6156,3171,233,191,424,
6157,3110,223,178,401,
6158,3196,238,145,383,
6159,3255,234,157,391,
6160,3196,220,176,396,
6162,36,2,3,5,
6163,2252,156,138,294,
6164,3305,256,171,427,
6165,3218,227,170,397,
6166,3254,230,187,417,
6167,3349,261,174,435,
6168,3114,228,180,408,
6170,3246,217,152,369,
6171,3254,230,184,414,
6172,3251,229,195,424,
6173,3215,224,176,400,
6174,3148,225,173,398,
6175,3334,249,183,432,
6176,3298,265,182,447,
6177,3231,252,171,423,
6178,3216,238,171,409,
6179,3168,222,179,401,
6180,3053,205,167,372,
6181,3298,246,196,442,
6182,3071,216,167,383,
6184,3284,243,209,452,
6185,3173,206,169,375,
6186,378,29,32,61,
6187,3153,236,178,414,
6189,3241,218,195,413,
6190,3139,238,147,385,
6191,3320,235,181,416,
6192,2863,231,148,379,
6193,3255,245,173,418,
6195,3291,233,183,416,
6196,3334,257,196,453,
6197,3225,233,172,405,
6198,3261,249,182,431,
6199,253,19,14,33,
6200,3246,236,175,411,
6201,3224,232,190,422,
6202,113,7,10,17,
6203,3234,245,190,435,
6204,3364,235,192,427,
6205,3233,227,178,405,
6207,3228,258,166,424,
6208,3151,225,194,419,
6209,3191,236,200,436,
6210,2467,176,123,299,
6211,3228,237,188,425,
6212,3222,223,181,404,
6213,3188,237,172,409,
6214,3175,240,180,420,
6217,3209,214,207,421,
6218,3203,217,204,421,
6219,3268,245,150,395,
6220,3231,270,190,460,
6221,3306,243,184,427,
6222,3164,249,179,428,
6223,3322,266,180,446,
6224,3282,251,199,450,
6225,3191,233,190,423,
6226,3246,212,183,395,
6227,2641,189,127,316,
6228,3221,225,168,393,
6229,3134,243,207,450,
6230,3054,229,168,397,
6231,3331,252,179,431,
6232,3306,226,197,423,
6233,3137,229,176,405,
6234,3221,224,176,400,
6235,3248,266,177,443,
6236,3184,211,177,388,
6237,3287,232,200,432,
6238,3086,215,193,408,
6239,3286,245,203,448,
6240,3183,236,180,416,
6241,3281,253,167,420,
6243,3133,253,171,424,
6244,3240,233,194,427,
6245,3193,246,181,427,
6246,3261,244,192,436,
6247,3301,266,174,440,
6248,3130,230,178,408,
6249,3167,259,154,413,
6250,3075,212,168,380,
6252,3123,216,189,405,
6253,3132,207,180,387,
6254,3235,242,174,416,
6255,3275,234,200,434,
6256,3137,241,187,428,
6257,3335,257,198,455,
6258,3299,254,195,449,
6259,3213,236,182,418,
6260,3211,223,192,415,
6261,3245,244,177,421,
6262,3196,241,182,423,
6263,3270,221,221,442,
6264,3220,224,170,394,
6265,3316,246,166,412,
6266,3310,248,182,430,
6267,3153,225,195,420,
6268,3131,216,176,392,
6269,3242,212,172,384,
6270,3217,232,178,410,
6271,3178,213,172,385,
6272,3265,228,181,409,
6273,3314,265,183,448,
6274,3181,230,182,412,
6275,3324,258,187,445,
6276,3246,241,185,426,
6277,3229,248,167,415,
6278,3138,225,183,408,
6279,3182,208,174,382,
6280,3154,250,162,412,
6281,356,19,21,40,
6282,3298,236,195,431,
6283,3137,244,165,409,
6284,3273,247,201,448,
6286,3114,219,164,383,
6287,3158,199,187,386,
6289,3208,204,176,380,
6290,3132,220,185,405,
6291,3255,234,158,392,
6292,3139,223,211,434,
6293,2621,197,150,347,
6294,3174,262,165,427,
6295,3185,232,191,423,
6296,3190,229,192,421,
6297,3328,233,184,417,
6298,3261,247,168,415,
6299,3205,209,183,392,
6300,3214,232,189,421,
6301,3094,237,171,408,
6302,3227,214,174,388,
6303,3167,207,180,387,
6304,3183,261,161,422,
6306,3223,242,185,427,
6307,3328,222,177,399,
6308,3163,274,147,421,
6309,3289,213,190,403,
6310,3240,234,176,410,
6311,3218,244,182,426,
6312,3149,227,184,411,
6313,3192,237,187,424,
6316,3258,218,179,397,
6317,3220,233,177,410,
6319,3272,263,164,427,
6320,3206,239,182,421,
6323,3295,219,186,405,
6324,3159,246,157,403,
6325,53,1,3,4,
6326,3249,210,190,400,
6327,3202,209,171,380,
6328,3201,236,162,398,
6329,3238,216,185,401,
6330,3176,220,200,420,
6332,3162,284,144,428,
6333,3240,194,190,384,
6334,3189,227,186,413,
6335,3249,250,169,419,
6336,3176,219,203,422,
6337,3273,232,181,413,
6338,3186,236,172,408,
6339,3272,242,192,434,
6340,3120,239,183,422,
6341,3245,232,198,430,
6342,3331,245,183,428,
6343,3212,242,176,418,
6344,3276,240,176,416,
6345,3227,226,193,419,
6346,3051,221,174,395,
6347,3091,229,178,407,
6348,3271,240,183,423,
6349,3226,228,196,424,
6350,3252,234,175,409,
6351,3158,238,186,424,
6352,3264,251,168,419,
6353,3161,228,166,394,
6354,3102,234,167,401,
6355,3258,212,168,380,
6356,3253,224,180,404,
6357,3191,228,192,420,
6358,3197,241,177,418,
6359,3324,240,209,449,
6360,3229,223,164,387,
6361,3300,267,182,449,
6362,3207,235,174,409,
6363,3181,221,163,384,
6364,3156,236,186,422,
6365,3229,242,179,421,
6366,3143,223,176,399,
6367,3257,262,156,418,
6368,3053,192,186,378,
6369,3210,226,170,396,
6370,3401,237,205,442,
6371,3221,212,191,403,
6372,3133,218,207,425,
6373,3246,232,190,422,
6374,3250,226,168,394,
6376,3178,212,208,420,
6377,3299,219,193,412,
6378,3395,200,204,404,
6379,3233,246,180,426,
6380,3223,235,190,425,
6381,3189,216,190,406,
6382,3264,226,181,407,
6384,3234,245,184,429,
6385,3209,242,161,403,
6386,3120,249,167,416,
6387,3244,238,172,410,
6388,3228,254,168,422,
6389,3279,229,181,410,
6390,3228,239,194,433,
6391,3336,241,189,430,
6392,3179,248,178,426,
6393,3164,236,178,414,
6394,3157,224,156,380,
6395,3340,237,193,430,
6396,3285,225,192,417,
6397,3255,239,194,433,
6399,2731,197,170,367,
6402,3245,265,170,435,
6403,3176,211,181,392,
6404,3219,229,194,423,
6405,3219,207,190,397,
6406,3137,219,148,367,
6407,3265,242,189,431,
6408,2624,176,173,349,
6409,2614,203,158,361,
6410,3056,215,177,392,
6411,3284,212,177,389,
6412,678,51,37,88,
6413,3193,219,157,376,
6414,3209,258,161,419,
6415,163,16,20,36,
6416,3334,226,187,413,
6418,3179,249,183,432,
6419,3108,270,183,453,
6420,3177,208,189,397,
6421,3060,216,173,389,
6422,3089,220,193,413,
6423,3279,208,202,410,
6424,3374,251,165,416,
6425,3132,210,165,375,
6428,2579,164,151,315,
6429,3163,203,185,388,
6430,3204,275,191,466,
6431,3292,247,179,426,
6432,3194,218,164,382,
6433,3170,235,185,420,
6434,3298,227,211,438,
6436,332,32,23,55,
6437,3181,247,170,417,
6438,3282,236,193,429,
6439,3113,246,150,396,
6440,3190,250,173,423,
6441,3294,251,180,431,
6442,3197,218,166,384,
6443,3269,252,181,433,
6444,3234,250,165,415,
6445,3173,238,179,417,
6446,3328,240,202,442,
6447,3246,217,198,415,
6448,3271,222,177,399,
6449,3198,276,198,474,
6450,3287,256,160,416,
6451,3143,247,169,416,
6452,3178,237,177,414,
6453,3312,241,190,431,
6454,3328,233,193,426,
6455,3225,215,171,386,
6456,3161,226,179,405,
6457,3154,231,166,397,
6458,3238,218,157,375,
6459,3090,229,135,364,
6460,134,11,6,17,
6461,151,16,6,22,
6462,3306,263,176,439,
6463,167,8,14,22,
6464,3245,222,185,407,
6465,3191,226,160,386,
6466,3146,236,172,408,
6468,3178,206,173,379,
6469,3081,228,168,396,
6471,3212,217,162,379,
6472,3264,242,190,432,
6473,3188,240,184,424,
6474,3268,228,182,410,
6475,3434,265,211,476,
6476,3280,231,198,429,
6477,3243,259,186,445,
6478,3337,253,207,460,
6479,3238,239,209,448,
6480,3346,242,205,447,
6482,3327,246,199,445,
6483,3142,240,169,409,
6484,3220,250,156,406,
6485,3302,240,194,434,
6486,3226,265,163,428,
6487,3253,252,176,428,
6488,3261,213,205,418,
6489,233,24,15,39,
6490,3302,250,187,437,
6491,3195,229,197,426,
6493,3200,209,208,417,
6494,3292,249,193,442,
6495,3233,246,186,432,
6496,3237,237,187,424,
6497,3324,251,176,427,
6498,3226,241,180,421,
6499,3188,220,199,419,
6500,447,37,24,61,
6501,3241,241,205,446,
6502,3108,220,163,383,
6503,3137,238,195,433,
6504,3294,226,186,412,
6505,3252,256,177,433,
6506,3181,233,194,427,
6507,3151,243,192,435,
6508,3334,233,200,433,
6509,3280,227,181,408,
6510,3180,226,166,392,
6511,3140,248,209,457,
6512,3058,224,168,392,
6514,3258,215,187,402,
6515,3291,208,172,380,
6516,3250,228,173,401,
6517,3158,241,190,431,
6518,3225,224,171,395,
6519,3214,258,188,446,
6520,3365,230,204,434,
6521,3187,262,177,439,
6523,3240,264,182,446,
6524,3190,228,171,399,
6525,3183,235,180,415,
6527,2536,157,143,300,
6528,3171,233,170,403,
6529,3132,246,148,394,
6530,3177,256,178,434,
6531,3210,257,173,430,
6533,3140,215,175,390,
6534,3259,230,173,403,
6535,3170,228,179,407,
6536,3218,233,173,406,
6537,3232,235,185,420,
6538,3258,230,165,395,
6539,3217,216,194,410,
6540,3166,234,150,384,
6541,3208,242,200,442,
6542,3220,230,170,400,
6543,3102,222,178,400,
6544,3227,230,172,402,
6545,99,5,4,9,
6546,3215,240,176,416,
6547,3227,247,167,414,
6548,3355,245,206,451,
6549,3078,233,165,398,
6550,3244,269,164,433,
6551,3153,239,184,423,
6552,3207,213,202,415,
6554,3270,210,178,388,
6555,3246,225,202,427,
6556,3232,242,205,447,
6557,3210,234,160,394,
6558,3255,227,188,415,
6559,2575,201,129,330,
6560,3083,242,172,414,
6562,3191,217,173,390,
6563,3214,233,165,398,
6565,3223,221,190,411,
6566,3277,256,191,447,
6567,3185,249,163,412,
6568,3159,249,183,432,
6570,3275,246,173,419,
6571,3264,258,187,445,
6573,3264,250,177,427,
6574,3251,214,187,401,
6575,3263,245,199,444,
6576,3209,214,187,401,
6577,3250,247,191,438,
6578,3154,224,201,425,
6579,3311,232,199,431,
6580,3209,215,213,428,
6581,3087,204,176,380,
6582,3154,225,181,406,
6584,3107,234,186,420,
6585,3352,250,181,431,
6587,3250,210,191,401,
6588,3238,210,180,390,
6589,3275,223,185,408,
6590,3192,217,175,392,
6591,3206,237,188,425,
6592,3310,236,189,425,
6593,3096,239,172,411,
6594,3262,236,170,406,
6595,3121,220,172,392,
6596,3199,214,195,409,
6597,3266,223,190,413,
6598,1045,78,66,144,
6599,324,23,22,45,
6600,3228,222,165,387,
6601,3242,251,183,434,
6603,3122,215,171,386,
6604,3214,258,180,438,
6605,3236,240,173,413,
6606,3202,257,180,437,
6607,3297,239,196,435,
6608,3273,221,193,414,
6609,3311,236,189,425,
6610,3219,238,174,412,
6611,3228,235,134,369,
6612,3249,234,195,429,
6613,3239,218,193,411,
6614,3282,237,194,431,
6615,3266,237,190,427,
6616,3073,248,165,413,
6617,411,23,25,48,
6618,3321,229,181,410,
6619,3144,250,160,410,
6620,3235,237,195,432,
6621,3287,243,168,411,
6622,3221,247,190,437,
6623,3179,243,191,434,
6624,3254,241,188,429,
6625,3138,216,174,390,
6626,3297,241,166,407,
6627,3396,240,176,416,
6628,3178,236,170,406,
6629,3203,210,199,409,
6630,3212,229,178,407,
6632,3261,237,198,435,
6633,3233,245,186,431,
6634,3252,220,194,414,
6635,3194,217,154,371,
6636,3178,207,160,367,
6637,3367,258,182,440,
6638,3261,231,197,428,
6639,3298,229,192,421,
6641,3287,247,190,437,
6643,3119,219,162,381,
6645,268,18,15,33,
6646,3286,237,182,419,
6647,3264,246,196,442,
6648,3292,254,175,429,
6649,3270,262,199,461,
6650,3275,237,188,425,
6651,3239,228,176,404,
6652,3193,212,182,394,
6653,3138,217,211,428,
6654,3143,221,167,388,
6655,3115,226,199,425,
6656,3260,250,188,438,
6657,3335,234,198,432,
6658,3242,230,193,423,
6659,3172,237,196,433,
6660,110,10,2,12,
6661,3206,244,181,425,
6662,3154,256,187,443,
6663,3141,234,175,409,
6664,3182,218,190,408,
6665,3202,223,182,405,
6666,2622,166,165,331,
6667,3196,234,161,395,
6668,3262,242,199,441,
6669,3198,222,188,410,
6670,182,9,14,23,
6671,3287,219,199,418,
6672,3301,234,168,402,
6674,3271,246,187,433,
6675,3325,254,182,436,
6677,3313,245,189,434,
6678,3132,232,172,404,
6679,3340,260,191,451,
6680,3220,235,167,402,
6681,3212,255,179,434,
6682,3193,234,190,424,
6683,3239,253,163,416,
6684,3116,214,193,407,
6685,3174,221,163,384,
6686,3318,236,194,430,
6688,200,12,8,20,
6690,3143,248,168,416,
6691,3295,237,189,426,
6692,3253,242,188,430,
6693,3310,220,181,401,
6694,3261,243,193,436,
6695,431,37,25,62,
6696,3197,242,187,429,
6697,3287,214,181,395,
6698,3249,237,171,408,
6699,3174,226,184,410,
6700,3339,244,205,449,
6701,70,7,5,12,
6702,3189,252,176,428,
6703,3149,238,169,407,
6704,3243,260,207,467,
6705,3170,248,191,439,
6706,3273,245,178,423,
6707,3098,243,194,437,
6709,3215,221,204,425,
6710,3244,216,184,400,
6711,3212,228,195,423,
6712,3251,229,178,407,
6713,3151,239,181,420,
6714,3141,249,190,439,
6715,3293,239,183,422,
6717,3064,210,156,366,
6718,3310,241,197,438,
6719,3192,223,173,396,
6720,3185,237,187,424,
6721,3181,243,174,417,
6722,349,25,22,47,
6723,3159,220,191,411,
6724,3245,223,169,392,
6725,2532,179,133,312,
6726,3129,212,178,390,
6727,3303,254,188,442,
6729,3116,243,198,441,
6730,3217,267,190,457,
6732,3188,247,184,431,
6733,3193,242,175,417,
6734,3191,245,175,420,
6735,3304,215,213,428,
6736,3305,231,180,411,
6737,415,25,23,48,
6738,3266,239,184,423,
6739,3202,251,180,431,
6740,3223,249,165,414,
6741,3263,238,170,408,
6742,3343,239,192,431,
6744,3149,239,167,406,
6745,3234,258,201,459,
6747,3276,261,189,450,
6748,3296,261,224,485,
6749,3055,200,190,390,
6750,3209,256,180,436,
6751,3185,220,183,403,
6752,3267,219,187,406,
6753,3159,207,172,379,
6754,3303,250,195,445,
6755,3209,235,166,401,
6756,3163,231,191,422,
6757,3133,209,188,397,
6758,3134,211,197,408,
6759,3240,259,171,430,
6760,3278,222,199,421,
6761,3218,220,180,400,
6762,3317,236,194,430,
6764,3070,239,165,404,
6765,3324,242,202,444,
6766,3152,226,192,418,
6767,3167,247,158,405,
6769,3274,224,200,424,
6770,3239,239,181,420,
6772,3239,231,179,410,
6773,3121,228,168,396,
6774,3105,259,153,412,
6775,3203,220,171,391,
6776,3235,227,192,419,
6777,3242,227,183,410,
6778,3192,224,198,422,
6779,3299,249,185,434,
6780,3143,232,176,408,
6781,3187,227,174,401,
6783,2726,214,148,362,
6784,3210,250,168,418,
6786,3268,240,176,416,
6788,3198,235,177,412,
6789,3227,225,193,418,
6790,3063,223,176,399,
6791,3194,242,192,434,
6793,3193,242,174,416,
6794,3190,237,195,432,
6797,3210,233,169,402,
6798,3195,231,184,415,
6799,3199,216,185,401,
6800,3144,263,184,447,
6802,3237,241,185,426,
6804,3213,237,176,413,
6805,3192,228,179,407,
6806,3281,253,177,430,
6807,3278,251,184,435,
6808,3147,219,173,392,
6809,3263,225,182,407,
6810,3217,221,197,418,
6811,3132,248,185,433,
6812,3128,220,157,377,
6813,3164,233,194,427,
6814,3128,236,184,420,
6815,3254,240,181,421,
6816,3265,226,197,423,
6817,3280,235,163,398,
6818,3250,224,174,398,
6819,3283,245,194,439,
6820,3119,234,180,414,
6821,3273,216,200,416,
6822,3139,241,173,414,
6823,3219,214,171,385,
6824,3283,254,177,431,
6825,2692,177,160,337,
6826,3237,233,168,401,
6827,3130,254,204,458,
6828,3238,233,183,416,
6829,3175,241,183,424,
6830,3261,218,205,423,
6831,269,22,18,40,
6832,3263,242,192,434,
6833,3164,232,183,415,
6834,3163,235,169,404,
6835,3233,229,187,416,
6836,3264,218,200,418,
6837,3215,217,187,404,
6838,3264,231,166,397,
6839,476,36,27,63,
6841,3118,219,175,394,
6842,3200,223,173,396,
6843,3149,237,170,407,
6845,3221,247,176,423,
6846,3338,213,189,402,
6847,3296,226,184,410,
6850,3358,242,196,438,
6851,3162,229,173,402,
6852,3206,232,171,403,
6853,3294,264,188,452,
6854,3167,228,155,383,
6855,3185,228,180,408,
6856,3225,253,165,418,
6857,3142,224,181,405,
6858,3240,264,195,459,
6859,3172,245,193,438,
6861,3213,244,176,420,
6862,3273,201,189,390,
6863,3197,234,196,430,
6864,3277,228,228,456,
6865,3270,230,182,412,
6866,3087,226,180,406,
6867,3214,236,181,417,
6868,3083,247,165,412,
6870,3107,241,188,429,
6871,3167,233,168,401,
6872,3028,183,185,368,
6873,3160,253,174,427,
6874,3117,226,196,422,
6875,3099,209,171,380,
6876,3173,240,165,405,
6877,3145,264,161,425,
6878,3370,211,187,398,
6879,297,19,21,40,
6880,3348,214,177,391,
6881,3114,249,173,422,
6882,3155,212,187,399,
6883,3118,221,186,407,
6884,3140,252,167,419,
6885,3180,238,181,419,
6886,3113,207,187,394,
6887,3202,255,176,431,
6888,3128,219,189,408,
6889,234,20,12,32,
6890,3227,220,166,386,
6891,638,51,41,92,
6892,3202,251,177,428,
6893,3240,233,187,420,
6894,3160,200,184,384,
6895,17,1,1,2,
6897,3304,232,173,405,
6898,3170,213,151,364,
6899,3156,275,180,455,
6900,3197,217,204,421,
6901,3214,249,173,422,
6902,3215,231,141,372,
6903,3247,237,166,403,
6904,3249,268,181,449,
6905,3328,260,200,460,
6906,3270,254,183,437,
6908,3150,217,151,368,
6909,3140,224,177,401,
6910,3121,227,183,410,
6911,3137,210,193,403,
6913,3338,243,166,409,
6914,3217,221,166,387,
6915,3285,248,182,430,
6916,3238,221,199,420,
6917,3304,230,167,397,
6918,3254,253,181,434,
6919,3155,243,174,417,
6920,3266,227,193,420,
6921,3071,224,190,414,
6922,3219,215,172,387,
6923,3157,231,161,392,
6924,3148,222,192,414,
6925,3211,239,175,414,
6926,3268,246,185,431,
6927,346,29,19,48,
6928,3126,225,177,402,
6929,3271,248,162,410,
6930,3334,234,202,436,
6931,3255,264,192,456,
6932,3179,218,152,370,
6933,3220,266,178,444,
6934,3251,234,182,416,
6935,3233,241,199,440,
6936,3296,249,203,452,
6937,3261,226,172,398,
6938,3209,233,187,420,
6939,3137,219,163,382,
6940,3261,233,191,424,
6941,3275,236,196,432,
6942,3193,238,184,422,
6943,3203,249,157,406,
6944,3339,227,162,389,
6945,90,7,8,15,
6946,3272,233,180,413,
6947,3191,235,191,426,
6948,3183,206,203,409,
6949,3173,258,182,440,
6950,3194,233,155,388,
6951,3195,252,193,445,
6952,3272,245,180,425,
6953,3230,254,154,408,
6955,3250,244,201,445,
6956,3217,220,177,397,
6957,3369,218,194,412,
6958,3273,247,201,448,
6959,3164,218,181,399,
6960,3232,243,178,421,
6961,3213,240,179,419,
6962,3216,208,189,397,
6963,3188,225,204,429,
6964,3293,227,183,410,
6965,3286,260,179,439,
6966,3320,264,196,460,
6967,3161,234,179,413,
6968,137,10,6,16,
6969,21,2,1,3,
6970,3147,266,164,430,
6971,3133,245,163,408,
6972,3174,236,167,403,
6973,3263,242,189,431,
6974,194,13,7,20,
6975,3161,226,185,411,
6976,3328,244,179,423,
6977,3234,241,186,427,
6978,3351,240,180,420,
6979,3089,224,174,398,
6980,3180,239,186,425,
6981,3141,216,179,395,
6982,3146,220,173,393,
6983,3142,258,157,415,
6984,3263,234,167,401,
6985,3273,238,197,435,
6986,3187,238,189,427,
6987,3260,275,155,430,
6988,3080,216,172,388,
6989,2612,208,137,345,
6990,3122,222,175,397,
6991,3240,226,209,435,
6992,3222,230,178,408,
6993,3235,240,182,422,
6994,3190,236,182,418,
6995,3123,245,185,430,
6996,3191,235,160,395,
6997,3273,239,188,427,
6998,3174,239,183,422,
6999,3247,229,183,412,
7000,3222,241,176,417,
7001,3262,238,175,413,
7002,3163,246,160,406,
7003,3205,204,151,355,
7004,3178,235,180,415,
7005,3238,227,186,413,
7006,3257,238,194,432,
7007,3230,244,156,400,
7008,3177,236,183,419,
7009,3258,230,178,408,
7011,3193,233,167,400,
7012,3218,236,206,442,
7013,3093,228,183,411,
7014,3219,243,179,422,
7015,3153,233,183,416,
7016,3275,222,176,398,
7017,3258,239,189,428,
7018,3296,230,173,403,
7019,3267,232,170,402,
7020,3231,242,177,419,
7021,362,24,24,48,
7022,3279,216,198,414,
7023,3193,237,183,420,
7024,3245,216,161,377,
7025,3245,235,190,425,
7026,3297,248,172,420,
7028,858,66,44,110,
7029,3118,221,178,399,
7030,3144,213,171,384,
7031,3238,218,184,402,
7032,3150,209,180,389,
7033,3266,233,174,407,
7034,475,35,31,66,
7035,3174,237,179,416,
7036,3255,246,179,425,
7037,3192,240,187,427,
7038,3373,238,175,413,
7040,3194,227,210,437,
7041,3222,219,189,408,
7042,3217,234,187,421,
7043,3174,210,168,378,
7044,3127,227,194,421,
7045,3259,235,177,412,
7046,3234,233,187,420,
7047,3194,230,170,400,
7048,3149,234,184,418,
7049,3259,236,184,420,
7050,3198,245,184,429,
7051,3244,208,187,395,
7052,3186,236,172,408,
7053,3306,245,201,446,
7054,47,3,2,5,
7055,3273,221,179,400,
7056,3274,251,200,451,
7057,3154,210,216,426,
7058,221,13,10,23,
7059,3162,229,178,407,
7060,3244,225,211,436,
7061,3067,212,191,403,
7062,3254,217,183,400,
7063,3351,231,207,438,
7064,3238,260,182,442,
7065,3270,226,216,442,
7066,3260,257,183,440,
7067,3258,232,182,414,
7068,3274,231,207,438,
7070,3197,221,162,383,
7071,3198,237,178,415,
7072,3215,230,169,399,
7073,3273,276,162,438,
7074,3260,261,188,449,
7075,3113,211,167,378,
7076,3228,254,168,422,
7078,3335,233,172,405,
7079,3232,229,187,416,
7080,3276,254,195,449,
7081,3189,232,184,416,
7082,3257,232,191,423,
7083,3255,232,210,442,
7084,3408,254,189,443,
7085,3112,221,153,374,
7086,3165,263,192,455,
7087,3196,239,180,419,
7088,3204,237,192,429,
7089,3212,228,180,408,
7090,3227,225,178,403,
7093,3301,257,193,450,
7094,3203,231,198,429,
7095,3162,207,181,388,
7096,3128,231,183,414,
7097,3207,216,195,411,
7098,714,46,35,81,
7099,3250,229,204,433,
7100,3233,234,204,438,
7101,3225,252,174,426,
7102,3285,243,192,435,
7103,3192,235,187,422,
7104,3192,225,193,418,
7105,3106,229,169,398,
7106,3223,218,180,398,
7107,3196,217,181,398,
7108,3216,219,190,409,
7109,3155,244,170,414,
7110,3245,223,206,429,
7112,3220,225,185,410,
7113,3215,224,187,411,
7114,3203,218,174,392,
7115,3202,231,209,440,
7116,3090,239,168,407,
7117,3200,203,187,390,
7118,3211,223,192,415,
7120,3269,267,161,428,
7121,3144,200,192,392,
7122,3194,245,157,402,
7123,3265,249,171,420,
7124,3113,233,174,407,
7125,3163,251,179,430,
7126,3207,226,167,393,
7127,3274,239,163,402,
7128,3257,251,207,458,
7130,3235,266,154,420,
7131,32,2,4,6,
7132,3229,243,179,422,
7133,605,52,37,89,
7134,3192,240,152,392,
7135,3249,234,173,407,
7136,3139,238,132,370,
7137,3249,258,181,439,
7139,3030,217,189,406,
7140,3149,249,164,413,
7141,3315,242,197,439,
7142,3238,240,186,426,
7143,3264,253,196,449,
7145,3126,206,165,371,
7146,3220,225,178,403,
7147,3199,248,160,408,
7148,3233,230,175,405,
7149,3255,219,183,402,
7150,3224,260,185,445,
7151,3282,203,196,399,
7152,3256,241,161,402,
7153,3185,243,195,438,
7154,362,16,18,34,
7156,3307,234,180,414,
7157,3338,241,177,418,
7158,3206,231,191,422,
7159,3131,233,174,407,
7160,3204,223,183,406,
7161,21,2,3,5,
7162,3080,200,206,406,
7163,3265,237,182,419,
7164,3235,233,180,413,
7165,3247,221,185,406,
7166,3205,230,203,433,
7168,3269,222,198,420,
7169,3281,236,188,424,
7170,3284,230,178,408,
7171,3211,243,178,421,
7172,3032,220,156,376,
7173,3214,230,194,424,
7174,3250,220,218,438,
7175,3173,211,189,400,
7176,3143,218,190,408,
7177,3314,227,178,405,
7178,3156,234,187,421,
7179,3172,230,192,422,
7180,400,33,21,54,
7181,3304,242,174,416,
7182,3244,228,185,413,
7183,3226,219,190,409,
7184,3202,241,188,429,
7185,3154,236,176,412,
7186,3295,222,212,434,
7187,3196,237,203,440,
7188,3279,246,192,438,
7189,3041,227,180,407,
7191,3249,225,179,404,
7192,3271,250,187,437,
7193,3203,265,172,437,
7194,3295,265,163,428,
7195,3263,271,162,433,
7196,3220,255,181,436,
7197,3256,254,182,436,
7198,3198,245,161,406,
7199,3174,226,183,409,
7200,3135,225,162,387,
7201,3198,236,186,422,
7202,3299,245,200,445,
7204,3153,219,168,387,
7205,3149,224,182,406,
7206,3248,237,206,443,
7207,3236,231,186,417,
7208,14,2,1,3,
7209,3254,229,190,419,
7210,3241,202,194,396,
7211,3195,252,164,416,
7212,3210,235,180,415,
7213,3238,227,176,403,
7214,3188,203,189,392,
7215,666,50,30,80,
7216,3247,236,204,440,
7217,3257,244,176,420,
7218,3149,225,185,410,
7219,3303,245,181,426,
7222,2754,219,138,357,
7223,3268,247,185,432,
7224,3199,192,186,378,
7225,3198,248,178,426,
7226,3166,230,183,413,
7227,3185,235,195,430,
7228,3177,244,178,422,
7229,3178,233,174,407,
7230,3231,226,183,409,
7231,3174,223,192,415,
7232,3189,226,192,418,
7233,3174,255,190,445,
7234,3129,241,171,412,
7235,3257,228,204,432,
7236,3215,254,178,432,
7237,3225,227,166,393,
7238,3181,234,161,395,
7239,3148,218,187,405,
7240,3179,228,179,407,
7241,3274,234,187,421,
7242,3277,244,172,416,
7243,3135,241,188,429,
7244,2539,193,122,315,
7245,3255,237,172,409,
7246,3206,221,182,403,
7248,96,8,10,18,
7249,3289,253,188,441,
7250,3245,244,190,434,
7251,3195,222,175,397,
7252,3205,231,180,411,
7253,3193,262,156,418,
7254,3228,211,186,397,
7255,3222,230,161,391,
7256,394,25,21,46,
7257,3233,250,173,423,
7258,3181,198,178,376,
7259,322,26,27,53,
7260,3169,224,158,382,
7261,3175,227,192,419,
7262,3252,223,198,421,
7263,3216,225,201,426,
7264,3172,250,206,456,
7265,3104,219,166,385,
7266,3148,258,163,421,
7267,3231,252,178,430,
7268,3266,266,177,443,
7269,3139,242,179,421,
7270,3177,233,188,421,
7271,3172,247,185,432,
7272,3196,202,170,372,
7273,141,19,7,26,
7274,3174,245,162,407,
7275,3152,226,172,398,
7276,3225,229,177,406,
7277,3196,220,159,379,
7278,3168,215,171,386,
7279,3252,233,199,432,
7280,3191,208,190,398,
7282,3173,245,185,430,
7283,3316,221,209,430,
7284,3241,261,186,447,
7285,178,15,13,28,
7286,3119,215,145,360,
7287,3296,249,170,419,
7288,3304,231,191,422,
7289,3190,248,205,453,
7291,75,5,2,7,
7292,3314,243,214,457,
7293,3141,217,195,412,
7294,3427,262,216,478,
7295,3309,256,179,435,
7296,3312,256,195,451,
7297,3201,232,194,426,
7298,3147,228,154,382,
7299,3247,238,213,451,
7300,3079,250,179,429,
7301,3192,254,156,410,
7302,3226,280,187,467,
7304,3136,218,179,397,
7305,3248,240,188,428,
7306,3314,245,153,398,
7307,3238,217,192,409,
7308,3264,238,198,436,
7309,3156,268,185,453,
7311,3164,227,182,409,
7312,3268,228,212,440,
7313,3265,264,167,431,
7314,3282,225,194,419,
7316,168,14,12,26,
7317,3280,221,175,396,
7319,3270,212,168,380,
7320,3223,228,193,421,
7321,3290,218,187,405,
7322,3135,238,196,434,
7323,3237,240,183,423,
7324,3185,232,197,429,
7325,3232,245,185,430,
7326,3303,218,202,420,
7327,3238,259,178,437,
7328,3111,213,182,395,
7329,3144,223,171,394,
7330,3117,243,150,393,
7331,3317,240,212,452,
7332,3276,247,190,437,
7333,3167,246,168,414,
7334,3154,219,172,391,
7335,3287,277,181,458,
7336,3209,238,175,413,
7337,3298,232,179,411,
7338,3150,213,184,397,
7339,3236,247,187,434,
7342,3222,240,171,411,
7343,3189,224,194,418,
7344,3229,236,165,401,
7346,3193,257,156,413,
7347,3194,228,185,413,
7348,3209,221,170,391,
7349,3343,245,177,422,
7350,3204,226,206,432,
7351,3294,247,192,439,
7352,3309,225,168,393,
7353,3255,225,196,421,
7354,365,22,21,43,
7355,3111,212,208,420,
7356,3266,260,189,449,
7357,3228,210,174,384,
7358,3319,234,197,431,
7359,3216,215,200,415,
7360,3309,205,193,398,
7361,3142,259,187,446,
7362,489,39,37,76,
7364,3296,258,196,454,
7365,3346,265,196,461,
7366,277,14,18,32,
7367,3314,239,200,439,
7368,3234,267,192,459,
7369,3103,248,188,436,
7370,3281,236,197,433,
7371,3175,225,184,409,
7372,3151,223,198,421,
7373,3224,248,175,423,
7374,3240,241,176,417,
7375,3178,214,186,400,
7376,3271,237,188,425,
7377,3137,230,186,416,
7380,3199,239,199,438,
7381,3161,217,191,408,
7382,3104,196,182,378,
7383,3183,233,168,401,
7384,3176,225,179,404,
7385,3066,251,156,407,
7386,3189,246,174,420,
7387,3210,236,197,433,
7388,3258,268,182,450,
7389,194,15,19,34,
7390,3186,214,175,389,
7391,3218,230,177,407,
7392,3350,248,189,437,
7393,3228,253,165,418,
7394,3221,223,187,410,
7395,3196,251,186,437,
7396,3233,249,174,423,
7397,3241,239,179,418,
7398,3218,239,202,441,
7399,3219,221,171,392,
7400,3113,212,200,412,
7401,3256,230,184,414,
7404,3324,267,192,459,
7405,3207,240,173,413,
7406,3303,216,204,420,
7407,3230,237,176,413,
7408,3199,187,185,372,
7409,3249,208,212,420,
7410,3292,221,175,396,
7411,3297,227,188,415,
7412,3415,243,208,451,
7413,3191,228,179,407,
7414,3257,231,182,413,
7416,3155,215,188,403,
7417,3114,247,172,419,
7421,3319,240,193,433,
7422,3304,226,176,402,
7423,3148,229,151,380,
7424,3266,241,174,415,
7425,3259,254,182,436,
7426,602,51,35,86,
7427,3199,224,203,427,
7429,3137,240,168,408,
7430,3200,246,190,436,
7431,3189,263,177,440,
7432,3246,220,184,404,
7433,3277,252,186,438,
7434,3095,199,166,365,
7435,3156,215,186,401,
7436,3169,252,182,434,
7437,3159,190,177,367,
7438,3109,219,182,401,
7439,3195,230,161,391,
7440,3311,238,223,461,
7441,3151,244,190,434,
7442,3199,250,189,439,
7443,3183,265,162,427,
7444,3303,255,205,460,
7446,3227,220,179,399,
7447,3118,239,174,413,
7448,3282,257,183,440,
7449,3301,246,170,416,
7450,3114,244,179,423,
7451,3125,255,179,434,
7452,3247,231,193,424,
7453,3235,249,184,433,
7454,3181,224,161,385,
7456,3286,240,173,413,
7457,3177,243,165,408,
7458,3296,231,182,413,
7459,3295,241,169,410,
7460,3295,249,185,434,
7461,3248,233,192,425,
7462,3160,250,208,458,
7463,3200,216,183,399,
7464,3179,233,178,411,
7465,3253,228,188,416,
7466,3255,234,206,440,
7467,3265,247,205,452,
7468,3169,212,149,361,
7469,3266,236,201,437,
7470,3253,247,174,421,
7471,3179,241,167,408,
7472,3261,263,197,460,
7473,3229,227,178,405,
7474,3191,225,191,416,
7475,3312,248,198,446,
7476,3188,228,212,440,
7478,3184,211,193,404,
7479,3240,249,178,427,
7480,3316,245,182,427,
7481,3159,244,193,437,
7482,3291,226,181,407,
7483,3230,210,193,403,
7485,3154,246,183,429,
7486,3130,229,202,431,
7488,3186,237,175,412,
7489,3354,250,229,479,
7490,3265,203,210,413,
7491,3231,244,193,437,
7492,3230,223,179,402,
7493,3113,263,159,422,
7494,3338,233,207,440,
7496,3140,235,183,418,
7497,3213,257,183,440,
7498,3204,217,216,433,
7499,3227,214,195,409,
7500,3180,230,187,417,
7501,3270,236,176,412,
7502,3257,230,199,429,
7503,3281,225,190,415,
7504,600,45,29,74,
7505,107,3,7,10,
7506,3278,249,188,437,
7507,3135,198,168,366,
7508,3203,240,182,422,
7509,3187,198,166,364,
7510,3147,243,177,420,
7511,3167,221,200,421,
7512,3256,253,176,429,
7513,3137,228,162,390,
7514,71,6,4,10,
7515,3224,240,195,435,
7516,3253,220,173,393,
7517,3215,244,182,426,
7518,3204,220,191,411,
7519,2502,182,124,306,
7521,3280,261,195,456,
7522,370,31,21,52,
7523,3302,268,181,449,
7525,3078,235,188,423,
7526,3236,236,173,409,
7527,3213,228,191,419,
7528,3095,200,163,363,
7529,3273,253,165,418,
7530,3265,224,203,427,
7531,3233,228,185,413,
7532,3225,280,168,448,
7533,3196,215,163,378,
7534,3247,233,185,418,
7535,3186,244,177,421,
7536,3235,245,172,417,
7538,3262,210,179,389,
7539,3185,233,182,415,
7540,3206,244,173,417,
7541,3233,218,195,413,
7542,3238,241,174,415,
7545,3155,198,183,381,
7547,3268,205,194,399,
7548,180,12,9,21,
7549,3044,218,197,415,
7550,3223,234,186,420,
7551,3206,248,195,443,
7552,676,54,41,95,
7553,3359,263,200,463,
7554,3199,223,179,402,
7555,3035,217,182,399,
7556,3113,257,182,439,
7558,3213,241,188,429,
7559,3242,258,175,433,
7560,3156,244,174,418,
7561,3223,243,231,474,
7564,3311,245,193,438,
7565,3262,253,192,445,
7566,2578,162,184,346,
7567,3101,219,154,373,
7568,3224,248,160,408,
7569,3202,241,173,414,
7570,3271,205,160,365,
7571,3283,238,206,444,
7573,3094,215,183,398,
7574,3223,225,180,405,
7575,3264,230,178,408,
7576,3264,207,190,397,
7577,3111,240,185,425,
7579,3218,222,180,402,
7580,3072,219,170,389,
7581,3204,220,162,382,
7582,3213,242,182,424,
7583,453,35,21,56,
7584,3036,206,158,364,
7585,3253,258,156,414,
7586,3183,211,168,379,
7587,3265,227,186,413,
7588,3160,207,196,403,
7589,3143,245,187,432,
7590,3153,217,200,417,
7591,3356,241,199,440,
7592,3145,208,184,392,
7593,3244,221,152,373,
7594,3195,237,201,438,
7595,3247,233,177,410,
7596,3052,201,179,380,
7597,3149,241,173,414,
7598,3195,213,196,409,
7599,3166,251,181,432,
7600,3232,236,202,438,
7601,3191,243,192,435,
7602,3230,249,177,426,
7603,3206,241,171,412,
7604,3162,209,169,378,
7606,299,21,15,36,
7607,3163,225,183,408,
7608,3194,197,180,377,
7609,3218,217,181,398,
7610,3254,230,191,421,
7611,3133,192,171,363,
7612,3290,228,173,401,
7613,3193,254,159,413,
7614,17,1,1,2,
7615,3272,259,178,437,
7616,3217,194,182,376,
7617,3253,232,186,418,
7618,3165,215,206,421,
7619,3305,221,193,414,
7620,3261,248,194,442,
7621,3180,252,172,424,
7622,3181,222,184,406,
7623,3286,224,180,404,
7624,3154,210,174,384,
7625,3214,225,169,394,
7626,3136,188,189,377,
7627,3212,232,188,420,
7628,3163,208,196,404,
7629,3116,222,175,397,
7630,3147,228,180,408,
7631,3203,249,201,450,
7632,3248,245,181,426,
7633,3224,235,166,401,
7634,3208,216,169,385,
7635,3243,226,183,409,
7636,3198,227,182,409,
7637,3256,204,215,419,
7638,3059,205,192,397,
7639,3158,220,190,410,
7640,3264,236,198,434,
7642,3281,238,180,418,
7643,3218,236,168,404,
7644,3198,245,184,429,
7645,318,29,21,50,
7646,3282,241,179,420,
7647,3105,203,169,372,
7648,3225,229,171,400,
7650,424,48,26,74,
7651,3182,262,166,428,
7652,2635,180,143,323,
7653,3274,242,198,440,
7654,3311,249,194,443,
7655,3299,229,207,436,
7656,3233,223,198,421,
7657,3211,236,211,447,
7658,3195,234,178,412,
7659,3260,251,186,437,
7661,3182,229,200,429,
7662,75,4,3,7,
7663,274,20,15,35,
7664,3227,225,181,406,
7665,3285,224,172,396,
7666,3199,209,188,397,
7667,3231,261,180,441,
7668,3121,218,194,412,
7669,3238,244,174,418,
7671,3253,231,173,404,
7672,3247,243,180,423,
7673,3301,224,183,407,
7674,3141,243,183,426,
7675,3122,226,202,428,
7676,3210,217,179,396,
7677,3160,240,174,414,
7679,3186,235,188,423,
7681,74,5,6,11,
7682,3148,194,206,400,
7683,3326,251,195,446,
7684,3278,229,173,402,
7685,3203,263,170,433,
7686,3195,235,179,414,
7687,3261,234,176,410,
7688,3331,239,179,418,
7689,3285,206,174,380,
7690,3184,214,174,388,
7691,3246,245,173,418,
7692,3203,211,185,396,
7693,3324,237,192,429,
7694,3260,260,203,463,
7696,3255,242,182,424,
7697,3128,235,191,426,
7698,3212,259,199,458,
7699,3248,252,180,432,
7700,3138,250,175,425,
7701,3168,244,190,434,
7702,3273,241,195,436,
7703,3219,255,178,433,
7704,3136,215,176,391,
7705,3155,237,179,416,
7706,119,4,7,11,
7707,3232,222,192,414,
7708,3153,214,176,390,
7709,3117,235,189,424,
7710,3167,224,199,423,
7712,3257,238,210,448,
7713,3141,217,189,406,
7714,3176,245,185,430,
7715,3223,241,188,429,
7716,3068,237,178,415,
7720,3065,255,180,435,
7721,3258,231,200,431,
7722,3218,222,197,419,
7723,3207,205,179,384,
7724,3270,235,181,416,
7725,3128,240,150,390,
7726,3206,240,167,407,
7727,3174,249,176,425,
7728,3155,225,182,407,
7729,205,15,16,31,
7730,3193,242,169,411,
7731,3129,235,168,403,
7732,51,3,4,7,
7733,3289,234,185,419,
7734,3267,221,182,403,
7735,3143,250,173,423,
7736,3163,251,170,421,
7737,3222,255,187,442,
7738,3158,219,186,405,
7739,3179,221,167,388,
7740,3203,223,194,417,
7741,3224,211,181,392,
7742,3141,240,181,421,
7743,3187,237,198,435,
7744,3195,249,163,412,
7746,3111,191,183,374,
7747,91,4,7,11,
7748,3310,243,185,428,
7749,3189,226,177,403,
7750,3278,245,167,412,
7751,3176,228,176,404,
7752,187,7,17,24,
7754,3285,256,169,425,
7755,3288,238,168,406,
7756,3185,237,198,435,
7757,3203,231,177,408,
7758,3194,225,162,387,
7759,3192,232,169,401,
7760,2987,232,181,413,
7761,3171,214,200,414,
7762,3183,220,184,404,
7763,3213,228,185,413,
7764,3259,240,212,452,
7765,3199,247,174,421,
7766,3291,243,188,431,
7767,3177,239,192,431,
7768,3214,232,173,405,
7769,3261,226,176,402,
7770,3271,238,192,430,
7771,3106,209,180,389,
7772,3245,254,200,454,
7773,3243,201,188,389,
7774,3092,211,165,376,
7776,3123,224,181,405,
7777,3247,236,191,427,
7778,3217,250,183,433,
7779,3195,236,163,399,
7780,3156,230,168,398,
7783,3209,248,163,411,
7784,3185,228,199,427,
7785,3259,256,209,465,
7786,3218,222,207,429,
7787,3190,220,189,409,
7788,3317,233,171,404,
7789,3348,242,211,453,
7790,3285,254,198,452,
7791,3228,251,169,420,
7792,3194,228,176,404,
7793,3218,229,186,415,
7794,3256,220,189,409,
7795,3216,244,188,432,
7796,3219,210,174,384,
7797,3208,226,180,406,
7798,3292,253,194,447,
7799,3237,241,197,438,
7800,3200,246,165,411,
7801,3092,228,186,414,
7802,3165,209,181,390,
7804,31,2,2,4,
7805,3270,223,201,424,
7806,3222,242,185,427,
7807,3277,246,198,444,
7808,3212,226,191,417,
7809,124,7,6,13,
7810,3241,215,181,396,
7811,3209,224,199,423,
7812,3247,233,177,410,
7813,3289,224,206,430,
7814,3310,257,153,410,
7815,3217,242,191,433,
7817,3161,209,172,381,
7818,3218,238,164,402,
7819,575,44,28,72,
7820,3151,226,197,423,
7821,3120,234,188,422,
7822,3135,229,171,400,
7823,3195,226,174,400,
7824,3234,260,183,443,
7825,3313,243,185,428,
7826,3235,239,166,405,
7827,3177,239,176,415,
7828,3183,222,178,400,
7829,3210,234,197,431,
7830,3208,236,180,416,
7831,3255,218,195,413,
7832,3059,244,178,422,
7833,3197,258,171,429,
7834,3197,255,162,417,
7837,3106,222,187,409,
7838,3205,222,194,416,
7839,3250,269,210,479,
7840,3311,262,204,466,
7841,3250,254,159,413,
7842,3215,253,170,423,
7843,3191,258,201,459,
7844,3383,275,181,456,
7845,570,39,30,69,
7846,3162,223,196,419,
7847,3293,225,181,406,
7848,2851,187,141,328,
7849,3286,208,214,422,
7850,3145,235,186,421,
7851,3234,244,185,429,
7852,3189,264,185,449,
7853,3175,207,195,402,
7854,3200,238,183,421,
7855,3254,236,166,402,
7856,3173,226,171,397,
7857,3325,222,187,409,
7858,3278,220,199,419,
7859,3084,210,165,375,
7860,3307,203,195,398,
7861,3287,220,191,411,
7862,3120,227,184,411,
7863,3183,249,177,426,
7864,3085,220,196,416,
7865,3264,239,202,441,
7867,3252,190,192,382,
7868,3163,221,180,401,
7869,522,39,23,62,
7870,3223,253,181,434,
7871,3232,235,170,405,
7872,3176,221,163,384,
7874,3210,226,223,449,
7875,3169,238,174,412,
7876,3164,267,165,432,
7878,3263,236,187,423,
7879,3216,241,200,441,
7880,3255,246,179,425,
7882,3229,255,181,436,
7883,3211,245,175,420,
7884,3191,221,191,412,
7886,3148,243,188,431,
7887,3280,241,204,445,
7888,3127,216,187,403,
7889,3212,212,192,404,
7890,3214,240,181,421,
7891,3251,241,169,410,
7892,3161,221,172,393,
7894,3232,220,187,407,
7895,3219,251,186,437,
7897,3226,207,171,378,
7898,3237,214,174,388,
7899,469,36,20,56,
7900,3236,266,192,458,
7901,3257,224,182,406,
7902,3103,228,174,402,
7903,3290,222,186,408,
7904,3175,230,197,427,
7906,3165,237,188,425,
7907,3190,225,175,400,
7909,3280,243,207,450,
7910,3206,219,158,377,
7912,3290,230,181,411,
7913,3208,204,185,389,
7914,3053,233,171,404,
7915,3223,244,193,437,
7916,3143,213,175,388,
7917,3325,221,197,418,
7918,3142,215,165,380,
7919,3141,231,190,421,
7920,3226,253,185,438,
7921,3084,236,176,412,
7922,3150,239,181,420,
7923,3272,224,185,409,
7925,3256,273,173,446,
7926,3236,252,186,438,
7927,3196,243,202,445,
7928,3306,243,175,418,
7929,3179,256,171,427,
7930,3112,247,186,433,
7931,557,34,41,75,
7933,3068,195,178,373,
7934,3271,239,165,404,
7935,3252,258,181,439,
7936,3174,238,194,432,
7937,3213,246,184,430,
7938,3206,245,196,441,
7939,3203,229,182,411,
7940,3201,226,194,420,
7941,3232,231,165,396,
7942,3287,248,205,453,
7943,3277,237,187,424,
7944,3186,256,175,431,
7945,2549,168,159,327,
7946,3129,258,161,419,
7947,3068,231,189,420,
7949,3151,184,170,354,
7950,3223,231,180,411,
7952,3215,249,191,440,
7953,3255,256,181,437,
7954,3267,224,183,407,
7955,3312,253,188,441,
7956,3183,240,184,424,
7957,3193,221,196,417,
7958,3299,258,179,437,
7959,3243,233,183,416,
7960,3208,234,197,431,
7961,3302,213,189,402,
7963,3204,222,190,412,
7964,2648,211,137,348,
7965,3149,220,179,399,
7966,38,5,2,7,
7967,3296,217,170,387,
7969,3333,235,198,433,
7970,3213,243,181,424,
7971,3092,244,158,402,
7972,3216,217,182,399,
7973,3257,226,174,400,
7974,3252,229,197,426,
7975,3193,219,171,390,
7976,3269,244,180,424,
7977,3288,201,181,382,
7978,3176,228,193,421,
7979,3345,246,185,431,
7980,3216,229,172,401,
7982,3123,191,196,387,
7983,2512,160,140,300,
7984,3283,265,178,443,
7985,3191,221,194,415,
7986,3211,229,176,405,
7987,3212,238,176,414,
7988,3254,251,175,426,
7989,3237,265,195,460,
7990,3254,228,165,393,
7992,3305,230,188,418,
7993,3265,225,177,402,
7995,3183,214,177,391,
7996,3306,240,182,422,
7997,3195,243,173,416,
7998,3274,246,174,420,
7999,3105,222,172,394,
8000,3325,255,170,425,
8001,3208,239,177,416,
8002,3278,223,190,413,
8003,3230,208,183,391,
8004,3136,223,183,406,
8005,3159,241,183,424,
8006,3284,236,182,418,
8008,3217,251,183,434,
8009,3206,245,166,411,
8010,3146,222,154,376,
8011,3169,225,173,398,
8012,3206,207,196,403,
8013,3181,253,153,406,
8014,3204,208,177,385,
8015,747,74,46,120,
8016,3283,220,174,394,
8017,3245,233,178,411,
8018,3287,245,192,437,
8019,3252,237,177,414,
8020,3282,240,175,415,
8021,3219,245,174,419,
8022,121,6,5,11,
8023,3179,241,172,413,
8024,3288,240,172,412,
8025,3188,217,193,410,
8026,3164,220,156,376,
8027,3273,224,192,416,
8028,3203,236,191,427,
8030,3252,271,181,452,
8031,3381,264,174,438,
8032,3238,232,203,435,
8033,3194,230,169,399,
8034,3181,211,163,374,
8035,3168,209,182,391,
8036,3271,259,203,462,
8038,3163,231,163,394,
8039,3270,232,184,416,
8040,3145,221,174,395,
8041,3254,244,179,423,
8042,3190,221,175,396,
8043,3227,231,188,419,
8044,3154,240,180,420,
8045,3083,228,168,396,
8046,3216,216,165,381,
8047,3239,246,181,427,
8048,3100,211,183,394,
8049,3295,254,184,438,
8050,3195,231,169,400,
8051,2309,161,108,269,
8052,3248,230,181,411,
8053,3249,218,201,419,
8054,3171,237,197,434,
8055,3206,222,197,419,
8056,517,31,36,67,
8057,3233,230,178,408,
8059,3195,253,155,408,
8060,3275,254,179,433,
8061,3192,238,183,421,
8062,3169,245,181,426,
8063,3298,258,182,440,
8064,3265,226,181,407,
8065,3166,231,186,417,
8066,3244,238,173,411,
8067,3174,212,185,397,
8068,3132,217,174,391,
8069,3297,232,205,437,
8070,3213,234,166,400,
8071,48,5,3,8,
8072,3132,234,180,414,
8073,3252,234,193,427,
8074,3283,235,197,432,
8075,3192,226,190,416,
8076,3086,194,184,378,
8078,3194,223,176,399,
8079,3190,228,174,402,
8080,3219,245,181,426,
8081,3127,211,193,404,
8082,3303,245,180,425,
8083,3135,230,180,410,
8084,3245,218,167,385,
8085,3327,236,169,405,
8086,3271,218,204,422,
8087,3156,256,162,418,
8089,3162,241,203,444,
8090,3314,240,187,427,
8091,3252,237,176,413,
8092,3195,193,179,372,
8093,3216,287,185,472,
8094,2811,210,139,349,
8096,3189,248,201,449,
8097,3206,241,171,412,
8098,3307,241,180,421,
8099,3212,236,161,397,
8100,308,22,16,38,
8101,3276,235,198,433,
8102,3163,232,193,425,
8103,3189,209,173,382,
8106,3232,222,176,398,
8107,3188,208,190,398,
8108,3168,263,161,424,
8109,3201,249,174,423,
8111,3175,208,190,398,
8112,3137,231,177,408,
8113,3186,232,189,421,
8114,3150,231,172,403,
8115,3222,246,183,429,
8116,3253,257,174,431,
8118,3173,231,181,412,
8119,3260,252,199,451,
8120,3185,229,186,415,
8121,3243,242,190,432,
8123,3257,271,207,478,
8124,3296,232,185,417,
8125,3129,226,181,407,
8126,3207,250,176,426,
8127,3143,244,173,417,
8128,3205,255,163,418,
8129,3176,225,173,398,
8130,3278,247,181,428,
8131,3255,236,202,438,
8132,3228,232,177,409,
8133,3186,231,174,405,
8134,3061,240,179,419,
8136,3224,234,181,415,
8138,3200,221,197,418,
8139,231,14,10,24,
8140,53,3,6,9,
8141,3289,245,184,429,
8143,3263,233,182,415,
8144,3182,240,170,410,
8145,3222,227,199,426,
8146,3146,224,177,401,
8148,3040,249,150,399,
8149,3275,234,189,423,
8150,3218,256,191,447,
8151,3282,244,195,439,
8152,3175,220,187,407,
8153,3186,247,144,391,
8154,3254,232,197,429,
8155,3199,220,177,397,
8156,3191,248,205,453,
8157,3204,230,162,392,
8158,3232,213,205,418,
8159,3242,228,204,432,
8160,3255,233,177,410,
8161,3241,235,180,415,
8162,3214,238,171,409,
8163,3159,253,190,443,
8164,3281,238,201,439,
8165,3221,243,166,409,
8166,3156,257,163,420,
8167,3286,242,186,428,
8168,3156,234,179,413,
8169,3225,230,189,419,
8170,3180,221,196,417,
8171,3189,222,171,393,
8172,3165,230,187,417,
8173,3197,251,185,436,
8174,3272,226,183,409,
8175,3269,221,195,416,
8176,94,5,3,8,
8177,3187,226,181,407,
8178,3242,240,175,415,
8179,3286,248,165,413,
8180,3258,208,174,382,
8181,3198,235,180,415,
8182,3207,245,182,427,
8183,3080,233,153,386,
8184,3226,247,178,425,
8185,3203,230,199,429,
8186,3218,249,185,434,
8187,3227,227,195,422,
8188,3185,221,196,417,
8189,3266,255,202,457,
8190,3188,223,177,400,
8191,3223,250,161,411,
8192,3181,190,170,360,
8193,3248,224,167,391,
8194,3126,261,171,432,
8195,3161,234,170,404,
8196,3207,261,175,436,
8197,3197,237,161,398,
8198,3195,215,166,381,
8199,3184,256,172,428,
8200,3247,233,201,434,
8201,3152,226,171,397,
8202,3231,238,169,407,
8203,3280,254,192,446,
8205,3165,228,187,415,
8206,3308,251,191,442,
8207,3271,229,185,414,
8209,3186,239,186,425,
8210,3177,219,192,411,
8211,3137,229,184,413,
8212,3236,236,179,415,
8213,3156,222,182,404,
8214,3232,229,182,411,
8215,3268,228,184,412,
8216,3286,231,170,401,
8217,3190,244,197,441,
8218,3309,269,175,444,
8219,3248,210,163,373,
8220,3145,214,198,412,
8221,3259,243,184,427,
8222,3251,257,183,440,
8223,3111,229,159,388,
8224,3141,236,144,380,
8225,3278,221,184,405,
8227,3244,245,173,418,
8228,3212,270,169,439,
8229,3217,230,181,411,
8230,3276,228,199,427,
8231,276,20,24,44,
8232,3213,236,180,416,
8233,3109,245,168,413,
8234,3296,235,191,426,
8236,3222,220,178,398,
8237,3217,256,187,443,
8238,3170,209,173,382,
8239,3073,232,160,392,
8240,3253,255,192,447,
8241,3304,211,190,401,
8242,3271,265,193,458,
8243,3132,222,187,409,
8246,3099,205,186,391,
8247,3016,222,185,407,
8248,3210,232,197,429,
8249,3090,216,189,405,
8250,2988,211,189,400,
8251,2562,193,137,330,
8252,3268,245,175,420,
8253,3143,225,169,394,
8254,3231,223,177,400,
8255,3344,231,215,446,
8256,3284,243,170,413,
8257,432,32,27,59,
8258,3178,226,192,418,
8259,3245,233,161,394,
8260,3237,265,185,450,
8261,3252,241,174,415,
8262,3311,251,190,441,
8263,3290,243,191,434,
8264,3155,216,178,394,
8265,3199,217,192,409,
8267,3335,247,175,422,
8268,3146,246,168,414,
8270,3247,249,201,450,
8271,3191,264,172,436,
8272,3249,204,172,376,
8273,3355,237,198,435,
8274,3212,241,194,435,
8275,3141,230,184,414,
8276,3267,262,197,459,
8277,645,52,31,83,
8278,3139,218,186,404,
8279,3210,232,195,427,
8280,2490,186,144,330,
8281,3174,224,170,394,
8283,3184,246,190,436,
8284,3276,258,189,447,
8285,3140,230,208,438,
8286,3298,248,217,465,
8287,3257,237,177,414,
8288,3176,244,187,431,
8289,3125,221,163,384,
8290,3233,226,172,398,
8291,3215,222,181,403,
8292,3163,241,160,401,
8293,3224,242,167,409,
8294,3248,252,188,440,
8295,590,47,30,77,
8296,3254,253,177,430,
8297,3132,237,163,400,
8298,3149,243,176,419,
8299,3234,210,192,402,
8300,3285,224,174,398,
8301,3146,215,196,411,
8302,3222,254,156,410,
8303,3031,210,163,373,
8304,3192,248,191,439,
8305,3209,226,192,418,
8306,3223,254,173,427,
8307,3203,208,162,370,
8308,3257,212,177,389,
8309,3283,222,202,424,
8310,3286,205,205,410,
8311,3131,239,168,407,
8312,3250,235,171,406,
8313,3168,233,164,397,
8314,3259,244,201,445,
8315,3251,222,221,443,
8316,3163,228,174,402,
8317,3266,217,173,390,
8318,3191,243,177,420,
8319,3261,250,162,412,
8320,3181,229,181,410,
8321,3322,233,189,422,
8322,3321,226,186,412,
8323,3117,248,167,415,
8324,3130,212,180,392,
8325,3204,213,172,385,
8326,3261,227,191,418,
8327,3207,226,178,404,
8329,305,22,16,38,
8330,3200,243,210,453,
8331,3091,211,171,382,
8332,3262,219,155,374,
8333,3316,232,163,395,
8334,3211,250,163,413,
8335,3249,237,177,414,
8336,3190,245,189,434,
8337,3255,233,191,424,
8338,3073,240,174,414,
8339,3108,216,196,412,
8340,3263,214,189,403,
8341,3354,246,182,428,
8342,3221,226,177,403,
8343,3143,241,192,433,
8344,3273,232,188,420,
8345,3237,234,177,411,
8346,3255,214,163,377,
8347,3258,258,177,435,
8348,3129,251,193,444,
8349,3280,243,189,432,
8350,3272,217,187,404,
8351,3281,248,181,429,
8352,3103,228,172,400,
8353,3236,233,188,421,
8354,3190,223,184,407,
8355,3281,232,195,427,
8356,3204,231,187,418,
8357,3094,233,159,392,
8358,3160,222,181,403,
8359,3184,212,195,407,
8362,219,16,15,31,
8363,3271,224,183,407,
8364,3345,237,212,449,
8365,3136,241,163,404,
8366,3210,230,176,406,
8367,3154,246,169,415,
8368,3242,257,182,439,
8369,390,23,26,49,
8371,3112,230,189,419,
8372,263,18,12,30,
8373,3030,229,167,396,
8374,3259,266,202,468,
8375,3109,233,148,381,
8376,3166,245,188,433,
8377,3436,251,184,435,
8378,3132,214,168,382,
8379,3315,238,192,430,
8380,3161,242,198,440,
8381,3201,189,190,379,
8382,3104,237,180,417,
8383,2513,177,145,322,
8384,3310,231,183,414,
8385,3226,236,181,417,
8386,3286,241,171,412,
8387,3266,239,184,423,
8388,3272,243,178,421,
8389,3222,243,184,427,
8390,3172,239,195,434,
8392,3201,236,197,433,
8393,3219,260,186,446,
8394,3174,244,168,412,
8395,3329,263,165,428,
8396,3327,234,182,416,
8397,3211,238,182,420,
8398,3075,220,174,394,
8399,3196,244,172,416,
8400,3198,256,198,454,
8401,3296,244,172,416,
8402,353,38,22,60,
8403,3194,256,171,427,
8404,3118,214,184,398,
8405,2703,179,149,328,
8407,3250,230,189,419,
8408,3215,237,157,394,
8409,3120,275,156,431,
8410,3167,206,168,374,
8411,3300,239,212,451,
8412,3201,255,193,448,
8413,3144,233,162,395,
8414,3203,216,176,392,
8415,3209,252,187,439,
8416,3244,245,193,438,
8418,3257,207,199,406,
8419,3241,239,168,407,
8420,3301,250,206,456,
8421,3308,266,180,446,
8423,3081,229,176,405,
8424,3224,249,181,430,
8425,3320,249,178,427,
8426,3231,220,200,420,
8427,3195,251,175,426,
8428,2492,180,172,352,
8429,3279,228,175,403,
8430,3222,237,203,440,
8431,3247,251,176,427,
8432,3220,250,184,434,
8433,3239,211,209,420,
8434,3174,230,187,417,
8435,3160,217,185,402,
8436,3271,254,165,419,
8437,3226,234,205,439,
8438,3208,221,166,387,
8439,3203,236,190,426,
8440,3165,193,185,378,
8441,3326,229,201,430,
8442,3260,236,180,416,
8443,3183,215,170,385,
8444,3236,195,180,375,
8445,3206,245,178,423,
8446,3287,240,172,412,
8447,3135,234,164,398,
8448,3208,247,185,432,
8449,3219,242,187,429,
8450,3159,222,184,406,
8451,3335,245,189,434,
8453,3159,230,196,426,
8455,3126,233,180,413,
8456,3093,226,175,401,
8457,3225,222,174,396,
8458,3123,221,180,401,
8460,3322,237,174,411,
8461,3245,211,179,390,
8462,3286,254,193,447,
8463,3249,236,188,424,
8464,3164,223,191,414,
8466,3141,232,205,437,
8467,3258,217,193,410,
8468,3360,267,183,450,
8470,3100,219,207,426,
8471,3329,216,188,404,
8472,3232,228,176,404,
8473,3249,243,172,415,
8474,3157,229,181,410,
8475,3146,235,189,424,
8476,3220,229,180,409,
8477,3206,228,190,418,
8479,3226,244,192,436,
8480,3181,221,186,407,
8482,3206,219,177,396,
8483,3163,232,189,421,
8484,3211,228,171,399,
8485,3097,228,193,421,
8488,3191,216,192,408,
8489,3209,243,199,442,
8490,3161,214,166,380,
8491,3085,232,172,404,
8492,3323,233,206,439,
8493,138,7,8,15,
8495,3232,223,171,394,
8496,3192,236,178,414,
8497,434,35,32,67,
8498,3279,252,180,432,
8499,3270,257,159,416,
8500,3198,217,208,425,
8501,3232,224,181,405,
8502,3202,209,193,402,
8503,3269,235,167,402,
8504,3322,271,189,460,
8505,3224,228,198,426,
8506,3336,258,182,440,
8507,3183,236,194,430,
8508,3156,238,181,419,
8509,3240,268,164,432,
8510,3211,214,206,420,
8511,3227,256,183,439,
8512,3250,234,206,440,
8514,3183,201,193,394,
8515,3078,240,164,404,
8516,3311,249,176,425,
8517,3220,259,180,439,
8518,3250,251,157,408,
8519,3198,203,190,393,
8520,3139,220,169,389,
8521,3139,247,176,423,
8522,3174,233,169,402,
8523,3216,237,193,430,
8524,3332,229,178,407,
8525,3351,236,177,413,
8526,3258,234,176,410,
8527,3224,225,189,414,
8528,3321,232,185,417,
8529,141,14,10,24,
8530,163,11,14,25,
8531,3177,241,173,414,
8532,3274,219,167,386,
8533,3215,230,155,385,
8534,3152,225,179,404,
8535,3280,246,198,444,
8536,3248,216,186,402,
8537,3232,227,202,429,
8538,3219,249,197,446,
8539,3117,232,169,401,
8540,3235,246,191,437,
8541,3210,221,180,401,
8542,3267,236,168,404,
8543,3258,244,187,431,
8544,3067,212,172,384,
8545,3240,242,176,418,
8546,3234,225,156,381,
8547,3291,237,196,433,
8548,3224,226,188,414,
8549,3313,229,188,417,
8550,3287,236,192,428,
8551,3211,224,178,402,
8552,3134,215,171,386,
8553,3261,233,197,430,
8554,3308,255,204,459,
8555,3150,222,180,402,
8556,3245,250,172,422,
8557,3107,234,175,409,
8559,3320,253,178,431,
8561,3156,205,184,389,
8562,3260,223,193,416,
8563,3103,235,180,415,
8564,3163,249,170,419,
8565,3116,252,193,445,
8566,3321,248,208,456,
8567,3110,232,163,395,
8568,3220,215,181,396,
8569,3163,232,190,422,
8570,3199,253,177,430,
8571,3277,240,169,409,
8572,3281,245,193,438,
8573,3219,218,181,399,
8574,2582,241,120,361,
8575,3363,237,168,405,
8576,3212,247,181,428,
8577,2675,189,176,365,
8578,3253,260,178,438,
8579,3215,220,200,420,
8580,3269,232,205,437,
8581,3203,212,200,412,
8582,3217,257,194,451,
8583,3186,242,166,408,
8584,3154,195,168,363,
8585,3242,213,183,396,
8586,3295,202,195,397,
8587,3254,254,169,423,
8588,3228,258,182,440,
8589,3189,227,178,405,
8590,3232,232,170,402,
8591,95,3,5,8,
8592,3278,214,190,404,
8593,3308,262,169,431,
8594,3264,217,207,424,
8595,3185,223,183,406,
8597,3239,215,193,408,
8598,3209,236,177,413,
8599,3234,239,195,434,
8600,3181,215,161,376,
8601,3229,250,191,441,
8602,3296,255,179,434,
8603,3162,200,160,360,
8605,3212,240,195,435,
8607,3244,243,179,422,
8608,3182,238,181,419,
8609,3271,240,204,444,
8611,3143,217,169,386,
8612,2593,200,140,340,
8613,3129,213,183,396,
8614,3268,239,178,417,
8615,3209,228,174,402,
8616,3194,244,180,424,
8617,3135,224,187,411,
8618,3284,254,185,439,
8619,3223,247,181,428,
8620,3178,233,204,437,
8622,3232,240,205,445,
8623,3049,212,161,373,
8624,3158,213,174,387,
8625,3212,233,228,461,
8626,3353,235,198,433,
8627,3259,238,189,427,
8628,200,17,15,32,
8629,3203,215,178,393,
8630,2391,179,132,311,
8631,3218,222,171,393,
8632,3106,212,188,400,
8633,3287,242,190,432,
8634,3164,243,158,401,
8635,3252,231,158,389,
8636,3269,239,194,433,
8637,3240,234,159,393,
8638,3207,256,193,449,
8640,3137,215,191,406,
8641,3281,212,165,377,
8642,3225,238,161,399,
8643,3281,221,201,422,
8644,3150,213,164,377,
8645,3092,266,192,458,
8646,3328,217,188,405,
8647,3294,265,186,451,
8648,3211,235,176,411,
8650,3263,247,200,447,
8651,3157,206,175,381,
8652,3125,220,199,419,
8653,3064,225,181,406,
8654,3234,243,185,428,
8655,115,8,5,13,
8656,3257,271,191,462,
8657,3153,236,155,391,
8658,3214,259,167,426,
8659,3271,246,167,413,
8660,3187,234,177,411,
8661,3190,224,185,409,
8664,3114,231,168,399,
8665,3124,233,162,395,
8666,3322,244,209,453,
8667,3250,218,215,433,
8669,3171,225,194,419,
8670,3217,247,191,438,
8671,3182,224,209,433,
8672,3257,233,190,423,
8673,3193,228,179,407,
8674,456,27,23,50,
8675,3196,232,199,431,
8676,3082,231,176,407,
8677,239,15,18,33,
8678,3198,250,182,432,
8679,3282,249,193,442,
8681,122,11,1,12,
8682,3135,216,170,386,
8683,3337,241,189,430,
8684,3253,251,184,435,
8685,3197,235,201,436,
8687,3242,253,210,463,
8688,3178,223,177,400,
8689,3181,207,209,416,
8690,3152,220,191,411,
8691,3195,246,195,441,
8692,3141,211,179,390,
8694,3198,208,188,396,
8695,3303,263,156,419,
8696,3144,261,177,438,
8697,3286,251,186,437,
8698,3368,230,185,415,
8699,3291,217,200,417,
8700,3242,223,169,392,
8703,3146,215,174,389,
8704,3354,235,195,430,
8705,3144,239,190,429,
8706,3131,208,179,387,
8707,160,7,13,20,
8709,3242,248,169,417,
8710,3253,240,189,429,
8711,3255,244,184,428,
8712,3162,227,180,407,
8713,3224,241,212,453,
8714,3184,203,185,388,
8715,3243,241,201,442,
8716,3241,254,182,436,
8717,3276,253,194,447,
8718,3266,242,182,424,
8719,3180,248,174,422,
8720,3231,246,180,426,
8721,3196,237,174,411,
8722,3176,226,178,404,
8723,3121,208,166,374,
8724,3192,204,185,389,
8725,3192,252,181,433,
8727,2241,150,133,283,
8728,3258,257,198,455,
8729,331,27,18,45,
8730,3159,257,167,424,
8731,3091,196,191,387,
8732,3217,223,191,414,
8733,3303,235,185,420,
8734,3364,241,194,435,
8735,3229,219,203,422,
8736,3260,243,184,427,
8737,3146,240,184,424,
8738,3260,235,196,431,
8739,3133,232,184,416,
8740,3174,222,195,417,
8742,3113,218,183,401,
8743,3210,231,169,400,
8744,3206,213,228,441,
8745,3213,222,196,418,
8746,3196,229,197,426,
8747,3258,233,191,424,
8748,3293,226,173,399,
8749,3179,269,163,432,
8750,3182,223,174,397,
8751,3209,251,195,446,
8752,3175,230,196,426,
8753,3200,223,165,388,
8754,3220,247,145,392,
8755,52,3,1,4,
8756,3129,261,183,444,
8757,3247,210,186,396,
8758,3199,223,171,394,
8759,3311,248,199,447,
8760,3183,240,191,431,
8762,3290,224,190,414,
8763,3112,220,135,355,
8764,3259,197,177,374,
8765,3219,259,208,467,
8766,3217,228,178,406,
8767,3239,238,180,418,
8768,3262,209,170,379,
8769,3146,242,174,416,
8770,3225,221,178,399,
8771,3250,238,187,425,
8772,3294,262,210,472,
8774,3239,211,180,391,
8775,3141,211,173,384,
8776,3199,247,196,443,
8777,3138,213,176,389,
8778,3218,253,190,443,
8779,3210,244,184,428,
8781,3277,243,195,438,
8782,3117,213,172,385,
8783,3287,238,191,429,
8784,3211,215,164,379,
8785,3209,215,177,392,
8786,3195,217,185,402,
8787,3243,235,166,401,
8788,3332,252,199,451,
8789,3141,234,179,413,
8790,3149,214,204,418,
8791,3244,248,195,443,
8792,3292,258,183,441,
8793,3127,217,170,387,
8794,3234,256,189,445,
8795,3230,228,164,392,
8796,3272,233,183,416,
8797,3147,191,171,362,
8798,3163,208,177,385,
8799,3289,217,176,393,
8800,3205,222,182,404,
8801,3185,230,198,428,
8802,3264,236,162,398,
8805,3238,238,168,406,
8806,3308,216,184,400,
8807,3224,243,180,423,
8808,3147,232,182,414,
8809,3256,238,187,425,
8810,3223,234,187,421,
8811,3208,222,164,386,
8812,3357,254,176,430,
8813,3265,231,177,408,
8814,3256,246,205,451,
8815,60,3,3,6,
8816,3249,220,180,400,
8817,3264,242,175,417,
8818,3004,222,161,383,
8819,3109,226,187,413,
8820,3178,216,206,422,
8821,3141,223,183,406,
8822,3277,214,179,393,
8823,3319,241,179,420,
8824,3306,239,189,428,
8825,3171,207,185,392,
8826,3263,239,169,408,
8827,3236,232,171,403,
8828,3253,231,180,411,
8829,3186,237,180,417,
8830,3226,248,173,421,
8831,3202,242,201,443,
8832,3194,231,186,417,
8833,3174,227,185,412,
8834,3111,236,186,422,
8835,3293,243,195,438,
8836,3138,212,170,382,
8837,3226,208,181,389,
8839,3195,220,203,423,
8840,3242,232,197,429,
8841,3137,237,162,399,
8842,3252,214,195,409,
8843,3251,235,188,423,
8844,3263,237,194,431,
8845,3200,247,189,436,
8846,3169,229,169,398,
8847,3137,205,168,373,
8848,3176,254,188,442,
8849,3263,249,189,438,
8850,3116,252,172,424,
8851,3323,242,194,436,
8852,3318,249,203,452,
8853,3145,234,176,410,
8854,375,21,19,40,
8855,3213,253,179,432,
8856,3112,259,185,444,
8857,3201,227,175,402,
8858,3252,197,180,377,
8859,3186,240,159,399,
8860,3277,252,169,421,
8861,3219,258,197,455,
8862,3243,223,164,387,
8863,3295,217,180,397,
8865,3130,226,161,387,
8867,3178,218,178,396,
8868,3274,233,180,413,
8869,3153,279,160,439,
8870,3189,256,185,441,
8872,3266,234,171,405,
8874,3275,245,187,432,
8875,3269,224,171,395,
8877,2518,190,173,363,
8878,3151,231,198,429,
8879,3166,198,175,373,
8880,3128,205,201,406,
8881,3151,194,186,380,
8882,3181,220,196,416,
8883,3129,226,190,416,
8884,3262,242,184,426,
8885,58,4,3,7,
8886,3191,216,194,410,
8887,3280,229,198,427,
8888,3274,255,192,447,
8889,3168,239,182,421,
8890,3173,223,163,386,
8891,3272,243,160,403,
8892,3144,230,204,434,
8893,3187,216,189,405,
8894,3243,207,194,401,
8895,2397,173,130,303,
8896,3200,242,168,410,
8897,3167,219,183,402,
8898,3200,230,188,418,
8899,3354,249,193,442,
8900,3215,266,188,454,
8901,3087,212,180,392,
8902,3317,240,188,428,
8903,3131,243,176,419,
8904,3218,223,191,414,
8905,3167,219,188,407,
8906,893,80,52,132,
8908,3232,218,178,396,
8909,3257,225,159,384,
8910,3255,241,180,421,
8911,3177,225,165,390,
8912,3221,211,186,397,
8913,3052,216,177,393,
8914,3198,223,184,407,
8915,341,32,14,46,
8916,3267,220,190,410,
8917,3247,202,190,392,
8918,3136,220,160,380,
8920,3104,221,188,409,
8921,3196,229,187,416,
8922,3077,212,183,395,
8923,3136,220,197,417,
8924,3291,220,198,418,
8925,581,39,30,69,
8926,452,38,19,57,
8927,3243,251,185,436,
8928,3200,235,173,408,
8929,3231,219,178,397,
8930,3240,223,168,391,
8931,3284,228,166,394,
8932,3334,260,205,465,
8933,3242,247,183,430,
8934,3253,245,172,417,
8935,3098,237,183,420,
8936,3261,222,155,377,
8937,3310,219,191,410,
8938,3256,210,191,401,
8939,3143,239,180,419,
8940,3226,242,146,388,
8941,3156,224,189,413,
8942,3202,250,170,420,
8943,3096,217,177,394,
8944,3262,219,189,408,
8945,3168,196,196,392,
8946,3182,235,171,406,
8947,3267,241,176,417,
8948,3255,259,168,427,
8949,3214,215,176,391,
8950,3208,245,200,445,
8951,3182,200,192,392,
8952,3230,248,172,420,
8953,3125,246,172,418,
8954,3279,236,203,439,
8955,3227,233,180,413,
8956,3230,245,174,419,
8958,3306,254,176,430,
8960,3294,236,194,430,
8961,3314,243,195,438,
8962,3126,266,176,442,
8963,3136,248,188,436,
8964,3152,242,189,431,
8965,3372,241,179,420,
8966,3334,245,206,451,
8967,3207,265,207,472,
8968,3190,234,179,413,
8969,3206,279,175,454,
8970,3201,230,215,445,
8971,3181,220,174,394,
8972,3184,217,183,400,
8973,3334,215,176,391,
8974,3164,208,166,374,
8975,3247,221,194,415,
8976,3208,224,178,402,
8977,3245,215,200,415,
8978,3231,238,170,408,
8979,3142,194,182,376,
8980,3292,260,200,460,
8981,3235,230,174,404,
8982,3288,236,177,413,
8984,3227,228,179,407,
8985,3173,218,201,419,
8986,3294,253,183,436,
8987,3270,240,179,419,
8988,3218,236,168,404,
8989,3224,233,208,441,
8991,3150,235,171,406,
8992,3032,210,173,383,
8993,3192,245,184,429,
8994,3170,225,195,420,
8995,3251,214,193,407,
8996,3228,221,177,398,
8997,3056,245,171,416,
8998,3307,220,195,415,
9000,3183,221,179,400,
9001,3174,242,151,393,
9002,3212,236,172,408,
9004,3180,233,183,416,
9008,2216,140,125,265,
9009,3304,245,157,402,
9010,531,39,23,62,
9011,3161,224,186,410,
9013,3140,256,184,440,
9014,3231,210,174,384,
9015,958,75,49,124,
9016,3173,235,174,409,
9017,3212,249,189,438,
9018,3083,210,153,363,
9019,3261,260,181,441,
9023,3238,256,184,440,
9024,3304,245,226,471,
9025,3291,242,160,402,
9026,3134,223,182,405,
9027,3123,230,181,411,
9028,3188,234,178,412,
9029,3271,235,184,419,
9032,3263,230,188,418,
9034,187,11,9,20,
9035,3317,230,191,421,
9036,2775,224,161,385,
9037,3276,212,169,381,
9039,3226,214,217,431,
9042,3326,230,193,423,
9043,3123,228,167,395,
9044,3199,241,164,405,
9045,3177,236,180,416,
9046,3139,233,196,429,
9047,3196,205,207,412,
9049,3333,226,189,415,
9050,3263,232,192,424,
9051,3329,260,176,436,
9052,3166,181,197,378,
9053,3258,242,171,413,
9055,3244,248,192,440,
9056,3217,233,185,418,
9057,3294,244,185,429,
9058,3248,244,170,414,
9059,3157,220,169,389,
9060,3183,219,188,407,
9062,3163,251,165,416,
9063,3213,236,171,407,
9064,3251,253,160,413,
9065,3195,260,175,435,
9066,3186,246,192,438,
9068,87,4,6,10,
9069,3275,241,216,457,
9070,3218,230,217,447,
9071,3291,238,188,426,
9072,3263,249,185,434,
9073,3199,223,181,404,
9074,3187,217,179,396,
9075,3219,212,177,389,
9076,3217,245,180,425,
9077,3278,207,197,404,
9078,3121,218,178,396,
9079,3251,272,175,447,
9080,3151,219,217,436,
9081,3118,206,182,388,
9082,3249,234,188,422,
9083,3217,249,205,454,
9084,3220,232,185,417,
9085,3244,242,184,426,
9086,3244,211,190,401,
9087,3248,234,184,418,
9088,3186,227,191,418,
9089,3258,262,216,478,
9090,3118,253,176,429,
9091,3297,217,174,391,
9092,3222,243,182,425,
9093,3125,190,207,397,
9094,3296,225,180,405,
9095,3172,235,186,421,
9096,3155,252,194,446,
9097,136,12,9,21,
9098,3160,219,177,396,
9099,3163,217,173,390,
9100,3164,218,197,415,
9101,3212,232,186,418,
9102,3173,222,163,385,
9103,3176,254,177,431,
9104,3210,233,151,384,
9105,3032,213,171,384,
9106,3113,223,174,397,
9107,3015,188,191,379,
9108,3200,242,178,420,
9111,3190,232,183,415,
9112,3185,213,169,382,
9113,3306,265,183,448,
9114,3251,244,157,401,
9115,3274,223,178,401,
9116,3127,201,172,373,
9117,3284,237,175,412,
9118,3272,225,192,417,
9119,3221,250,194,444,
9120,3151,257,186,443,
9121,3185,231,167,398,
9122,3153,203,210,413,
9123,3206,232,174,406,
9124,3210,225,168,393,
9125,3136,238,179,417,
9126,3335,238,199,437,
9127,3216,238,183,421,
9128,3318,222,188,410,
9129,3179,213,175,388,
9131,3307,236,172,408,
9132,3290,248,181,429,
9133,3088,224,169,393,
9134,3049,249,186,435,
9135,3289,212,203,415,
9137,3230,239,172,411,
9138,3155,248,181,429,
9139,3186,238,143,381,
9140,3195,235,201,436,
9141,3266,237,171,408,
9142,3221,226,170,396,
9143,3162,208,163,371,
9145,3113,235,178,413,
9146,3205,215,207,422,
9147,3268,236,191,427,
9148,3150,269,179,448,
9149,3247,213,179,392,
9150,2608,195,164,359,
9151,3270,236,167,403,
9152,3165,223,186,409,
9153,3177,234,182,416,
9155,3215,234,191,425,
9156,3188,220,168,388,
9157,3255,213,183,396,
9159,3265,226,182,408,
9160,3265,265,178,443,
9161,3254,234,175,409,
9162,3190,256,174,430,
9163,3254,232,193,425,
9164,3117,242,173,415,
9165,3117,260,199,459,
9166,3142,227,175,402,
9167,3256,239,180,419,
9169,3222,226,176,402,
9170,3263,243,176,419,
9171,3263,259,196,455,
9172,3197,231,183,414,
9173,94,8,5,13,
9174,3186,235,197,432,
9175,3205,248,188,436,
9176,3314,248,160,408,
9177,3146,227,181,408,
9178,3180,233,186,419,
9180,3343,241,184,425,
9181,3263,269,191,460,
9182,3312,259,193,452,
9183,3302,234,192,426,
9184,3199,220,181,401,
9185,3198,224,172,396,
9186,3137,227,177,404,
9187,3150,225,162,387,
9188,3176,229,184,413,
9189,3251,256,178,434,
9190,3150,229,165,394,
9191,3223,238,192,430,
9192,3140,233,179,412,
9193,3197,229,199,428,
9194,3144,224,179,403,
9195,3218,222,177,399,
9196,3223,227,200,427,
9197,79,10,4,14,
9198,3166,236,171,407,
9199,3226,241,175,416,
9201,3199,256,200,456,
9202,2523,170,154,324,
9204,3203,237,197,434,
9205,3213,229,175,404,
9206,3197,245,187,432,
9207,3235,252,193,445,
9208,3277,229,168,397,
9209,3262,209,218,427,
9210,3215,236,171,407,
9211,3163,230,170,400,
9212,3104,213,179,392,
9213,3279,213,176,389,
9214,763,66,44,110,
9215,3150,249,183,432,
9216,3164,231,205,436,
9217,3248,256,168,424,
9218,3187,225,166,391,
9219,3222,253,199,452,
9220,3179,203,183,386,
9221,3230,233,214,447,
9222,3232,227,170,397,
9223,3368,267,188,455,
9224,3186,247,157,404,
9225,10,1,3,4,
9226,3225,217,149,366,
9228,3162,230,171,401,
9230,3257,234,203,437,
9232,3225,244,172,416,
9234,3235,226,183,409,
9236,3178,241,189,430,
9237,3177,206,168,374,
9238,3206,231,191,422,
9239,3222,220,180,400,
9240,3180,229,179,408,
9241,3272,241,216,457,
9242,3164,229,171,400,
9243,3305,227,187,414,
9244,3233,218,185,403,
9245,3250,240,208,448,
9246,3180,220,188,408,
9247,3089,228,183,411,
9249,3289,210,207,417,
9250,3292,205,204,409,
9251,3208,234,173,407,
9252,3293,233,180,413,
9253,3263,229,206,435,
9254,3169,227,187,414,
9255,3191,234,169,403,
9256,3275,248,180,428,
9257,3237,238,184,422,
9258,3230,251,198,449,
9259,3204,204,184,388,
9260,3180,240,168,408,
9261,3280,242,194,436,
9262,3181,236,183,419,
9263,3083,198,183,381,
9264,3221,249,209,458,
9265,3207,228,175,403,
9266,3264,233,206,439,
9267,3225,227,200,427,
9268,3294,222,190,412,
9270,3137,206,187,393,
9271,3187,224,178,402,
9272,3245,235,174,409,
9273,3291,241,197,438,
9274,3235,216,205,421,
9275,3138,250,166,416,
9276,3262,241,198,439,
9277,3123,234,173,407,
9278,3165,246,170,416,
9279,3249,217,179,396,
9280,3232,239,170,409,
9281,3365,235,197,432,
9282,3273,253,196,449,
9283,3304,257,185,442,
9284,3233,232,198,430,
9285,3114,222,175,397,
9286,3185,241,147,388,
9287,3359,243,195,438,
9288,3318,227,194,421,
9290,3192,242,206,448,
9291,3179,218,181,399,
9292,3095,231,198,429,
9293,77,4,7,11,
9294,3257,212,176,388,
9295,3185,230,173,403,
9296,3148,232,181,413,
9297,3122,205,187,392,
9298,3120,224,188,412,
9299,3142,199,160,359,
9301,3138,224,166,390,
9302,3235,243,187,430,
9303,3347,243,203,446,
9304,3287,216,203,419,
9305,3209,232,191,423,
9306,3217,232,183,415,
9307,3199,252,187,439,
9308,3130,198,166,364,
9310,3251,221,165,386,
9312,3245,248,185,433,
9313,3124,218,177,395,
9314,3248,258,178,436,
9316,3204,247,198,445,
9317,2721,201,143,344,
9318,3252,237,183,420,
9319,3262,238,193,431,
9320,3166,218,169,387,
9321,3230,247,187,434,
9322,3229,247,176,423,
9323,3362,223,185,408,
9324,3191,232,178,410,
9325,3229,249,211,460,
9326,156,10,10,20,
9327,3258,208,206,414,
9328,3003,193,159,352,
9329,3109,259,164,423,
9330,3167,192,177,369,
9331,3313,245,183,428,
9332,3213,259,169,428,
9333,3179,232,181,413,
9334,3182,249,187,436,
9335,3074,236,188,424,
9336,3299,244,174,418,
9337,3236,246,191,437,
9338,3290,270,182,452,
9340,3171,219,179,398,
9341,3233,205,179,384,
9342,3245,244,177,421,
9343,3215,225,193,418,
9344,3149,240,167,407,
9345,3281,262,185,447,
9346,3235,244,187,431,
9347,3054,198,175,373,
9348,3254,221,186,407,
9349,3163,212,190,402,
9350,3160,226,193,419,
9351,3136,241,184,425,
9352,3294,259,177,436,
9353,3327,236,190,426,
9354,3202,217,196,413,
9355,196,13,6,19,
9356,3147,243,194,437,
9357,3169,217,183,400,
9358,3262,249,191,440,
9359,3224,230,205,435,
9360,3283,233,158,391,
9361,3174,224,168,392,
9362,3154,234,177,411,
9363,3287,252,178,430,
9364,3122,202,175,377,
9365,3108,210,206,416,
9366,3164,217,180,397,
9368,3258,235,182,417,
9369,3295,227,195,422,
9370,3253,232,183,415,
9371,3201,241,176,417,
9372,3210,241,187,428,
9373,3163,257,189,446,
9374,3264,244,202,446,
9375,3248,240,187,427,
9376,3182,203,179,382,
9377,3193,231,187,418,
9378,3214,221,200,421,
9379,3164,225,204,429,
9380,3068,226,176,402,
9381,3137,220,174,394,
9382,3114,222,175,397,
9383,3195,227,192,419,
9384,3265,255,180,435,
9385,3162,229,164,393,
9386,3209,231,202,433,
9387,3124,217,172,389,
9388,3280,230,183,413,
9389,3143,228,162,390,
9390,3270,256,192,448,
9391,3313,260,178,438,
9392,3253,218,205,423,
9393,3217,237,173,410,
9394,3214,223,204,427,
9395,3202,223,174,397,
9396,3186,236,169,405,
9397,3136,256,169,425,
9398,3353,266,191,457,
9399,3279,230,194,424,
9400,3112,236,181,417,
9401,3217,234,182,416,
9402,3257,242,181,423,
9403,3222,235,191,426,
9404,3178,217,184,401,
9405,3206,217,190,407,
9406,3175,239,187,426,
9407,3227,250,182,432,
9408,3140,216,158,374,
9409,3288,229,203,432,
9410,3220,210,192,402,
9411,3185,224,181,405,
9412,3172,235,168,403,
9413,3213,245,193,438,
9414,3238,234,190,424,
9415,3269,244,161,405,
9416,345,19,13,32,
9417,3200,234,185,419,
9418,3385,254,192,446,
9419,3151,231,185,416,
9420,3231,234,160,394,
9421,3210,250,165,415,
9422,3213,231,155,386,
9423,88,8,5,13,
9424,3253,230,198,428,
9425,3102,224,165,389,
9426,3102,223,166,389,
9427,3287,232,189,421,
9428,3279,247,184,431,
9429,3203,222,183,405,
9431,285,22,17,39,
9432,303,20,18,38,
9434,3183,214,167,381,
9435,3309,241,199,440,
9436,3112,195,180,375,
9437,3197,233,176,409,
9438,3199,240,173,413,
9439,3248,233,160,393,
9440,3336,262,176,438,
9441,3086,217,160,377,
9442,3262,268,212,480,
9443,3088,244,166,410,
9444,3260,234,178,412,
9445,3173,225,168,393,
9446,3257,260,167,427,
9448,3312,234,186,420,
9449,3179,221,181,402,
9450,3229,223,209,432,
9451,3264,238,189,427,
9453,3042,246,171,417,
9454,3218,232,181,413,
9455,3188,238,175,413,
9457,3229,237,170,407,
9458,3225,238,183,421,
9459,106,13,4,17,
9460,718,61,46,107,
9461,3254,229,208,437,
9462,3189,199,190,389,
9463,3259,207,179,386,
9465,3193,241,186,427,
9466,3211,215,203,418,
9467,3215,231,192,423,
9470,3151,257,179,436,
9471,341,25,16,41,
9472,3250,248,182,430,
9473,3262,263,204,467,
9474,3143,229,193,422,
9475,3206,233,176,409,
9477,3253,237,196,433,
9478,3118,209,206,415,
9479,3308,227,213,440,
9480,3114,238,172,410,
9481,3265,229,195,424,
9482,3248,222,171,393,
9483,3105,223,204,427,
9484,529,42,27,69,
9485,3277,240,163,403,
9486,2494,172,141,313,
9487,3180,238,172,410,
9488,3150,250,195,445,
9489,3174,218,194,412,
9490,3237,236,200,436,
9491,3325,251,206,457,
9492,3196,194,179,373,
9493,3241,262,179,441,
9494,3222,233,195,428,
9495,3136,226,190,416,
9496,3147,191,180,371,
9499,3322,260,185,445,
9500,3302,223,198,421,
9501,3225,223,215,438,
9502,368,23,20,43,
9503,3175,253,170,423,
9504,254,26,13,39,
9505,3167,224,185,409,
9506,3157,200,170,370,
9507,2682,200,144,344,
9508,3211,239,178,417,
9509,3234,241,178,419,
9510,3238,242,196,438,
9512,3244,238,204,442,
9513,3174,235,193,428,
9514,3273,212,184,396,
9515,3051,213,165,378,
9516,3364,259,165,424,
9517,92,4,5,9,
9518,3136,258,166,424,
9519,3285,217,200,417,
9520,3245,253,167,420,
9521,3234,252,158,410,
9522,3207,215,160,375,
9523,3196,243,182,425,
9524,3135,203,167,370,
9525,3240,250,210,460,
9526,245,23,14,37,
9527,3224,241,155,396,
9528,3130,247,185,432,
9529,205,14,14,28,
9530,3195,225,171,396,
9531,3112,214,172,386,
9532,3175,239,195,434,
9534,3151,234,201,435,
9535,3239,244,198,442,
9536,3253,257,174,431,
9537,3197,257,181,438,
9539,3169,226,186,412,
9540,3239,228,177,405,
9541,3199,221,194,415,
9542,3270,224,188,412,
9543,357,36,16,52,
9544,3243,243,185,428,
9545,3250,235,195,430,
9546,3306,265,188,453,
9547,109,10,8,18,
9548,3314,245,192,437,
9549,3157,245,170,415,
9550,3129,244,190,434,
9551,3282,243,196,439,
9552,3101,195,167,362,
9553,3214,206,207,413,
9554,3189,229,206,435,
9555,3282,250,202,452,
9556,3238,195,191,386,
9557,3261,228,192,420,
9558,3179,262,197,459,
9559,3139,222,178,400,
9560,3295,238,195,433,
9561,3211,228,182,410,
9562,3218,236,181,417,
9563,3279,235,175,410,
9564,3219,222,183,405,
9565,3227,225,171,396,
9566,3102,214,172,386,
9567,3148,221,168,389,
9568,3102,235,186,421,
9570,3239,238,180,418,
9571,3190,230,174,404,
9572,3248,224,165,389,
9573,3185,216,176,392,
9574,3294,232,203,435,
9575,3252,231,166,397,
9576,3219,233,193,426,
9577,3274,231,172,403,
9578,3222,237,205,442,
9579,3159,222,149,371,
9581,3126,215,164,379,
9582,3247,234,165,399,
9583,3335,230,193,423,
9584,3173,219,171,390,
9585,3210,251,169,420,
9586,3122,251,182,433,
9588,3235,218,203,421,
9589,3257,239,179,418,
9590,3245,235,208,443,
9591,3241,220,205,425,
9592,3223,215,173,388,
9593,3225,245,171,416,
9594,3329,219,174,393,
9595,3262,246,213,459,
9597,3192,240,190,430,
9598,3255,233,199,432,
9599,3271,236,178,414,
9600,3100,230,190,420,
9601,3184,240,176,416,
9602,3143,245,151,396,
9604,3229,221,169,390,
9606,3290,229,195,424,
9607,3220,232,190,422,
9608,3177,220,177,397,
9609,3098,263,156,419,
9610,3263,242,184,426,
9611,3166,232,191,423,
9612,3286,245,188,433,
9613,3297,247,204,451,
9614,3169,218,185,403,
9615,3232,231,184,415,
9616,3264,219,193,412,
9617,3237,226,180,406,
9618,3212,248,182,430,
9619,3316,241,176,417,
9620,3253,227,183,410,
9621,3209,252,185,437,
9622,3115,217,196,413,
9623,3231,230,181,411,
9624,3335,254,170,424,
9626,3273,228,187,415,
9627,3329,256,196,452,
9628,3164,244,165,409,
9629,3148,229,189,418,
9630,3136,236,169,405,
9631,3192,224,173,397,
9632,3190,226,184,410,
9633,3265,229,209,438,
9634,3242,275,188,463,
9635,3281,252,196,448,
9636,3228,215,155,370,
9637,111,9,7,16,
9638,3223,213,167,380,
9639,3101,233,165,398,
9640,3188,246,184,430,
9641,3116,206,181,387,
9642,3223,221,171,392,
9643,3246,226,180,406,
9644,3194,271,165,436,
9645,3242,223,198,421,
9646,3274,262,175,437,
9647,3184,256,161,417,
9648,3212,194,227,421,
9649,3237,214,184,398,
9650,3148,230,190,420,
9651,3194,239,183,422,
9652,3324,258,165,423,
9653,3270,234,187,421,
9654,3237,240,191,431,
9655,3284,237,194,431,
9656,3182,224,168,392,
9657,3214,229,177,406,
9658,3288,237,200,437,
9659,3233,230,192,422,
9660,3193,232,168,400,
9661,3260,220,182,402,
9662,3232,242,171,413,
9664,3299,230,190,420,
9665,3177,226,176,402,
9666,3249,242,185,427,
9667,3200,244,194,438,
9668,3223,250,189,439,
9670,3262,237,180,417,
9671,3197,211,173,384,
9672,3231,239,179,418,
9673,52,3,4,7,
9674,3335,257,175,432,
9676,3161,195,187,382,
9677,695,53,38,91,
9678,3292,260,192,452,
9679,3252,214,184,398,
9680,3239,239,165,404,
9681,3219,235,179,414,
9682,364,29,18,47,
9683,3202,220,185,405,
9684,3198,246,177,423,
9685,3112,242,172,414,
9686,3131,247,167,414,
9687,61,3,3,6,
9690,3123,250,162,412,
9691,3223,228,167,395,
9692,3136,237,152,389,
9693,25,1,1,2,
9694,3191,238,189,427,
9695,3261,222,193,415,
9696,3271,259,170,429,
9698,3193,192,182,374,
9699,3305,229,205,434,
9700,3127,216,181,397,
9702,3257,206,192,398,
9703,3146,239,178,417,
9704,3235,238,208,446,
9705,3241,236,206,442,
9706,3294,206,193,399,
9707,3219,262,183,445,
9708,3156,237,163,400,
9709,3259,240,185,425,
9710,99,9,6,15,
9711,3219,245,156,401,
9712,3123,205,197,402,
9713,3181,218,173,391,
9714,3200,220,217,437,
9715,3209,238,194,432,
9716,3295,242,178,420,
9717,3174,234,165,399,
9718,3220,202,180,382,
9720,3211,242,186,428,
9721,3247,232,171,403,
9722,3319,263,201,464,
9723,3239,218,185,403,
9724,3238,225,200,425,
9726,3221,208,181,389,
9727,3192,202,164,366,
9728,3235,249,185,434,
9729,3080,243,166,409,
9730,3194,243,188,431,
9731,3246,213,190,403,
9732,449,30,27,57,
9733,2788,192,159,351,
9734,3215,231,190,421,
9735,3097,251,157,408,
9736,2265,171,118,289,
9737,3258,266,170,436,
9738,3131,269,184,453,
9739,3290,256,193,449,
9740,3158,227,201,428,
9741,3221,229,161,390,
9742,3133,199,172,371,
9743,3203,231,174,405,
9744,3238,239,161,400,
9745,3083,230,131,361,
9746,3229,220,189,409,
9747,3248,207,180,387,
9748,3221,215,182,397,
9749,3187,215,173,388,
9750,3361,249,214,463,
9751,3116,230,164,394,
9752,3273,208,184,392,
9753,3197,233,165,398,
9754,3107,229,206,435,
9755,422,32,30,62,
9757,3200,240,208,448,
9758,3210,221,172,393,
9759,3199,205,190,395,
9760,3138,218,197,415,
9761,3296,258,184,442,
9762,3253,227,184,411,
9763,3235,251,182,433,
9764,3265,233,208,441,
9765,3201,244,171,415,
9766,2357,161,148,309,
9767,3220,194,185,379,
9768,3318,232,175,407,
9769,2545,208,137,345,
9770,3210,243,184,427,
9771,3270,207,186,393,
9772,3220,257,168,425,
9773,3207,218,153,371,
9774,3112,224,176,400,
9775,3251,218,173,391,
9776,3159,225,182,407,
9777,3207,234,192,426,
9778,3234,250,169,419,
9779,3254,246,191,437,
9780,3192,243,186,429,
9781,3220,243,193,436,
9782,3209,241,194,435,
9783,3191,248,193,441,
9785,3189,205,204,409,
9787,3275,249,187,436,
9788,3136,235,186,421,
9789,3203,267,190,457,
9791,3159,206,165,371,
9792,3252,225,186,411,
9793,3163,227,168,395,
9794,3234,254,183,437,
9795,3232,226,174,400,
9796,3220,226,196,422,
9797,3156,212,181,393,
9798,3182,232,186,418,
9799,3172,218,197,415,
9800,3164,227,191,418,
9801,3256,232,195,427,
9802,3070,198,172,370,
9803,3217,213,178,391,
9804,3097,217,172,389,
9805,3231,213,178,391,
9807,3217,203,192,395,
9808,3116,227,186,413,
9809,3274,222,190,412,
9810,3224,221,173,394,
9811,3217,226,177,403,
9812,3184,220,190,410,
9813,3313,249,197,446,
9814,3264,257,191,448,
9815,3277,231,166,397,
9816,3221,239,184,423,
9818,3169,243,196,439,
9819,3224,216,191,407,
9820,3200,239,184,423,
9821,3241,216,174,390,
9822,3239,248,188,436,
9823,3256,225,189,414,
9824,93,8,7,15,
9825,3205,230,178,408,
9826,3229,213,183,396,
9827,3306,239,180,419,
9829,3192,239,163,402,
9830,3227,246,185,431,
9831,3244,235,174,409,
9832,3194,228,175,403,
9833,3127,183,205,388,
9834,3289,243,185,428,
9835,3273,218,174,392,
9836,3175,248,199,447,
9837,3227,220,184,404,
9838,3289,234,173,407,
9839,3261,226,179,405,
9840,3190,216,160,376,
9841,3247,226,185,411,
9842,3206,246,159,405,
9843,3260,227,170,397,
9844,347,22,16,38,
9845,3208,221,186,407,
9846,3106,226,155,381,
9847,3240,223,184,407,
9848,3154,203,188,391,
9849,3236,238,171,409,
9850,3293,249,198,447,
9851,3195,234,161,395,
9853,3190,205,168,373,
9854,3151,231,200,431,
9855,3250,238,188,426,
9856,3206,230,177,407,
9857,3223,242,197,439,
9858,3227,231,175,406,
9859,3212,237,184,421,
9860,3241,248,209,457,
9861,3398,238,190,428,
9862,3159,247,165,412,
9863,3209,215,174,389,
9864,3228,211,177,388,
9865,3221,240,179,419,
9866,294,20,20,40,
9867,3213,254,165,419,
9868,3223,236,178,414,
9869,3227,216,188,404,
9870,2524,200,150,350,
9871,3152,202,161,363,
9872,3240,234,191,425,
9873,3157,242,180,422,
9874,3105,247,177,424,
9875,3172,239,165,404,
9876,3261,240,207,447,
9877,3191,229,182,411,
9878,3178,224,148,372,
9879,3089,241,178,419,
9880,3258,219,182,401,
9881,3252,246,181,427,
9882,3372,254,190,444,
9883,3193,249,186,435,
9884,2155,166,107,273,
9886,3236,234,196,430,
9887,3147,188,187,375,
9889,3237,230,165,395,
9890,3241,247,189,436,
9891,3281,253,196,449,
9892,3109,242,176,418,
9893,3137,201,172,373,
9894,3220,202,174,376,
9896,3128,236,170,406,
9897,3143,231,173,404,
9898,3267,259,174,433,
9899,3244,236,154,390,
9900,3170,241,165,406,
9901,3255,236,164,400,
9902,3271,223,166,389,
9903,3209,234,171,405,
9904,3178,189,189,378,
9905,3181,252,180,432,
9906,3204,237,196,433,
9908,3251,278,165,443,
9910,3204,243,166,409,
9911,3160,232,168,400,
9912,3232,238,166,404,
9913,2332,180,116,296,
9914,3221,240,167,407,
9915,3224,225,201,426,
9916,3265,231,179,410,
9917,3286,241,166,407,
9918,3204,229,193,422,
9919,3124,202,182,384,
9920,3199,202,182,384,
9921,3362,229,201,430,
9922,3224,217,164,381,
9923,3182,260,193,453,
9925,3122,224,160,384,
9926,3176,213,188,401,
9927,3234,222,176,398,
9928,3184,233,183,416,
9929,3147,218,188,406,
9930,3330,209,179,388,
9931,3240,214,203,417,
9932,3218,214,190,404,
9933,3226,269,206,475,
9934,3287,242,177,419,
9935,3269,252,178,430,
9936,3232,243,172,415,
9937,3344,258,188,446,
9938,3184,246,169,415,
9940,3278,235,182,417,
9941,3154,224,185,409,
9943,3204,227,178,405,
9944,3261,241,216,457,
9945,3175,253,159,412,
9946,3220,245,164,409,
9947,3190,243,186,429,
9949,3148,214,198,412,
9951,3166,226,203,429,
9952,3211,212,200,412,
9953,3194,213,179,392,
9954,3226,255,181,436,
9955,3210,242,176,418,
9956,3298,233,202,435,
9957,16,1,1,2,
9958,2489,153,160,313,
9959,3275,246,176,422,
9960,320,23,17,40,
9961,3247,229,184,413,
9962,3224,229,204,433,
9963,3234,247,169,416,
9964,3170,207,207,414,
9965,3239,242,203,445,
9966,3134,231,160,391,
9967,3142,213,184,397,
9968,3136,230,175,405,
9969,3234,227,171,398,
9970,3271,228,196,424,
9971,3254,199,176,375,
9972,3226,234,196,430,
9973,3197,211,171,382,
9974,3273,254,186,440,
9975,3108,268,167,435,
9976,3157,211,156,367,
9977,109,12,10,22,
9978,3117,213,200,413,
9980,3284,256,173,429,
9981,3184,219,160,379,
9982,3254,229,185,414,
9984,3255,228,190,418,
9985,3291,239,175,414,
9986,3196,249,197,446,
9987,3130,209,179,388,
9988,3277,211,193,404,
9989,3161,214,174,388,
9990,3258,250,200,450,
9991,3285,241,164,405,
9992,3109,224,184,408,
9993,3276,247,205,452,
9994,3270,249,185,434,
9995,3188,229,204,433,
9996,3136,219,167,386,
9997,3138,189,194,383,
9998,3289,236,184,420,
9999,3342,241,195,436,
