eventID,numPhotons,numReachedDown,numReachedUp,numPE,
0,995,73,58,131,
1,1003,82,65,147,
2,1071,70,68,138,
3,1084,82,73,155,
4,988,81,56,137,
5,984,79,57,136,
6,1022,81,57,138,
7,990,81,69,150,
8,1024,67,59,126,
9,1051,70,63,133,
10,1037,74,49,123,
11,1066,81,80,161,
12,981,79,67,146,
13,1063,68,67,135,
14,1040,69,59,128,
15,1003,87,58,145,
16,1026,71,63,134,
17,1031,66,60,126,
18,983,61,58,119,
19,1035,69,61,130,
20,1030,81,55,136,
21,1038,75,67,142,
22,985,63,49,112,
23,1046,72,59,131,
24,1009,64,67,131,
25,1040,66,46,112,
26,1016,83,62,145,
27,1030,77,62,139,
28,1061,64,50,114,
29,1048,76,51,127,
30,1036,86,49,135,
31,1047,80,64,144,
32,1029,63,58,121,
33,1059,90,50,140,
34,1055,75,53,128,
35,1013,88,49,137,
36,1028,87,55,142,
37,985,71,50,121,
38,993,68,54,122,
39,996,69,54,123,
40,1033,71,67,138,
41,978,69,57,126,
42,1010,66,54,120,
43,991,73,53,126,
44,1014,65,51,116,
45,996,80,60,140,
46,1051,77,54,131,
47,1031,73,56,129,
48,963,51,57,108,
49,996,59,50,109,
50,1040,78,58,136,
51,1073,80,54,134,
52,1022,83,59,142,
53,1044,84,63,147,
54,1062,58,61,119,
55,1030,60,78,138,
56,953,57,54,111,
57,1053,76,52,128,
58,1079,87,54,141,
59,1035,82,51,133,
60,1059,85,57,142,
61,988,72,49,121,
62,992,79,43,122,
63,985,79,56,135,
64,1007,67,53,120,
65,1012,74,56,130,
66,1069,77,60,137,
67,1005,63,59,122,
68,1101,81,53,134,
69,995,72,76,148,
70,969,66,58,124,
71,1001,68,58,126,
72,1004,71,56,127,
73,969,77,58,135,
74,1021,89,48,137,
75,1024,84,50,134,
76,1005,71,57,128,
77,1003,80,63,143,
78,1014,75,54,129,
79,1031,88,58,146,
80,1043,84,53,137,
81,1053,76,55,131,
82,934,57,46,103,
83,981,61,59,120,
84,1013,83,55,138,
85,1073,78,59,137,
86,1035,81,69,150,
87,1013,96,53,149,
88,1052,93,58,151,
89,1006,62,58,120,
90,1027,72,53,125,
91,1021,74,47,121,
92,995,85,55,140,
93,1036,63,56,119,
94,1005,69,59,128,
95,1019,54,63,117,
96,968,57,42,99,
97,1020,71,66,137,
98,1036,66,58,124,
99,1041,76,73,149,
100,1034,71,57,128,
101,956,64,52,116,
102,993,79,53,132,
103,986,77,51,128,
104,914,67,52,119,
105,1072,76,61,137,
106,1029,76,59,135,
107,1049,83,64,147,
108,1011,65,53,118,
109,934,64,50,114,
110,990,76,56,132,
111,1023,65,68,133,
112,969,68,44,112,
113,1005,63,52,115,
114,1053,79,42,121,
115,1024,71,60,131,
116,1079,83,63,146,
117,1036,77,73,150,
118,998,70,56,126,
119,1021,82,63,145,
120,1015,72,66,138,
121,1032,69,57,126,
122,1052,72,59,131,
123,1034,67,55,122,
124,1009,78,50,128,
125,1048,80,59,139,
126,988,67,64,131,
127,1011,71,52,123,
128,997,65,60,125,
129,1021,74,69,143,
130,1002,63,53,116,
131,968,69,54,123,
132,997,79,51,130,
133,1005,62,63,125,
134,998,60,44,104,
135,989,75,65,140,
136,981,76,58,134,
137,978,62,54,116,
138,1021,86,57,143,
139,1057,70,69,139,
140,997,75,65,140,
141,998,84,55,139,
142,943,51,55,106,
143,1030,91,72,163,
144,980,76,54,130,
145,1027,86,50,136,
146,974,67,63,130,
147,1017,72,68,140,
148,968,71,59,130,
149,1040,59,73,132,
150,1096,79,59,138,
151,1027,91,52,143,
152,1050,84,65,149,
153,1047,73,64,137,
154,1045,89,57,146,
155,1029,69,55,124,
156,1081,65,63,128,
157,1023,68,75,143,
158,960,78,45,123,
159,1012,62,62,124,
160,1021,75,61,136,
161,1015,72,59,131,
162,1007,74,55,129,
163,1038,76,49,125,
164,1047,74,52,126,
165,984,64,66,130,
166,992,74,43,117,
167,980,71,44,115,
168,1021,80,61,141,
169,1059,85,65,150,
170,1048,87,53,140,
171,1014,81,70,151,
172,1034,74,50,124,
173,1045,95,58,153,
174,962,70,56,126,
175,1049,80,57,137,
176,1057,67,62,129,
177,1045,84,46,130,
178,1053,77,46,123,
179,1072,65,63,128,
180,1053,60,55,115,
181,1044,84,65,149,
182,1047,66,61,127,
183,1058,79,63,142,
184,1009,54,59,113,
185,1040,80,50,130,
186,1038,86,68,154,
187,990,76,57,133,
188,1017,69,54,123,
189,958,76,58,134,
190,992,83,55,138,
191,1009,84,73,157,
192,1010,66,51,117,
193,1052,92,78,170,
194,983,64,54,118,
195,970,73,53,126,
196,1020,68,58,126,
197,1036,80,53,133,
198,1037,90,62,152,
199,981,56,50,106,
200,977,76,55,131,
201,981,73,53,126,
202,1048,93,49,142,
203,999,72,53,125,
204,989,73,49,122,
205,1055,75,65,140,
206,921,75,60,135,
207,1023,76,63,139,
208,1046,83,64,147,
209,1002,57,62,119,
210,1016,105,56,161,
211,1003,70,54,124,
212,984,69,58,127,
213,1045,87,50,137,
214,1048,67,54,121,
215,1041,71,62,133,
216,993,65,50,115,
217,1019,66,54,120,
218,969,70,69,139,
219,997,64,60,124,
220,1060,82,57,139,
221,1027,66,71,137,
222,1035,63,72,135,
223,1046,76,50,126,
224,1053,58,47,105,
225,966,59,44,103,
226,1016,76,62,138,
227,951,66,45,111,
228,1006,72,49,121,
229,1026,75,44,119,
230,1060,73,74,147,
231,1017,60,74,134,
232,1026,65,56,121,
233,1024,69,59,128,
234,1056,71,75,146,
235,994,75,65,140,
236,1017,74,50,124,
237,1002,61,58,119,
238,984,71,57,128,
239,1030,74,54,128,
240,999,72,54,126,
241,1012,73,49,122,
242,991,75,72,147,
243,1034,77,47,124,
244,1017,68,66,134,
245,965,69,54,123,
246,999,76,68,144,
247,987,71,48,119,
248,1057,75,57,132,
249,981,63,56,119,
250,1053,70,75,145,
251,945,64,45,109,
252,987,60,73,133,
253,1014,82,68,150,
254,1037,77,67,144,
255,1054,79,67,146,
256,1017,73,62,135,
257,1022,70,56,126,
258,1012,67,52,119,
259,930,62,49,111,
260,994,73,56,129,
261,989,76,61,137,
262,1057,84,62,146,
263,991,70,58,128,
264,1021,70,61,131,
265,1019,79,60,139,
266,1034,88,61,149,
267,1059,71,63,134,
268,1021,84,70,154,
269,963,82,57,139,
270,1082,74,70,144,
271,1058,81,62,143,
272,1032,94,46,140,
273,974,66,54,120,
274,1047,58,48,106,
275,1062,95,50,145,
276,992,70,69,139,
277,1030,77,64,141,
278,961,73,45,118,
279,997,70,64,134,
280,1040,68,56,124,
281,981,70,63,133,
282,1023,67,63,130,
283,965,71,58,129,
284,998,78,65,143,
285,1007,71,68,139,
286,979,71,62,133,
287,1032,80,56,136,
288,1022,65,71,136,
289,955,67,56,123,
290,1057,71,62,133,
291,1028,73,50,123,
292,995,75,55,130,
293,1011,73,69,142,
294,980,73,53,126,
295,1045,71,56,127,
296,1049,57,71,128,
297,1023,93,49,142,
298,1043,77,66,143,
299,1060,74,65,139,
300,1081,79,63,142,
301,988,67,58,125,
302,1068,77,68,145,
303,972,54,53,107,
304,1042,71,63,134,
305,1009,60,60,120,
306,988,72,62,134,
307,965,99,51,150,
308,1087,74,78,152,
309,1037,78,56,134,
310,992,66,55,121,
311,1001,70,61,131,
312,1048,70,49,119,
313,1020,79,52,131,
314,1084,87,55,142,
315,1053,77,56,133,
316,1054,91,52,143,
317,994,67,55,122,
318,986,64,55,119,
319,970,66,46,112,
320,996,70,62,132,
321,1055,72,63,135,
322,1059,82,58,140,
323,1000,64,67,131,
324,1016,86,39,125,
325,1029,84,52,136,
326,1005,83,60,143,
327,948,64,61,125,
328,985,84,52,136,
329,1027,78,64,142,
330,977,57,59,116,
331,1009,80,61,141,
332,1052,91,53,144,
333,1051,77,69,146,
334,993,74,45,119,
335,1020,78,72,150,
336,1033,88,62,150,
337,993,73,60,133,
338,1046,76,45,121,
339,1055,69,66,135,
340,941,74,59,133,
341,1032,72,55,127,
342,924,53,62,115,
343,1026,72,58,130,
344,992,79,54,133,
345,983,73,63,136,
346,1030,74,49,123,
347,992,64,53,117,
348,987,78,65,143,
349,1004,77,53,130,
350,992,58,63,121,
351,1051,80,47,127,
352,1015,72,47,119,
353,1074,66,69,135,
354,991,69,53,122,
355,1012,69,54,123,
356,992,56,58,114,
357,1066,70,71,141,
358,1070,74,60,134,
359,1057,83,58,141,
360,966,62,48,110,
361,1017,76,56,132,
362,1026,66,62,128,
363,1030,71,56,127,
364,974,77,51,128,
365,1000,75,55,130,
366,1092,91,57,148,
367,1033,71,60,131,
368,1019,63,56,119,
369,1027,65,51,116,
370,999,81,58,139,
371,1049,86,61,147,
372,1056,84,52,136,
373,1035,75,62,137,
374,1038,57,58,115,
375,1026,79,83,162,
376,989,73,58,131,
377,969,60,58,118,
378,1065,89,53,142,
379,1021,77,68,145,
380,1041,60,67,127,
381,1004,72,50,122,
382,1033,81,66,147,
383,1025,87,48,135,
384,1070,77,68,145,
385,1027,77,71,148,
386,982,70,49,119,
387,1019,67,60,127,
388,1043,79,56,135,
389,986,67,49,116,
390,1012,83,56,139,
391,1111,67,67,134,
392,1060,85,56,141,
393,1032,83,73,156,
394,1047,85,68,153,
395,1069,67,63,130,
396,954,71,38,109,
397,1000,63,51,114,
398,988,90,50,140,
399,1065,83,59,142,
400,1063,73,58,131,
401,973,63,45,108,
402,1024,78,52,130,
403,1003,66,58,124,
404,1043,69,53,122,
405,1008,82,51,133,
406,997,64,46,110,
407,1073,83,73,156,
408,1040,77,57,134,
409,999,67,54,121,
410,1001,74,53,127,
411,1046,81,56,137,
412,1018,82,61,143,
413,1002,70,64,134,
414,1066,74,56,130,
415,1037,77,57,134,
416,997,66,71,137,
417,1063,79,69,148,
418,989,77,48,125,
419,1012,71,65,136,
420,981,74,63,137,
421,998,72,56,128,
422,999,78,62,140,
423,1038,82,50,132,
424,1034,78,54,132,
425,1036,75,56,131,
426,1004,68,54,122,
427,1014,74,56,130,
428,1057,74,49,123,
429,1055,81,56,137,
430,997,82,50,132,
431,1021,63,55,118,
432,999,71,64,135,
433,963,66,43,109,
434,1032,84,53,137,
435,1048,70,61,131,
436,989,64,66,130,
437,946,74,49,123,
438,995,77,56,133,
439,1033,73,59,132,
440,959,73,61,134,
441,959,73,50,123,
442,991,67,56,123,
443,1075,80,64,144,
444,1039,65,53,118,
445,1058,88,60,148,
446,1023,66,51,117,
447,1018,60,59,119,
448,1026,70,65,135,
449,1032,81,67,148,
450,1040,74,64,138,
451,1065,89,58,147,
452,985,75,56,131,
453,1000,75,49,124,
454,989,74,49,123,
455,1074,73,73,146,
456,1116,73,69,142,
457,1013,72,55,127,
458,1019,81,52,133,
459,999,79,56,135,
460,999,78,42,120,
461,1011,81,64,145,
462,937,79,51,130,
463,1000,79,51,130,
464,1009,69,54,123,
465,1063,69,46,115,
466,1062,78,55,133,
467,1001,62,55,117,
468,993,78,48,126,
469,1039,71,72,143,
470,992,74,65,139,
471,999,67,63,130,
472,1076,84,53,137,
473,1036,64,64,128,
474,1047,72,72,144,
475,1027,73,56,129,
476,1017,73,61,134,
477,1021,77,71,148,
478,1011,87,47,134,
479,1026,66,54,120,
480,1043,73,57,130,
481,1082,74,58,132,
482,1087,76,67,143,
483,1048,73,62,135,
484,1018,65,61,126,
485,989,78,45,123,
486,951,75,55,130,
487,1028,68,56,124,
488,1064,86,67,153,
489,980,72,54,126,
490,947,84,57,141,
491,1017,83,62,145,
492,1022,63,64,127,
493,990,78,54,132,
494,1034,72,60,132,
495,988,59,51,110,
496,967,72,57,129,
497,1022,75,59,134,
498,1039,59,52,111,
499,1031,72,70,142,
500,987,74,63,137,
501,1039,73,64,137,
502,1012,64,36,100,
503,1031,76,51,127,
504,998,72,48,120,
505,1025,72,70,142,
506,1059,80,67,147,
507,1006,64,54,118,
508,955,75,55,130,
509,1055,69,57,126,
510,1027,87,57,144,
511,1015,69,59,128,
512,1046,86,55,141,
513,1014,61,54,115,
514,1036,65,56,121,
515,1004,68,48,116,
516,1030,75,55,130,
517,1004,83,47,130,
518,1054,76,61,137,
519,1000,67,51,118,
520,1014,82,50,132,
521,1030,71,57,128,
522,1021,89,51,140,
523,1011,77,58,135,
524,1044,78,70,148,
525,999,89,59,148,
526,1036,72,58,130,
527,1007,69,59,128,
528,962,68,50,118,
529,998,64,54,118,
530,987,64,50,114,
531,966,74,62,136,
532,1037,76,70,146,
533,1083,99,54,153,
534,1045,72,50,122,
535,1047,78,56,134,
536,1077,67,68,135,
537,1050,82,64,146,
538,1019,62,46,108,
539,1050,80,56,136,
540,938,66,49,115,
541,1036,79,67,146,
542,990,84,39,123,
543,1056,74,61,135,
544,984,72,55,127,
545,1010,59,60,119,
546,988,80,58,138,
547,1031,66,48,114,
548,946,70,60,130,
549,1043,77,53,130,
550,1032,65,66,131,
551,1023,52,63,115,
552,989,76,66,142,
553,1079,73,52,125,
554,1010,76,53,129,
555,1015,63,47,110,
556,956,59,56,115,
557,1030,75,66,141,
558,981,74,60,134,
559,1001,68,50,118,
560,984,70,59,129,
561,1069,86,62,148,
562,1016,67,49,116,
563,1009,58,56,114,
564,1029,67,59,126,
565,978,71,66,137,
566,1054,77,58,135,
567,947,71,58,129,
568,1038,52,57,109,
569,1004,80,58,138,
570,1004,72,59,131,
571,1031,85,54,139,
572,1013,69,61,130,
573,1026,87,56,143,
574,1056,90,56,146,
575,968,78,65,143,
576,1054,70,75,145,
577,942,59,41,100,
578,1051,76,52,128,
579,1030,64,60,124,
580,991,65,54,119,
581,980,60,69,129,
582,1017,83,65,148,
583,979,46,71,117,
584,994,63,55,118,
585,1049,82,66,148,
586,1022,74,60,134,
587,999,76,65,141,
588,1000,72,63,135,
589,1012,76,59,135,
590,1010,65,43,108,
591,1022,82,48,130,
592,1020,70,50,120,
593,1054,75,54,129,
594,1054,69,65,134,
595,1045,79,48,127,
596,1031,70,58,128,
597,958,68,66,134,
598,981,61,65,126,
599,950,65,49,114,
600,1066,70,55,125,
601,1028,73,55,128,
602,1001,69,59,128,
603,929,65,64,129,
604,1023,71,61,132,
605,1020,64,65,129,
606,1053,84,78,162,
607,1009,65,64,129,
608,1041,76,54,130,
609,1011,72,61,133,
610,1052,72,58,130,
611,1046,93,60,153,
612,1005,68,55,123,
613,991,72,57,129,
614,1042,80,59,139,
615,1044,77,54,131,
616,1082,88,71,159,
617,1041,67,56,123,
618,1036,77,57,134,
619,1082,66,69,135,
620,1064,79,49,128,
621,1029,87,61,148,
622,1026,75,53,128,
623,1046,71,63,134,
624,1003,69,72,141,
625,932,63,43,106,
626,1003,81,64,145,
627,1021,71,54,125,
628,1026,81,56,137,
629,1015,67,64,131,
630,1004,62,60,122,
631,1013,66,52,118,
632,990,65,60,125,
633,1043,78,56,134,
634,1034,91,62,153,
635,1011,79,66,145,
636,1023,81,66,147,
637,1013,76,63,139,
638,974,62,54,116,
639,1016,71,53,124,
640,1003,78,57,135,
641,1004,91,37,128,
642,1026,81,47,128,
643,1020,69,46,115,
644,965,64,48,112,
645,988,74,45,119,
646,1037,64,65,129,
647,981,74,56,130,
648,962,75,61,136,
649,956,66,55,121,
650,1069,67,75,142,
651,1051,74,64,138,
652,970,70,55,125,
653,1026,75,66,141,
654,1077,71,66,137,
655,968,77,51,128,
656,1011,64,69,133,
657,1156,83,67,150,
658,1026,87,56,143,
659,972,54,49,103,
660,1036,76,59,135,
661,1043,82,56,138,
662,1078,98,71,169,
663,969,70,49,119,
664,963,71,52,123,
665,1014,81,54,135,
666,972,77,38,115,
667,1094,71,77,148,
668,1031,66,64,130,
669,1023,58,53,111,
670,982,62,67,129,
671,1003,75,60,135,
672,992,72,74,146,
673,979,75,66,141,
674,1044,65,45,110,
675,999,74,64,138,
676,1033,74,50,124,
677,1022,64,59,123,
678,1004,65,52,117,
679,1084,82,49,131,
680,969,60,67,127,
681,975,73,48,121,
682,1015,60,55,115,
683,1031,65,53,118,
684,1004,68,56,124,
685,1001,86,61,147,
686,1020,55,53,108,
687,1064,81,67,148,
688,976,61,57,118,
689,1040,83,73,156,
690,1020,69,50,119,
691,1004,75,53,128,
692,1063,82,56,138,
693,1035,81,59,140,
694,1047,86,47,133,
695,1018,64,60,124,
696,1068,71,50,121,
697,1037,75,64,139,
698,959,80,66,146,
699,979,55,61,116,
700,963,61,51,112,
701,1030,85,54,139,
702,1038,62,50,112,
703,1004,78,59,137,
704,1067,74,63,137,
705,982,82,43,125,
706,1020,73,63,136,
707,1050,60,57,117,
708,1031,85,51,136,
709,998,77,45,122,
710,1030,64,70,134,
711,1039,65,69,134,
712,1032,74,58,132,
713,967,76,61,137,
714,1063,79,64,143,
715,1012,76,72,148,
716,1017,75,47,122,
717,1000,78,59,137,
718,973,74,72,146,
719,986,88,57,145,
720,1005,76,61,137,
721,1007,76,60,136,
722,999,76,58,134,
723,1077,70,70,140,
724,1025,80,67,147,
725,1090,60,63,123,
726,995,72,67,139,
727,997,74,70,144,
728,1000,80,62,142,
729,982,78,57,135,
730,1017,74,68,142,
731,997,63,53,116,
732,996,80,60,140,
733,1044,75,51,126,
734,1053,77,58,135,
735,984,72,46,118,
736,992,64,59,123,
737,1021,71,65,136,
738,1036,81,58,139,
739,976,73,44,117,
740,1052,77,58,135,
741,969,72,63,135,
742,1022,56,58,114,
743,968,56,37,93,
744,1026,69,56,125,
745,1058,77,64,141,
746,1041,65,54,119,
747,1003,87,50,137,
748,970,81,56,137,
749,992,80,46,126,
750,1014,72,53,125,
751,1049,74,62,136,
752,1015,69,45,114,
753,1001,73,72,145,
754,1040,98,63,161,
755,999,68,60,128,
756,998,78,59,137,
757,997,77,43,120,
758,970,74,54,128,
759,1035,82,47,129,
760,961,73,66,139,
761,877,70,52,122,
762,979,71,42,113,
763,1017,81,58,139,
764,1042,66,79,145,
765,987,48,60,108,
766,1011,76,67,143,
767,1090,86,63,149,
768,987,67,49,116,
769,954,76,56,132,
770,1004,73,55,128,
771,996,65,56,121,
772,999,67,66,133,
773,1011,75,48,123,
774,1073,96,50,146,
775,1047,72,54,126,
776,980,71,48,119,
777,1038,82,60,142,
778,981,78,61,139,
779,998,60,55,115,
780,1022,75,64,139,
781,1051,75,58,133,
782,1034,79,50,129,
783,996,77,57,134,
784,1034,60,56,116,
785,999,63,66,129,
786,1005,73,44,117,
787,1041,91,63,154,
788,965,69,52,121,
789,1049,81,53,134,
790,1012,67,64,131,
791,992,66,52,118,
792,1022,81,71,152,
793,1051,83,64,147,
794,1032,77,63,140,
795,1018,70,61,131,
796,1005,61,69,130,
797,1037,68,60,128,
798,1014,74,67,141,
799,985,69,55,124,
800,1093,81,56,137,
801,1003,79,58,137,
802,1027,78,56,134,
803,1026,71,56,127,
804,1001,74,63,137,
805,1037,69,47,116,
806,997,67,56,123,
807,1037,83,56,139,
808,1034,70,44,114,
809,1003,79,60,139,
810,1045,81,69,150,
811,1057,74,53,127,
812,987,79,38,117,
813,1046,66,71,137,
814,992,67,59,126,
815,984,61,65,126,
816,978,73,64,137,
817,990,76,52,128,
818,1015,78,53,131,
819,1049,82,59,141,
820,1053,79,70,149,
821,991,70,64,134,
822,1032,74,53,127,
823,999,75,64,139,
824,1007,79,58,137,
825,1032,82,55,137,
826,1039,67,53,120,
827,1002,77,62,139,
828,954,67,58,125,
829,998,63,52,115,
830,1052,83,54,137,
831,1086,68,60,128,
832,1058,88,60,148,
833,966,65,73,138,
834,996,75,65,140,
835,997,74,45,119,
836,1026,65,58,123,
837,1014,70,55,125,
838,1020,60,52,112,
839,977,64,59,123,
840,972,77,54,131,
841,986,83,71,154,
842,1005,77,65,142,
843,998,78,62,140,
844,1021,61,45,106,
845,1020,87,50,137,
846,973,74,42,116,
847,1022,86,54,140,
848,1041,85,63,148,
849,1009,76,54,130,
850,1079,79,61,140,
851,983,62,60,122,
852,1027,82,54,136,
853,1029,85,49,134,
854,993,78,68,146,
855,1000,77,60,137,
856,936,72,41,113,
857,949,74,42,116,
858,983,65,65,130,
859,1002,68,41,109,
860,971,78,59,137,
861,1022,83,55,138,
862,965,77,53,130,
863,1014,90,54,144,
864,1047,78,68,146,
865,1008,85,57,142,
866,1101,78,49,127,
867,1043,90,44,134,
868,1014,59,50,109,
869,1036,86,55,141,
870,1068,74,64,138,
871,982,58,51,109,
872,1021,88,46,134,
873,1049,84,70,154,
874,1014,73,56,129,
875,996,73,59,132,
876,1044,98,70,168,
877,1030,71,45,116,
878,1019,88,59,147,
879,1014,81,51,132,
880,1054,83,61,144,
881,1024,80,60,140,
882,998,78,74,152,
883,999,76,52,128,
884,1009,64,60,124,
885,1038,78,56,134,
886,1020,71,64,135,
887,1009,60,61,121,
888,1035,65,66,131,
889,1065,70,59,129,
890,958,69,49,118,
891,983,71,62,133,
892,1009,85,60,145,
893,999,66,61,127,
894,1024,81,48,129,
895,1055,76,48,124,
896,921,48,55,103,
897,1062,76,58,134,
898,971,82,62,144,
899,973,76,54,130,
900,954,80,47,127,
901,924,59,62,121,
902,1004,89,81,170,
903,1002,61,60,121,
904,974,67,57,124,
905,1027,57,67,124,
906,996,71,50,121,
907,1003,66,60,126,
908,1007,80,63,143,
909,1066,68,60,128,
910,1043,70,66,136,
911,974,84,49,133,
912,1003,63,64,127,
913,987,79,63,142,
914,1080,94,59,153,
915,1017,77,55,132,
916,953,61,71,132,
917,1042,82,65,147,
918,945,71,57,128,
919,1041,84,47,131,
920,1072,76,62,138,
921,988,87,40,127,
922,983,87,49,136,
923,1043,91,45,136,
924,1024,75,65,140,
925,1040,82,62,144,
926,1028,68,75,143,
927,1025,64,49,113,
928,1023,75,51,126,
929,1004,78,48,126,
930,990,66,65,131,
931,1100,84,78,162,
932,1041,80,60,140,
933,1002,66,58,124,
934,1049,82,62,144,
935,977,82,54,136,
936,1033,93,58,151,
937,1005,69,36,105,
938,985,66,45,111,
939,950,53,53,106,
940,1063,89,67,156,
941,1005,78,71,149,
942,1030,65,65,130,
943,1038,81,61,142,
944,984,74,54,128,
945,1074,70,52,122,
946,1037,76,65,141,
947,1060,66,48,114,
948,1010,71,35,106,
949,1011,82,61,143,
950,1040,71,57,128,
951,1058,71,58,129,
952,1019,79,66,145,
953,1079,76,65,141,
954,1015,89,49,138,
955,1055,81,68,149,
956,1048,75,69,144,
957,1038,74,60,134,
958,984,57,59,116,
959,964,89,50,139,
960,1017,56,59,115,
961,1038,71,59,130,
962,1041,68,53,121,
963,1016,69,63,132,
964,952,64,49,113,
965,967,75,49,124,
966,1094,79,63,142,
967,1015,66,61,127,
968,1073,84,60,144,
969,1030,69,65,134,
970,928,75,54,129,
971,980,79,45,124,
972,1015,54,56,110,
973,1058,83,69,152,
974,1036,75,53,128,
975,984,63,56,119,
976,1034,80,50,130,
977,978,82,52,134,
978,1059,81,62,143,
979,1043,85,68,153,
980,1036,67,60,127,
981,1026,82,52,134,
982,1033,72,49,121,
983,1033,68,59,127,
984,988,71,55,126,
985,977,79,56,135,
986,1008,59,49,108,
987,1053,77,62,139,
988,1022,67,53,120,
989,1021,83,57,140,
990,1003,70,49,119,
991,992,71,43,114,
992,1017,68,52,120,
993,991,69,65,134,
994,1057,87,56,143,
995,1032,75,71,146,
996,1080,70,71,141,
997,1030,74,49,123,
998,1026,73,49,122,
999,1056,78,53,131,
1000,1038,69,61,130,
1001,1063,82,68,150,
1002,1008,82,53,135,
1003,959,51,48,99,
1004,1007,72,57,129,
1005,1010,69,63,132,
1006,1072,90,60,150,
1007,1007,68,72,140,
1008,1003,83,66,149,
1009,1031,70,51,121,
1010,1043,80,60,140,
1011,1058,73,69,142,
1012,1032,85,48,133,
1013,1031,93,60,153,
1014,1038,70,54,124,
1015,1046,72,78,150,
1016,1039,72,62,134,
1017,1042,82,64,146,
1018,974,70,64,134,
1019,942,64,51,115,
1020,1040,72,71,143,
1021,1024,78,59,137,
1022,947,65,46,111,
1023,987,72,72,144,
1024,990,67,58,125,
1025,992,68,55,123,
1026,998,65,68,133,
1027,1020,88,45,133,
1028,994,89,59,148,
1029,1033,63,50,113,
1030,1001,70,60,130,
1031,1064,77,55,132,
1032,1014,81,56,137,
1033,1016,81,59,140,
1034,1016,75,55,130,
1035,1062,72,75,147,
1036,1067,80,53,133,
1037,1055,66,60,126,
1038,1061,76,49,125,
1039,1043,84,48,132,
1040,1005,62,52,114,
1041,1053,76,56,132,
1042,1057,89,64,153,
1043,1020,80,59,139,
1044,1019,72,69,141,
1045,994,83,57,140,
1046,984,55,52,107,
1047,1055,82,54,136,
1048,1027,73,51,124,
1049,986,70,58,128,
1050,1025,70,53,123,
1051,981,66,39,105,
1052,1022,68,44,112,
1053,1044,76,77,153,
1054,1004,75,57,132,
1055,970,81,65,146,
1056,995,82,63,145,
1057,1032,66,77,143,
1058,1014,71,55,126,
1059,1018,79,60,139,
1060,1023,79,49,128,
1061,1052,73,52,125,
1062,1058,63,53,116,
1063,1030,92,62,154,
1064,1011,70,53,123,
1065,1005,76,62,138,
1066,1025,76,50,126,
1067,1043,74,53,127,
1068,1076,73,65,138,
1069,1017,73,61,134,
1070,1003,90,63,153,
1071,1039,91,68,159,
1072,1017,64,54,118,
1073,1026,61,56,117,
1074,1051,70,57,127,
1075,1089,88,59,147,
1076,1120,77,69,146,
1077,1066,75,73,148,
1078,987,69,45,114,
1079,1022,80,64,144,
1080,1081,65,63,128,
1081,1054,72,44,116,
1082,1042,61,63,124,
1083,1041,82,57,139,
1084,929,79,36,115,
1085,1038,73,54,127,
1086,1008,81,54,135,
1087,1067,81,62,143,
1088,1044,85,52,137,
1089,1000,74,71,145,
1090,1038,75,60,135,
1091,1025,68,59,127,
1092,1016,85,61,146,
1093,1047,70,64,134,
1094,1036,78,50,128,
1095,1028,70,54,124,
1096,1047,82,52,134,
1097,1036,80,50,130,
1098,1001,77,66,143,
1099,1024,84,53,137,
1100,1033,77,57,134,
1101,989,79,57,136,
1102,987,78,41,119,
1103,1031,79,53,132,
1104,981,72,59,131,
1105,1079,73,74,147,
1106,998,73,62,135,
1107,1055,71,66,137,
1108,1040,71,52,123,
1109,1022,83,68,151,
1110,1026,76,55,131,
1111,997,62,60,122,
1112,1019,79,53,132,
1113,1088,75,65,140,
1114,1022,70,55,125,
1115,1006,73,58,131,
1116,1086,67,67,134,
1117,989,74,61,135,
1118,1025,71,57,128,
1119,986,64,59,123,
1120,1048,95,63,158,
1121,1054,90,57,147,
1122,1000,82,52,134,
1123,1004,73,56,129,
1124,959,79,57,136,
1125,1033,59,59,118,
1126,978,58,59,117,
1127,969,73,58,131,
1128,1057,83,62,145,
1129,1071,79,68,147,
1130,983,74,53,127,
1131,1073,75,75,150,
1132,1013,79,66,145,
1133,965,65,57,122,
1134,1001,84,48,132,
1135,1082,88,53,141,
1136,1057,77,72,149,
1137,988,72,52,124,
1138,1006,81,54,135,
1139,1008,64,58,122,
1140,1026,66,59,125,
1141,1035,76,48,124,
1142,1038,85,52,137,
1143,992,71,54,125,
1144,1007,61,41,102,
1145,1012,78,57,135,
1146,1022,73,57,130,
1147,1074,81,53,134,
1148,1022,59,56,115,
1149,1013,75,60,135,
1150,984,64,56,120,
1151,1044,84,52,136,
1152,986,80,55,135,
1153,1013,74,47,121,
1154,1021,79,64,143,
1155,1031,82,52,134,
1156,1065,83,62,145,
1157,1058,71,66,137,
1158,994,60,50,110,
1159,1041,67,67,134,
1160,1042,74,61,135,
1161,1073,88,70,158,
1162,1061,83,70,153,
1163,1053,72,54,126,
1164,1018,73,69,142,
1165,987,53,49,102,
1166,971,65,50,115,
1167,939,66,57,123,
1168,954,55,61,116,
1169,1076,79,72,151,
1170,1009,76,48,124,
1171,1045,78,65,143,
1172,1037,62,65,127,
1173,963,70,51,121,
1174,1016,84,62,146,
1175,1026,83,55,138,
1176,971,75,55,130,
1177,1071,83,73,156,
1178,960,71,56,127,
1179,1013,73,46,119,
1180,978,63,43,106,
1181,979,70,54,124,
1182,1022,63,51,114,
1183,1014,87,55,142,
1184,1096,83,65,148,
1185,1053,80,44,124,
1186,1001,77,61,138,
1187,1005,64,65,129,
1188,1012,66,46,112,
1189,969,70,51,121,
1190,1045,84,58,142,
1191,1069,74,58,132,
1192,993,71,58,129,
1193,1051,79,64,143,
1194,983,70,65,135,
1195,1033,68,59,127,
1196,997,67,47,114,
1197,1038,66,66,132,
1198,1064,70,62,132,
1199,1035,68,51,119,
1200,1034,70,57,127,
1201,1004,61,54,115,
1202,1027,69,68,137,
1203,1016,65,53,118,
1204,996,73,54,127,
1205,1003,75,49,124,
1206,1027,75,58,133,
1207,992,70,65,135,
1208,980,63,60,123,
1209,1029,66,61,127,
1210,1056,77,52,129,
1211,997,67,53,120,
1212,1027,69,59,128,
1213,1069,87,58,145,
1214,1033,90,60,150,
1215,1043,89,63,152,
1216,1001,79,64,143,
1217,979,68,60,128,
1218,1062,97,55,152,
1219,1022,77,46,123,
1220,1037,83,62,145,
1221,944,81,54,135,
1222,1017,70,52,122,
1223,991,59,64,123,
1224,1112,102,76,178,
1225,1010,89,73,162,
1226,1012,79,53,132,
1227,996,69,43,112,
1228,971,74,59,133,
1229,1017,66,68,134,
1230,1019,62,56,118,
1231,1029,61,62,123,
1232,1066,77,52,129,
1233,1015,68,55,123,
1234,978,69,52,121,
1235,1033,80,56,136,
1236,1076,79,59,138,
1237,1001,72,42,114,
1238,1004,70,51,121,
1239,992,83,52,135,
1240,986,83,66,149,
1241,984,76,63,139,
1242,1026,68,48,116,
1243,983,80,62,142,
1244,991,61,58,119,
1245,1030,67,65,132,
1246,990,65,63,128,
1247,1028,80,64,144,
1248,1096,78,73,151,
1249,984,82,47,129,
1250,1004,55,65,120,
1251,1004,78,56,134,
1252,1042,75,64,139,
1253,995,72,56,128,
1254,1081,96,83,179,
1255,998,71,57,128,
1256,1065,85,63,148,
1257,988,65,52,117,
1258,1034,78,67,145,
1259,1014,82,64,146,
1260,1052,84,57,141,
1261,1031,79,53,132,
1262,1042,60,66,126,
1263,992,82,65,147,
1264,1032,77,50,127,
1265,992,64,53,117,
1266,986,79,51,130,
1267,1002,78,60,138,
1268,1011,95,70,165,
1269,976,66,49,115,
1270,992,68,67,135,
1271,973,78,57,135,
1272,1080,87,62,149,
1273,990,72,63,135,
1274,1030,78,50,128,
1275,1017,73,62,135,
1276,1007,77,58,135,
1277,1029,90,38,128,
1278,947,57,59,116,
1279,976,73,56,129,
1280,994,84,64,148,
1281,970,65,63,128,
1282,980,60,64,124,
1283,997,58,64,122,
1284,1026,76,55,131,
1285,1055,76,62,138,
1286,1020,84,52,136,
1287,1060,80,66,146,
1288,1035,80,58,138,
1289,946,77,57,134,
1290,1063,88,52,140,
1291,1034,69,58,127,
1292,1040,60,51,111,
1293,968,82,43,125,
1294,1027,86,58,144,
1295,1005,71,54,125,
1296,1053,72,57,129,
1297,984,87,59,146,
1298,1055,69,65,134,
1299,1009,71,49,120,
1300,1030,82,57,139,
1301,1025,74,55,129,
1302,1029,73,71,144,
1303,1013,65,55,120,
1304,1022,66,63,129,
1305,959,65,49,114,
1306,1069,70,59,129,
1307,996,68,54,122,
1308,1020,78,62,140,
1309,1006,78,58,136,
1310,1032,76,60,136,
1311,1034,64,61,125,
1312,1011,75,54,129,
1313,1051,77,64,141,
1314,996,52,66,118,
1315,1021,85,56,141,
1316,1053,94,69,163,
1317,979,70,50,120,
1318,974,71,49,120,
1319,990,65,54,119,
1320,1019,84,50,134,
1321,1001,72,65,137,
1322,1033,73,55,128,
1323,948,64,68,132,
1324,1010,77,55,132,
1325,1053,76,66,142,
1326,1010,74,60,134,
1327,1005,82,56,138,
1328,1037,76,59,135,
1329,1008,86,63,149,
1330,1008,78,55,133,
1331,1021,69,57,126,
1332,981,62,68,130,
1333,1057,78,59,137,
1334,1019,63,68,131,
1335,1036,61,66,127,
1336,1026,76,72,148,
1337,1036,78,56,134,
1338,994,71,63,134,
1339,1108,77,66,143,
1340,948,61,53,114,
1341,1080,72,59,131,
1342,1014,72,54,126,
1343,1069,65,49,114,
1344,985,75,45,120,
1345,1015,84,50,134,
1346,985,78,61,139,
1347,973,70,55,125,
1348,969,66,53,119,
1349,1048,78,58,136,
1350,983,74,54,128,
1351,1043,80,57,137,
1352,989,77,57,134,
1353,959,66,56,122,
1354,978,69,65,134,
1355,1008,72,66,138,
1356,1037,58,66,124,
1357,1037,77,54,131,
1358,954,68,55,123,
1359,1057,92,68,160,
1360,1073,83,70,153,
1361,1033,77,61,138,
1362,1039,72,62,134,
1363,1010,65,58,123,
1364,1031,76,46,122,
1365,1019,75,65,140,
1366,1029,76,58,134,
1367,1031,73,58,131,
1368,1049,75,59,134,
1369,1082,71,66,137,
1370,1021,81,44,125,
1371,1017,71,56,127,
1372,1025,76,46,122,
1373,1026,84,60,144,
1374,1030,70,63,133,
1375,1013,80,40,120,
1376,1022,75,63,138,
1377,987,72,64,136,
1378,1066,64,59,123,
1379,1005,83,55,138,
1380,995,85,52,137,
1381,1043,60,56,116,
1382,1056,73,48,121,
1383,1090,82,56,138,
1384,997,83,63,146,
1385,968,66,60,126,
1386,1045,74,78,152,
1387,1054,82,72,154,
1388,1034,91,44,135,
1389,1048,66,66,132,
1390,1016,61,65,126,
1391,1040,79,61,140,
1392,1054,56,58,114,
1393,1016,82,51,133,
1394,1023,65,55,120,
1395,1011,66,65,131,
1396,983,78,56,134,
1397,1054,81,57,138,
1398,1009,75,77,152,
1399,938,65,59,124,
1400,1035,77,52,129,
1401,1009,66,54,120,
1402,1001,62,57,119,
1403,1028,62,47,109,
1404,1058,73,58,131,
1405,1007,76,51,127,
1406,1023,66,60,126,
1407,1016,72,56,128,
1408,1032,79,46,125,
1409,1017,72,58,130,
1410,1032,61,82,143,
1411,1006,88,48,136,
1412,1109,86,52,138,
1413,1050,72,67,139,
1414,1023,70,60,130,
1415,1074,87,59,146,
1416,980,75,51,126,
1417,1031,86,60,146,
1418,988,61,52,113,
1419,1052,71,56,127,
1420,1043,81,71,152,
1421,966,61,52,113,
1422,971,69,48,117,
1423,1046,73,70,143,
1424,1037,81,57,138,
1425,954,62,63,125,
1426,1040,87,59,146,
1427,985,79,55,134,
1428,1026,74,69,143,
1429,1044,66,54,120,
1430,1019,93,46,139,
1431,1030,97,57,154,
1432,1034,68,69,137,
1433,947,63,51,114,
1434,1020,81,61,142,
1435,1017,87,55,142,
1436,978,64,56,120,
1437,1018,67,56,123,
1438,1038,65,65,130,
1439,1007,73,59,132,
1440,982,74,62,136,
1441,1024,71,63,134,
1442,1057,83,58,141,
1443,992,83,63,146,
1444,983,55,64,119,
1445,999,70,50,120,
1446,1031,59,48,107,
1447,1016,69,66,135,
1448,1014,77,55,132,
1449,1068,93,53,146,
1450,1043,63,58,121,
1451,980,94,47,141,
1452,1048,65,51,116,
1453,1041,80,64,144,
1454,1011,79,69,148,
1455,1036,85,58,143,
1456,1010,73,68,141,
1457,970,72,66,138,
1458,967,82,58,140,
1459,998,70,40,110,
1460,974,71,52,123,
1461,994,71,57,128,
1462,1061,64,63,127,
1463,1004,78,69,147,
1464,1038,83,62,145,
1465,1018,86,57,143,
1466,1019,63,56,119,
1467,1037,86,61,147,
1468,1000,71,46,117,
1469,994,73,62,135,
1470,1029,70,54,124,
1471,1033,76,58,134,
1472,1038,78,69,147,
1473,1034,74,58,132,
1474,999,66,56,122,
1475,1084,72,67,139,
1476,1028,67,50,117,
1477,1064,72,58,130,
1478,1053,76,51,127,
1479,997,78,46,124,
1480,1032,84,64,148,
1481,963,75,53,128,
1482,1017,68,55,123,
1483,1039,67,66,133,
1484,1082,79,72,151,
1485,1002,90,58,148,
1486,990,63,49,112,
1487,1032,77,67,144,
1488,1057,84,65,149,
1489,985,69,64,133,
1490,1035,79,47,126,
1491,1020,81,66,147,
1492,955,63,64,127,
1493,931,59,64,123,
1494,1011,70,67,137,
1495,1022,71,69,140,
1496,1014,81,56,137,
1497,1011,75,62,137,
1498,1020,74,65,139,
1499,999,59,72,131,
1500,1055,78,57,135,
1501,1064,86,80,166,
1502,987,73,58,131,
1503,1027,77,58,135,
1504,1036,88,50,138,
1505,1004,65,49,114,
1506,968,62,53,115,
1507,991,63,48,111,
1508,1039,83,55,138,
1509,993,71,46,117,
1510,1039,79,60,139,
1511,1017,75,67,142,
1512,990,75,61,136,
1513,1030,80,66,146,
1514,1052,69,53,122,
1515,989,67,50,117,
1516,1014,76,48,124,
1517,1034,81,51,132,
1518,1012,71,68,139,
1519,981,68,58,126,
1520,1051,74,66,140,
1521,1030,73,61,134,
1522,1055,91,68,159,
1523,1029,73,53,126,
1524,1056,69,66,135,
1525,974,69,48,117,
1526,1005,77,64,141,
1527,1001,79,56,135,
1528,1002,86,56,142,
1529,1000,76,50,126,
1530,935,81,37,118,
1531,1006,82,54,136,
1532,1069,78,66,144,
1533,1067,74,53,127,
1534,1002,94,48,142,
1535,1009,90,49,139,
1536,1033,66,60,126,
1537,971,68,51,119,
1538,1041,66,58,124,
1539,1019,81,48,129,
1540,1047,84,55,139,
1541,1026,89,48,137,
1542,1061,76,70,146,
1543,1023,80,52,132,
1544,1004,70,56,126,
1545,941,82,47,129,
1546,1084,77,66,143,
1547,992,84,54,138,
1548,1006,65,62,127,
1549,1033,66,52,118,
1550,971,79,59,138,
1551,1001,75,58,133,
1552,970,68,54,122,
1553,1101,83,68,151,
1554,1018,81,53,134,
1555,1105,81,51,132,
1556,999,95,53,148,
1557,1001,78,58,136,
1558,1036,77,70,147,
1559,1045,79,61,140,
1560,977,82,57,139,
1561,986,82,60,142,
1562,1037,71,56,127,
1563,1003,82,47,129,
1564,1026,75,58,133,
1565,967,71,64,135,
1566,1042,87,58,145,
1567,1016,69,68,137,
1568,1061,64,69,133,
1569,1014,72,56,128,
1570,947,61,46,107,
1571,1006,66,62,128,
1572,1015,72,66,138,
1573,1044,84,65,149,
1574,1028,74,52,126,
1575,980,75,54,129,
1576,1008,90,56,146,
1577,1061,70,57,127,
1578,1099,82,53,135,
1579,1021,77,55,132,
1580,1080,88,76,164,
1581,978,64,63,127,
1582,1004,79,51,130,
1583,1030,74,47,121,
1584,992,68,58,126,
1585,1057,71,63,134,
1586,1004,76,58,134,
1587,980,71,75,146,
1588,1039,82,54,136,
1589,972,72,60,132,
1590,992,64,54,118,
1591,1021,63,53,116,
1592,992,71,64,135,
1593,1035,68,67,135,
1594,1022,82,57,139,
1595,1074,71,65,136,
1596,950,65,53,118,
1597,1028,82,50,132,
1598,1024,84,62,146,
1599,975,83,64,147,
1600,1003,75,50,125,
1601,1008,69,53,122,
1602,1076,102,66,168,
1603,1009,73,62,135,
1604,993,62,56,118,
1605,1091,66,66,132,
1606,1004,87,57,144,
1607,1045,80,52,132,
1608,1044,78,54,132,
1609,1075,66,69,135,
1610,975,69,56,125,
1611,989,70,65,135,
1612,997,82,41,123,
1613,1039,89,60,149,
1614,1032,71,66,137,
1615,1023,82,66,148,
1616,1040,65,51,116,
1617,1078,80,77,157,
1618,1045,70,70,140,
1619,1030,74,65,139,
1620,1033,69,60,129,
1621,985,73,64,137,
1622,999,62,65,127,
1623,1050,78,58,136,
1624,987,80,43,123,
1625,1076,76,59,135,
1626,1085,71,80,151,
1627,1000,74,63,137,
1628,983,66,46,112,
1629,1032,78,56,134,
1630,1028,84,54,138,
1631,961,70,51,121,
1632,990,61,53,114,
1633,977,71,63,134,
1634,957,66,63,129,
1635,1051,75,64,139,
1636,1037,86,66,152,
1637,993,63,53,116,
1638,1074,99,61,160,
1639,1040,72,69,141,
1640,1026,85,56,141,
1641,978,74,55,129,
1642,1002,89,58,147,
1643,1045,84,54,138,
1644,978,72,40,112,
1645,1006,78,47,125,
1646,1044,81,44,125,
1647,1012,76,60,136,
1648,1010,77,47,124,
1649,1007,80,55,135,
1650,985,84,56,140,
1651,1029,77,72,149,
1652,1050,70,46,116,
1653,1002,56,60,116,
1654,1011,85,55,140,
1655,1076,92,66,158,
1656,998,63,56,119,
1657,968,71,58,129,
1658,1084,86,66,152,
1659,1045,69,51,120,
1660,1045,70,52,122,
1661,1007,69,46,115,
1662,1045,75,52,127,
1663,1001,77,55,132,
1664,966,76,55,131,
1665,1024,82,52,134,
1666,1007,73,64,137,
1667,1027,56,57,113,
1668,1044,85,63,148,
1669,1029,68,63,131,
1670,946,67,55,122,
1671,1014,73,54,127,
1672,1022,87,51,138,
1673,1032,67,58,125,
1674,1018,82,61,143,
1675,1008,66,74,140,
1676,995,72,65,137,
1677,1009,80,53,133,
1678,1062,70,71,141,
1679,1015,69,60,129,
1680,1048,81,59,140,
1681,1038,81,64,145,
1682,990,76,60,136,
1683,1013,71,48,119,
1684,1096,82,79,161,
1685,1046,83,56,139,
1686,1033,78,52,130,
1687,1007,87,56,143,
1688,982,79,48,127,
1689,1022,76,70,146,
1690,1031,93,69,162,
1691,1002,60,75,135,
1692,1005,63,59,122,
1693,1029,72,51,123,
1694,1006,74,57,131,
1695,1077,81,66,147,
1696,1092,81,66,147,
1697,1006,84,72,156,
1698,1146,88,69,157,
1699,1023,87,74,161,
1700,1037,82,66,148,
1701,997,66,59,125,
1702,1059,84,64,148,
1703,1075,71,48,119,
1704,960,74,49,123,
1705,1014,68,71,139,
1706,995,81,71,152,
1707,973,81,50,131,
1708,988,77,68,145,
1709,994,53,57,110,
1710,1045,83,53,136,
1711,992,72,54,126,
1712,994,66,58,124,
1713,1020,71,53,124,
1714,1027,81,52,133,
1715,970,61,56,117,
1716,1033,62,70,132,
1717,1022,66,70,136,
1718,1014,65,54,119,
1719,1061,90,66,156,
1720,1055,80,55,135,
1721,1022,87,68,155,
1722,1034,89,57,146,
1723,1021,73,64,137,
1724,1015,70,61,131,
1725,995,79,60,139,
1726,994,72,64,136,
1727,1088,80,59,139,
1728,1030,80,52,132,
1729,1000,71,50,121,
1730,1080,71,55,126,
1731,1013,72,62,134,
1732,1039,75,50,125,
1733,1001,70,49,119,
1734,1069,86,60,146,
1735,988,68,71,139,
1736,994,62,55,117,
1737,985,77,54,131,
1738,979,80,46,126,
1739,1002,64,63,127,
1740,1022,72,64,136,
1741,1042,57,55,112,
1742,988,71,44,115,
1743,991,82,43,125,
1744,1025,73,65,138,
1745,983,65,55,120,
1746,975,64,50,114,
1747,986,64,69,133,
1748,996,73,56,129,
1749,988,74,53,127,
1750,1032,68,60,128,
1751,1046,73,55,128,
1752,1083,90,70,160,
1753,1012,76,51,127,
1754,970,72,61,133,
1755,990,66,65,131,
1756,1000,71,53,124,
1757,985,65,50,115,
1758,1056,75,77,152,
1759,1023,70,68,138,
1760,1038,76,51,127,
1761,1049,78,56,134,
1762,1005,68,53,121,
1763,962,65,48,113,
1764,992,77,58,135,
1765,1021,74,54,128,
1766,1001,81,59,140,
1767,1034,69,66,135,
1768,1006,91,48,139,
1769,979,79,54,133,
1770,1024,84,56,140,
1771,954,75,40,115,
1772,991,63,67,130,
1773,1039,89,73,162,
1774,1095,61,68,129,
1775,1002,63,47,110,
1776,1024,71,55,126,
1777,987,67,68,135,
1778,985,81,55,136,
1779,1071,79,52,131,
1780,1029,72,66,138,
1781,1017,77,50,127,
1782,1054,78,58,136,
1783,994,63,55,118,
1784,977,71,59,130,
1785,1029,86,56,142,
1786,967,73,53,126,
1787,1009,76,58,134,
1788,1029,77,69,146,
1789,1016,63,66,129,
1790,1058,74,65,139,
1791,1074,69,68,137,
1792,1022,75,61,136,
1793,1010,76,67,143,
1794,1051,66,72,138,
1795,1046,71,57,128,
1796,1026,83,70,153,
1797,976,60,48,108,
1798,1011,83,47,130,
1799,994,78,59,137,
1800,993,61,66,127,
1801,1056,89,48,137,
1802,1026,83,57,140,
1803,944,58,70,128,
1804,1050,69,62,131,
1805,1014,88,52,140,
1806,1126,91,80,171,
1807,1020,85,55,140,
1808,1068,71,67,138,
1809,999,69,53,122,
1810,1051,62,57,119,
1811,1055,64,50,114,
1812,1048,68,57,125,
1813,1073,74,71,145,
1814,973,77,55,132,
1815,1066,63,58,121,
1816,989,69,50,119,
1817,1011,80,59,139,
1818,1014,74,57,131,
1819,1017,66,60,126,
1820,989,68,70,138,
1821,1036,75,55,130,
1822,1001,63,49,112,
1823,1037,75,51,126,
1824,1003,84,65,149,
1825,1023,77,53,130,
1826,1021,78,77,155,
1827,1006,83,48,131,
1828,1029,67,53,120,
1829,1094,70,69,139,
1830,965,73,51,124,
1831,1013,86,70,156,
1832,1089,86,71,157,
1833,959,68,41,109,
1834,1060,85,49,134,
1835,958,63,55,118,
1836,1013,74,54,128,
1837,1044,82,45,127,
1838,1070,81,49,130,
1839,1024,64,60,124,
1840,1000,59,54,113,
1841,995,73,57,130,
1842,1028,84,70,154,
1843,1018,69,66,135,
1844,1014,73,73,146,
1845,1048,97,52,149,
1846,999,79,65,144,
1847,1030,84,61,145,
1848,1016,75,52,127,
1849,1018,85,54,139,
1850,1044,86,37,123,
1851,1017,64,52,116,
1852,1013,71,67,138,
1853,1021,76,61,137,
1854,1027,83,64,147,
1855,1016,70,58,128,
1856,1020,75,67,142,
1857,1012,62,46,108,
1858,1039,71,57,128,
1859,1020,75,51,126,
1860,958,67,55,122,
1861,1021,80,70,150,
1862,995,62,66,128,
1863,967,70,65,135,
1864,1026,77,58,135,
1865,1033,89,74,163,
1866,987,80,48,128,
1867,998,63,64,127,
1868,961,80,50,130,
1869,1072,76,62,138,
1870,990,75,69,144,
1871,1054,73,73,146,
1872,1079,71,57,128,
1873,1061,76,74,150,
1874,969,65,41,106,
1875,989,78,55,133,
1876,1017,69,54,123,
1877,1018,65,63,128,
1878,988,54,52,106,
1879,975,64,63,127,
1880,1040,68,56,124,
1881,1048,90,50,140,
1882,938,70,40,110,
1883,1001,79,46,125,
1884,976,66,46,112,
1885,1000,73,60,133,
1886,1001,87,65,152,
1887,1019,62,58,120,
1888,1000,77,59,136,
1889,1024,67,60,127,
1890,1024,83,53,136,
1891,1016,76,52,128,
1892,943,56,58,114,
1893,1016,69,70,139,
1894,1029,79,62,141,
1895,1043,81,51,132,
1896,1035,78,70,148,
1897,1034,89,54,143,
1898,1101,67,50,117,
1899,1001,76,52,128,
1900,942,71,56,127,
1901,1008,63,54,117,
1902,1039,71,55,126,
1903,1020,70,63,133,
1904,1059,94,57,151,
1905,938,68,55,123,
1906,1011,86,51,137,
1907,928,64,41,105,
1908,1010,81,46,127,
1909,1011,69,59,128,
1910,1042,88,56,144,
1911,1036,80,66,146,
1912,1040,73,57,130,
1913,1037,85,55,140,
1914,1036,67,61,128,
1915,994,74,56,130,
1916,989,84,64,148,
1917,1073,87,58,145,
1918,1054,68,66,134,
1919,1050,71,63,134,
1920,1019,92,55,147,
1921,1098,84,69,153,
1922,1008,70,47,117,
1923,986,73,62,135,
1924,990,73,51,124,
1925,1032,86,57,143,
1926,1064,79,58,137,
1927,990,58,51,109,
1928,997,64,58,122,
1929,1129,81,67,148,
1930,1017,66,54,120,
1931,1008,69,63,132,
1932,1001,82,44,126,
1933,989,73,55,128,
1934,1016,82,56,138,
1935,1048,91,57,148,
1936,1028,83,64,147,
1937,1055,75,63,138,
1938,962,82,65,147,
1939,1008,68,52,120,
1940,1080,89,52,141,
1941,994,74,65,139,
1942,949,72,54,126,
1943,1011,77,61,138,
1944,1059,73,60,133,
1945,1006,73,59,132,
1946,1016,63,65,128,
1947,1039,81,58,139,
1948,1016,62,62,124,
1949,1054,90,66,156,
1950,1038,76,57,133,
1951,1050,83,61,144,
1952,1060,86,76,162,
1953,976,71,56,127,
1954,996,72,56,128,
1955,1032,81,52,133,
1956,1077,59,65,124,
1957,996,63,42,105,
1958,1005,70,58,128,
1959,1066,85,60,145,
1960,1053,71,62,133,
1961,999,89,56,145,
1962,1047,85,58,143,
1963,998,64,53,117,
1964,1067,81,60,141,
1965,1057,60,62,122,
1966,1028,67,60,127,
1967,1032,76,69,145,
1968,1043,98,52,150,
1969,1082,79,65,144,
1970,1035,65,60,125,
1971,1052,72,52,124,
1972,1006,73,54,127,
1973,993,67,51,118,
1974,1008,68,54,122,
1975,1032,59,60,119,
1976,1048,76,62,138,
1977,1049,75,54,129,
1978,972,78,53,131,
1979,942,64,51,115,
1980,1017,63,68,131,
1981,986,60,61,121,
1982,1030,82,57,139,
1983,1045,85,57,142,
1984,1026,85,44,129,
1985,1039,74,71,145,
1986,1024,83,62,145,
1987,1007,99,65,164,
1988,982,75,54,129,
1989,1006,62,58,120,
1990,1012,61,61,122,
1991,1035,67,52,119,
1992,959,67,65,132,
1993,1006,63,51,114,
1994,1047,60,51,111,
1995,1024,85,52,137,
1996,985,77,47,124,
1997,1010,70,62,132,
1998,968,75,60,135,
1999,1025,84,59,143,
2000,1041,73,64,137,
2001,1022,89,64,153,
2002,1051,69,61,130,
2003,1033,77,68,145,
2004,976,66,56,122,
2005,1058,78,76,154,
2006,975,72,58,130,
2007,1012,73,59,132,
2008,1044,76,67,143,
2009,1034,83,71,154,
2010,1019,73,66,139,
2011,994,73,63,136,
2012,970,58,67,125,
2013,984,69,55,124,
2014,1032,71,61,132,
2015,1075,81,46,127,
2016,1020,69,55,124,
2017,991,48,49,97,
2018,1074,78,57,135,
2019,999,88,63,151,
2020,1008,75,40,115,
2021,1033,77,64,141,
2022,1044,77,44,121,
2023,1056,81,60,141,
2024,1041,65,53,118,
2025,989,71,59,130,
2026,1068,73,67,140,
2027,995,72,58,130,
2028,1048,72,49,121,
2029,1006,69,61,130,
2030,1043,69,53,122,
2031,998,68,60,128,
2032,1058,75,65,140,
2033,1056,84,49,133,
2034,1057,81,54,135,
2035,991,86,58,144,
2036,1054,74,66,140,
2037,1013,96,57,153,
2038,1015,65,68,133,
2039,1033,72,49,121,
2040,995,87,52,139,
2041,1045,71,56,127,
2042,1050,83,48,131,
2043,1050,83,61,144,
2044,1020,63,60,123,
2045,952,83,57,140,
2046,1099,88,65,153,
2047,1000,75,56,131,
2048,1032,69,59,128,
2049,1038,80,49,129,
2050,1016,78,50,128,
2051,995,80,56,136,
2052,976,72,47,119,
2053,1027,75,53,128,
2054,1090,73,60,133,
2055,1024,71,67,138,
2056,991,69,59,128,
2057,1048,77,68,145,
2058,1048,61,63,124,
2059,1035,66,60,126,
2060,990,70,52,122,
2061,1027,69,62,131,
2062,1050,66,60,126,
2063,1040,67,50,117,
2064,1019,69,54,123,
2065,1038,73,59,132,
2066,976,61,55,116,
2067,991,71,63,134,
2068,1065,79,67,146,
2069,1011,69,74,143,
2070,1026,71,66,137,
2071,1023,61,66,127,
2072,1025,77,52,129,
2073,1084,92,58,150,
2074,1078,83,54,137,
2075,1015,86,51,137,
2076,1011,84,55,139,
2077,1017,79,63,142,
2078,1008,62,57,119,
2079,1015,68,52,120,
2080,1051,80,57,137,
2081,916,69,41,110,
2082,1035,59,55,114,
2083,1090,70,70,140,
2084,1008,68,51,119,
2085,1029,73,74,147,
2086,972,75,50,125,
2087,978,66,51,117,
2088,1030,59,65,124,
2089,1018,74,52,126,
2090,1072,67,64,131,
2091,990,75,65,140,
2092,1005,73,53,126,
2093,1069,80,59,139,
2094,970,68,51,119,
2095,973,65,47,112,
2096,979,70,48,118,
2097,1003,68,70,138,
2098,1038,85,65,150,
2099,1026,75,52,127,
2100,1020,51,58,109,
2101,1014,73,55,128,
2102,971,53,56,109,
2103,1077,89,53,142,
2104,1023,84,62,146,
2105,977,80,51,131,
2106,1015,62,67,129,
2107,995,67,59,126,
2108,1032,74,62,136,
2109,1038,69,64,133,
2110,1026,76,64,140,
2111,1038,77,57,134,
2112,1069,70,62,132,
2113,1027,81,57,138,
2114,1035,67,64,131,
2115,984,59,55,114,
2116,993,59,71,130,
2117,994,77,51,128,
2118,979,79,56,135,
2119,1016,87,55,142,
2120,1076,82,61,143,
2121,1003,79,44,123,
2122,961,64,63,127,
2123,1092,76,65,141,
2124,1050,72,54,126,
2125,1040,63,61,124,
2126,1006,68,57,125,
2127,1011,65,73,138,
2128,962,69,49,118,
2129,995,70,60,130,
2130,934,77,56,133,
2131,1001,73,63,136,
2132,1041,72,69,141,
2133,1008,76,60,136,
2134,961,73,45,118,
2135,1065,65,68,133,
2136,1038,88,56,144,
2137,1068,89,61,150,
2138,1013,73,69,142,
2139,1082,88,55,143,
2140,1000,70,59,129,
2141,997,80,63,143,
2142,1103,65,54,119,
2143,1024,76,64,140,
2144,972,61,63,124,
2145,1055,80,52,132,
2146,1052,70,61,131,
2147,1032,84,53,137,
2148,1083,87,57,144,
2149,1065,75,57,132,
2150,984,71,68,139,
2151,1015,73,56,129,
2152,1089,85,69,154,
2153,1001,71,52,123,
2154,998,64,54,118,
2155,986,76,54,130,
2156,985,62,55,117,
2157,1080,81,62,143,
2158,984,94,50,144,
2159,1027,70,65,135,
2160,1013,67,54,121,
2161,978,74,56,130,
2162,973,63,43,106,
2163,1058,78,55,133,
2164,1003,75,52,127,
2165,1058,77,57,134,
2166,987,71,47,118,
2167,1013,68,70,138,
2168,980,77,52,129,
2169,994,60,56,116,
2170,1045,74,55,129,
2171,1019,90,48,138,
2172,1004,72,73,145,
2173,1055,69,54,123,
2174,974,85,54,139,
2175,972,65,41,106,
2176,1026,84,65,149,
2177,1042,83,80,163,
2178,1006,73,62,135,
2179,985,73,61,134,
2180,1021,83,57,140,
2181,981,84,65,149,
2182,1026,82,65,147,
2183,1004,84,53,137,
2184,981,60,57,117,
2185,1038,74,72,146,
2186,1030,60,66,126,
2187,1010,83,65,148,
2188,990,62,66,128,
2189,980,84,46,130,
2190,1001,83,48,131,
2191,1069,81,59,140,
2192,1020,89,60,149,
2193,950,60,62,122,
2194,1053,84,64,148,
2195,973,79,48,127,
2196,1024,83,61,144,
2197,1009,67,63,130,
2198,981,74,61,135,
2199,1009,90,59,149,
2200,1061,64,52,116,
2201,1004,47,66,113,
2202,1022,78,56,134,
2203,1046,75,62,137,
2204,1020,73,59,132,
2205,996,66,51,117,
2206,1052,78,71,149,
2207,1030,79,64,143,
2208,997,74,47,121,
2209,1029,74,72,146,
2210,1050,72,57,129,
2211,949,63,45,108,
2212,1036,80,70,150,
2213,1048,78,53,131,
2214,1077,84,49,133,
2215,1060,87,53,140,
2216,975,66,59,125,
2217,1040,74,66,140,
2218,1058,73,59,132,
2219,1024,71,52,123,
2220,965,79,57,136,
2221,1069,83,59,142,
2222,1033,69,65,134,
2223,993,78,65,143,
2224,977,63,49,112,
2225,967,103,53,156,
2226,1012,77,50,127,
2227,1064,80,55,135,
2228,991,79,58,137,
2229,1029,81,53,134,
2230,999,59,59,118,
2231,979,80,48,128,
2232,1051,70,60,130,
2233,998,56,49,105,
2234,1008,62,55,117,
2235,1002,81,62,143,
2236,1038,75,64,139,
2237,989,70,55,125,
2238,1021,78,50,128,
2239,1002,65,65,130,
2240,985,58,62,120,
2241,988,80,56,136,
2242,1056,66,62,128,
2243,985,87,57,144,
2244,1022,63,63,126,
2245,1047,63,66,129,
2246,1017,83,60,143,
2247,996,73,52,125,
2248,1075,83,59,142,
2249,994,75,56,131,
2250,1023,67,67,134,
2251,1037,70,67,137,
2252,1022,82,50,132,
2253,1004,75,51,126,
2254,980,73,59,132,
2255,947,66,54,120,
2256,1049,70,48,118,
2257,1033,70,56,126,
2258,1056,68,69,137,
2259,966,75,60,135,
2260,1059,74,58,132,
2261,1043,83,65,148,
2262,1050,81,76,157,
2263,1037,74,56,130,
2264,989,63,56,119,
2265,1055,81,62,143,
2266,1012,63,61,124,
2267,986,69,59,128,
2268,985,73,59,132,
2269,974,70,63,133,
2270,1044,71,64,135,
2271,1045,67,67,134,
2272,1021,65,52,117,
2273,950,65,67,132,
2274,1011,77,49,126,
2275,996,66,51,117,
2276,1001,79,60,139,
2277,942,79,45,124,
2278,928,71,49,120,
2279,1021,85,57,142,
2280,1033,89,66,155,
2281,1028,76,48,124,
2282,1043,86,51,137,
2283,1092,84,66,150,
2284,1001,73,54,127,
2285,1029,101,43,144,
2286,980,73,58,131,
2287,1067,99,53,152,
2288,1034,87,72,159,
2289,1004,73,64,137,
2290,1081,69,51,120,
2291,978,72,47,119,
2292,988,72,57,129,
2293,1029,74,62,136,
2294,1026,71,59,130,
2295,969,55,50,105,
2296,1013,66,47,113,
2297,1004,70,58,128,
2298,979,74,54,128,
2299,1016,83,67,150,
2300,1039,85,70,155,
2301,1024,71,55,126,
2302,1066,97,67,164,
2303,965,72,50,122,
2304,957,63,56,119,
2305,991,61,58,119,
2306,1009,85,59,144,
2307,1053,76,62,138,
2308,997,69,66,135,
2309,1099,70,62,132,
2310,1013,74,72,146,
2311,1059,72,55,127,
2312,1062,78,47,125,
2313,985,69,61,130,
2314,1043,86,48,134,
2315,1039,79,64,143,
2316,978,55,57,112,
2317,1047,56,58,114,
2318,1015,72,54,126,
2319,986,74,50,124,
2320,955,71,49,120,
2321,1029,70,57,127,
2322,996,77,58,135,
2323,1068,82,56,138,
2324,997,81,56,137,
2325,992,72,66,138,
2326,1022,83,57,140,
2327,972,66,58,124,
2328,985,66,67,133,
2329,1032,86,70,156,
2330,1073,84,67,151,
2331,1029,81,59,140,
2332,996,79,54,133,
2333,1038,91,52,143,
2334,995,69,52,121,
2335,1040,73,50,123,
2336,1003,65,63,128,
2337,1049,73,54,127,
2338,1115,89,55,144,
2339,1016,69,52,121,
2340,1029,94,53,147,
2341,1040,82,69,151,
2342,1024,70,56,126,
2343,1046,80,76,156,
2344,976,79,45,124,
2345,956,69,54,123,
2346,1050,77,57,134,
2347,967,55,54,109,
2348,1066,88,61,149,
2349,968,62,43,105,
2350,989,71,73,144,
2351,1074,57,48,105,
2352,1020,73,59,132,
2353,1076,71,52,123,
2354,1013,72,50,122,
2355,1025,55,54,109,
2356,1009,64,56,120,
2357,990,75,69,144,
2358,998,65,62,127,
2359,1041,83,50,133,
2360,1010,77,63,140,
2361,1019,69,63,132,
2362,964,72,60,132,
2363,1012,84,42,126,
2364,975,72,48,120,
2365,1019,71,47,118,
2366,1023,78,55,133,
2367,1037,68,62,130,
2368,1064,64,67,131,
2369,1012,85,51,136,
2370,1023,80,60,140,
2371,987,72,67,139,
2372,1032,80,52,132,
2373,1023,72,53,125,
2374,1019,80,67,147,
2375,1040,84,53,137,
2376,1078,66,53,119,
2377,980,70,54,124,
2378,1037,77,67,144,
2379,1048,72,56,128,
2380,939,75,60,135,
2381,969,72,55,127,
2382,1066,90,49,139,
2383,1059,87,54,141,
2384,993,78,49,127,
2385,985,69,52,121,
2386,1028,67,58,125,
2387,1035,77,59,136,
2388,1071,73,43,116,
2389,1021,59,58,117,
2390,1038,74,59,133,
2391,1005,74,60,134,
2392,994,68,51,119,
2393,958,67,51,118,
2394,1007,56,49,105,
2395,1066,80,67,147,
2396,1097,81,57,138,
2397,1027,83,64,147,
2398,996,69,68,137,
2399,998,76,57,133,
2400,957,72,61,133,
2401,1003,78,60,138,
2402,1037,79,64,143,
2403,1028,79,55,134,
2404,1016,79,56,135,
2405,1028,85,50,135,
2406,988,87,64,151,
2407,982,74,52,126,
2408,1019,78,73,151,
2409,1034,72,55,127,
2410,998,75,53,128,
2411,1010,83,71,154,
2412,1015,80,56,136,
2413,1021,71,53,124,
2414,1044,81,68,149,
2415,1017,64,51,115,
2416,1031,71,59,130,
2417,1041,65,62,127,
2418,981,71,49,120,
2419,1017,75,65,140,
2420,1034,77,69,146,
2421,1016,74,56,130,
2422,929,72,54,126,
2423,1066,82,49,131,
2424,1044,69,69,138,
2425,1022,67,72,139,
2426,1006,86,61,147,
2427,1011,67,57,124,
2428,1026,77,60,137,
2429,1049,78,55,133,
2430,1016,76,56,132,
2431,973,66,58,124,
2432,987,84,54,138,
2433,1008,69,49,118,
2434,1064,71,69,140,
2435,961,68,47,115,
2436,997,81,54,135,
2437,950,65,61,126,
2438,1036,66,64,130,
2439,1056,66,58,124,
2440,1015,70,68,138,
2441,1031,75,52,127,
2442,1009,59,67,126,
2443,1058,81,58,139,
2444,1040,57,59,116,
2445,1070,60,65,125,
2446,1016,75,73,148,
2447,1030,68,62,130,
2448,991,73,56,129,
2449,1047,79,64,143,
2450,989,69,44,113,
2451,1010,76,49,125,
2452,995,66,52,118,
2453,1056,90,66,156,
2454,989,59,64,123,
2455,1017,86,53,139,
2456,1087,67,63,130,
2457,1064,79,57,136,
2458,1037,82,60,142,
2459,991,90,51,141,
2460,1054,75,52,127,
2461,1079,82,60,142,
2462,1038,75,66,141,
2463,1016,76,66,142,
2464,943,66,57,123,
2465,969,67,63,130,
2466,1050,87,76,163,
2467,1047,82,58,140,
2468,1027,87,56,143,
2469,985,88,53,141,
2470,1023,74,56,130,
2471,1048,74,60,134,
2472,1055,70,51,121,
2473,1048,69,53,122,
2474,1034,58,49,107,
2475,969,77,60,137,
2476,1014,75,58,133,
2477,1018,69,66,135,
2478,1072,84,57,141,
2479,1005,72,52,124,
2480,994,62,54,116,
2481,1071,78,57,135,
2482,1064,84,55,139,
2483,1044,87,48,135,
2484,1038,76,52,128,
2485,970,57,43,100,
2486,994,73,57,130,
2487,932,63,55,118,
2488,1019,76,68,144,
2489,987,67,52,119,
2490,948,67,51,118,
2491,1041,65,56,121,
2492,1022,89,59,148,
2493,1004,59,58,117,
2494,1048,75,71,146,
2495,1022,73,66,139,
2496,1054,76,45,121,
2497,1048,81,53,134,
2498,1055,78,54,132,
2499,978,79,46,125,
2500,984,81,58,139,
2501,1054,74,60,134,
2502,1022,63,57,120,
2503,1056,74,58,132,
2504,1140,93,63,156,
2505,1053,66,51,117,
2506,1016,82,67,149,
2507,1026,84,51,135,
2508,1107,74,65,139,
2509,1064,65,59,124,
2510,1023,85,67,152,
2511,996,86,47,133,
2512,1049,57,49,106,
2513,1102,82,56,138,
2514,1056,69,58,127,
2515,1081,88,64,152,
2516,1070,80,53,133,
2517,1036,102,66,168,
2518,1069,66,67,133,
2519,1109,62,59,121,
2520,1050,84,70,154,
2521,1088,80,43,123,
2522,1001,79,70,149,
2523,1020,70,64,134,
2524,1014,70,56,126,
2525,1008,74,62,136,
2526,1072,67,54,121,
2527,999,73,64,137,
2528,1036,87,55,142,
2529,1024,73,57,130,
2530,1032,67,59,126,
2531,997,79,46,125,
2532,1017,76,42,118,
2533,1034,83,46,129,
2534,982,61,56,117,
2535,1007,70,58,128,
2536,1043,76,58,134,
2537,1039,81,62,143,
2538,1152,82,60,142,
2539,1012,79,48,127,
2540,984,70,54,124,
2541,1027,82,54,136,
2542,1049,78,72,150,
2543,1008,79,64,143,
2544,1027,65,64,129,
2545,997,61,60,121,
2546,1033,74,48,122,
2547,996,60,54,114,
2548,988,69,48,117,
2549,1028,66,62,128,
2550,1038,70,66,136,
2551,978,70,51,121,
2552,995,66,58,124,
2553,1038,82,50,132,
2554,1004,67,64,131,
2555,1028,77,55,132,
2556,954,73,61,134,
2557,1069,74,52,126,
2558,1002,77,58,135,
2559,1077,90,54,144,
2560,987,72,65,137,
2561,1004,78,61,139,
2562,997,78,53,131,
2563,1005,63,68,131,
2564,1034,70,66,136,
2565,1012,78,60,138,
2566,1007,70,53,123,
2567,1013,77,54,131,
2568,992,70,59,129,
2569,1048,79,60,139,
2570,1038,79,63,142,
2571,1009,62,58,120,
2572,1019,72,61,133,
2573,1039,80,51,131,
2574,1057,80,61,141,
2575,1049,76,55,131,
2576,968,75,57,132,
2577,1041,73,59,132,
2578,1028,73,69,142,
2579,1045,70,44,114,
2580,1009,84,60,144,
2581,1003,70,60,130,
2582,1037,72,59,131,
2583,1013,75,49,124,
2584,1023,85,46,131,
2585,1013,57,80,137,
2586,1021,83,57,140,
2587,1045,72,57,129,
2588,989,64,61,125,
2589,1085,78,50,128,
2590,970,58,56,114,
2591,1009,83,53,136,
2592,1031,92,58,150,
2593,1025,77,66,143,
2594,1075,72,64,136,
2595,1037,85,59,144,
2596,1077,73,42,115,
2597,1027,75,49,124,
2598,1030,72,59,131,
2599,1060,91,67,158,
2600,1077,90,63,153,
2601,1004,89,58,147,
2602,1015,92,56,148,
2603,1010,85,74,159,
2604,1027,79,63,142,
2605,1008,73,59,132,
2606,1035,84,53,137,
2607,1051,87,56,143,
2608,1004,80,42,122,
2609,964,72,59,131,
2610,1038,59,60,119,
2611,981,85,49,134,
2612,1005,76,56,132,
2613,1002,71,40,111,
2614,1004,79,64,143,
2615,1022,81,51,132,
2616,983,85,58,143,
2617,1022,73,67,140,
2618,965,62,54,116,
2619,979,72,55,127,
2620,996,67,56,123,
2621,1130,69,58,127,
2622,1032,86,60,146,
2623,1057,68,53,121,
2624,1040,80,61,141,
2625,969,69,52,121,
2626,994,95,54,149,
2627,1008,68,58,126,
2628,1051,59,56,115,
2629,1069,81,60,141,
2630,1002,55,50,105,
2631,1030,77,54,131,
2632,1037,73,58,131,
2633,996,87,53,140,
2634,915,53,66,119,
2635,1067,80,62,142,
2636,1040,76,48,124,
2637,1010,67,73,140,
2638,1005,78,57,135,
2639,1005,65,76,141,
2640,1019,68,68,136,
2641,1050,85,58,143,
2642,1050,58,48,106,
2643,1026,79,56,135,
2644,1043,70,60,130,
2645,970,57,57,114,
2646,1016,78,61,139,
2647,980,71,52,123,
2648,1028,63,69,132,
2649,1049,68,64,132,
2650,991,79,63,142,
2651,1022,84,64,148,
2652,976,60,44,104,
2653,1020,69,59,128,
2654,1028,80,52,132,
2655,1034,79,56,135,
2656,1006,74,60,134,
2657,1011,64,63,127,
2658,1027,64,60,124,
2659,1007,74,44,118,
2660,1021,81,66,147,
2661,1042,84,76,160,
2662,1017,77,65,142,
2663,993,102,59,161,
2664,1009,55,67,122,
2665,1031,69,61,130,
2666,999,79,56,135,
2667,1011,81,72,153,
2668,1051,93,71,164,
2669,1122,79,72,151,
2670,1006,70,64,134,
2671,954,61,46,107,
2672,977,63,54,117,
2673,1024,68,52,120,
2674,933,65,56,121,
2675,1029,83,49,132,
2676,1016,78,70,148,
2677,1000,62,46,108,
2678,991,84,51,135,
2679,1037,88,75,163,
2680,998,64,62,126,
2681,1028,82,68,150,
2682,1017,58,56,114,
2683,1027,76,67,143,
2684,1044,74,60,134,
2685,1012,61,70,131,
2686,1037,84,61,145,
2687,1048,63,56,119,
2688,996,80,40,120,
2689,1085,67,70,137,
2690,997,82,70,152,
2691,1048,86,58,144,
2692,1047,87,58,145,
2693,1029,67,59,126,
2694,987,74,40,114,
2695,1028,71,41,112,
2696,1011,82,51,133,
2697,1057,95,60,155,
2698,1006,71,53,124,
2699,1018,74,60,134,
2700,991,70,69,139,
2701,1084,74,59,133,
2702,1043,70,70,140,
2703,1057,86,70,156,
2704,1057,83,67,150,
2705,1056,76,61,137,
2706,942,57,52,109,
2707,1013,62,69,131,
2708,975,75,55,130,
2709,1007,62,67,129,
2710,1051,69,63,132,
2711,1055,69,66,135,
2712,1017,81,61,142,
2713,1043,58,53,111,
2714,1057,57,74,131,
2715,1074,84,53,137,
2716,980,54,47,101,
2717,999,73,51,124,
2718,987,78,54,132,
2719,1050,70,50,120,
2720,1010,75,58,133,
2721,1045,78,59,137,
2722,1019,65,68,133,
2723,1002,70,62,132,
2724,1095,62,65,127,
2725,1014,66,55,121,
2726,1022,78,68,146,
2727,1044,62,61,123,
2728,955,77,57,134,
2729,1018,80,53,133,
2730,1039,60,71,131,
2731,995,63,65,128,
2732,1098,92,64,156,
2733,1031,76,52,128,
2734,979,66,59,125,
2735,1017,65,57,122,
2736,1005,69,58,127,
2737,1013,82,50,132,
2738,1004,86,57,143,
2739,996,76,64,140,
2740,1048,76,41,117,
2741,1026,76,56,132,
2742,993,73,48,121,
2743,1067,72,63,135,
2744,968,78,70,148,
2745,1001,68,59,127,
2746,1039,71,58,129,
2747,991,71,49,120,
2748,972,71,61,132,
2749,1056,90,53,143,
2750,1022,78,50,128,
2751,969,76,60,136,
2752,1060,78,66,144,
2753,1062,64,62,126,
2754,966,69,48,117,
2755,1042,86,58,144,
2756,1023,76,58,134,
2757,1035,78,54,132,
2758,950,76,62,138,
2759,989,68,47,115,
2760,1042,80,64,144,
2761,996,78,53,131,
2762,1029,74,71,145,
2763,1050,72,67,139,
2764,1013,71,50,121,
2765,1055,76,60,136,
2766,1029,80,63,143,
2767,1027,83,43,126,
2768,1048,73,63,136,
2769,1037,74,58,132,
2770,1056,81,60,141,
2771,1028,79,70,149,
2772,1009,72,43,115,
2773,1026,69,52,121,
2774,1031,70,45,115,
2775,990,69,62,131,
2776,982,68,60,128,
2777,1013,67,58,125,
2778,1025,74,60,134,
2779,1048,63,63,126,
2780,1059,61,63,124,
2781,978,53,61,114,
2782,977,65,47,112,
2783,1028,82,56,138,
2784,1002,75,52,127,
2785,987,71,55,126,
2786,995,55,53,108,
2787,1028,61,59,120,
2788,1050,75,75,150,
2789,972,63,51,114,
2790,1007,77,48,125,
2791,976,71,56,127,
2792,1061,86,65,151,
2793,1052,80,64,144,
2794,983,86,62,148,
2795,1069,78,57,135,
2796,1041,70,66,136,
2797,1021,58,59,117,
2798,1036,75,73,148,
2799,1054,75,61,136,
2800,1062,79,67,146,
2801,1058,88,68,156,
2802,1026,77,55,132,
2803,1012,72,59,131,
2804,1019,75,59,134,
2805,978,67,64,131,
2806,1013,70,62,132,
2807,1081,76,67,143,
2808,1007,64,67,131,
2809,1044,65,57,122,
2810,960,74,62,136,
2811,1009,88,59,147,
2812,977,54,68,122,
2813,996,72,54,126,
2814,1030,80,78,158,
2815,1002,70,64,134,
2816,1003,71,49,120,
2817,985,68,72,140,
2818,999,65,62,127,
2819,1019,71,70,141,
2820,988,68,60,128,
2821,1021,64,46,110,
2822,984,80,57,137,
2823,1037,65,68,133,
2824,1030,66,64,130,
2825,936,69,52,121,
2826,1037,76,51,127,
2827,1065,89,53,142,
2828,1032,73,61,134,
2829,1071,83,70,153,
2830,958,67,53,120,
2831,1021,70,63,133,
2832,1051,72,52,124,
2833,939,67,51,118,
2834,1047,83,60,143,
2835,997,77,56,133,
2836,1043,79,63,142,
2837,978,65,37,102,
2838,1004,73,58,131,
2839,1012,78,63,141,
2840,965,63,56,119,
2841,1011,76,50,126,
2842,1079,71,64,135,
2843,1039,76,49,125,
2844,1097,88,69,157,
2845,989,64,55,119,
2846,1011,85,56,141,
2847,1011,66,59,125,
2848,1020,62,46,108,
2849,1007,67,52,119,
2850,1015,78,46,124,
2851,1010,72,46,118,
2852,987,58,67,125,
2853,1062,79,55,134,
2854,1023,76,62,138,
2855,1037,84,65,149,
2856,1013,70,47,117,
2857,1005,73,59,132,
2858,1025,73,52,125,
2859,1003,85,60,145,
2860,1067,79,60,139,
2861,1037,76,46,122,
2862,1055,63,61,124,
2863,980,73,53,126,
2864,1059,81,77,158,
2865,1001,82,55,137,
2866,1021,91,68,159,
2867,1097,66,66,132,
2868,1013,68,61,129,
2869,943,63,48,111,
2870,982,58,86,144,
2871,1010,67,55,122,
2872,1002,68,48,116,
2873,1030,84,56,140,
2874,1015,90,63,153,
2875,975,80,49,129,
2876,1025,76,54,130,
2877,1020,73,58,131,
2878,1030,58,59,117,
2879,1069,75,58,133,
2880,993,60,63,123,
2881,1068,85,66,151,
2882,1054,63,59,122,
2883,1009,78,52,130,
2884,1057,81,59,140,
2885,1050,80,67,147,
2886,1046,74,58,132,
2887,1053,95,62,157,
2888,1047,93,66,159,
2889,1030,84,60,144,
2890,1021,74,57,131,
2891,1019,90,63,153,
2892,1024,76,59,135,
2893,1029,86,58,144,
2894,1016,80,61,141,
2895,971,56,57,113,
2896,983,66,54,120,
2897,1052,76,60,136,
2898,1022,72,55,127,
2899,1015,73,55,128,
2900,977,69,54,123,
2901,1046,85,56,141,
2902,1035,68,62,130,
2903,1031,94,54,148,
2904,1080,71,57,128,
2905,1009,70,65,135,
2906,1034,65,56,121,
2907,1004,78,46,124,
2908,972,59,70,129,
2909,1012,68,71,139,
2910,1011,69,58,127,
2911,996,72,51,123,
2912,983,74,43,117,
2913,1062,74,57,131,
2914,1040,75,71,146,
2915,1049,83,59,142,
2916,1014,56,61,117,
2917,984,60,63,123,
2918,1052,68,55,123,
2919,1040,78,62,140,
2920,961,73,55,128,
2921,950,76,59,135,
2922,1041,67,74,141,
2923,989,83,49,132,
2924,1003,64,69,133,
2925,1001,77,53,130,
2926,1020,62,67,129,
2927,964,82,50,132,
2928,1011,71,62,133,
2929,1040,81,53,134,
2930,1058,72,51,123,
2931,1051,58,69,127,
2932,1009,70,71,141,
2933,1039,82,42,124,
2934,1025,88,60,148,
2935,993,63,66,129,
2936,994,77,43,120,
2937,994,71,54,125,
2938,1108,80,68,148,
2939,1034,61,61,122,
2940,1011,79,70,149,
2941,1013,75,64,139,
2942,996,85,61,146,
2943,985,80,52,132,
2944,977,67,50,117,
2945,1012,63,47,110,
2946,1005,82,68,150,
2947,1056,71,63,134,
2948,995,73,59,132,
2949,998,78,61,139,
2950,975,83,58,141,
2951,1060,68,63,131,
2952,1041,64,67,131,
2953,993,79,67,146,
2954,1007,77,72,149,
2955,973,81,61,142,
2956,1005,73,59,132,
2957,1029,66,61,127,
2958,1061,61,66,127,
2959,1025,88,51,139,
2960,968,65,54,119,
2961,995,67,54,121,
2962,1017,78,58,136,
2963,1059,81,50,131,
2964,1033,97,62,159,
2965,1001,70,57,127,
2966,1024,67,56,123,
2967,1024,70,54,124,
2968,993,61,54,115,
2969,980,74,52,126,
2970,1007,71,52,123,
2971,1048,77,62,139,
2972,1058,85,66,151,
2973,1084,81,51,132,
2974,1038,72,55,127,
2975,1023,72,61,133,
2976,1012,67,59,126,
2977,1052,93,61,154,
2978,1035,78,59,137,
2979,1026,65,47,112,
2980,1021,78,60,138,
2981,1007,70,63,133,
2982,982,73,52,125,
2983,1055,73,55,128,
2984,986,77,55,132,
2985,975,79,62,141,
2986,987,67,63,130,
2987,1007,80,61,141,
2988,1007,74,69,143,
2989,1037,67,55,122,
2990,1022,65,70,135,
2991,1056,79,62,141,
2992,1008,69,63,132,
2993,1015,86,46,132,
2994,1110,78,74,152,
2995,1058,82,53,135,
2996,1016,70,72,142,
2997,1053,87,72,159,
2998,1003,77,53,130,
2999,1005,97,58,155,
3000,991,55,58,113,
3001,1080,97,62,159,
3002,1004,71,68,139,
3003,1060,63,75,138,
3004,987,68,59,127,
3005,1006,75,43,118,
3006,1043,73,50,123,
3007,1048,75,55,130,
3008,1035,71,52,123,
3009,1053,61,60,121,
3010,1032,73,74,147,
3011,1061,65,44,109,
3012,1001,74,62,136,
3013,1060,88,67,155,
3014,990,70,58,128,
3015,1015,64,59,123,
3016,1070,71,53,124,
3017,974,70,50,120,
3018,1020,70,73,143,
3019,1013,72,45,117,
3020,1046,71,60,131,
3021,1090,77,76,153,
3022,1002,78,58,136,
3023,1028,82,57,139,
3024,1076,76,56,132,
3025,982,57,55,112,
3026,1034,87,52,139,
3027,1035,74,64,138,
3028,1032,59,62,121,
3029,1017,75,53,128,
3030,1018,84,56,140,
3031,1067,87,67,154,
3032,1040,93,46,139,
3033,999,79,69,148,
3034,997,86,64,150,
3035,1065,69,56,125,
3036,1015,72,60,132,
3037,1006,75,51,126,
3038,1030,83,58,141,
3039,1000,57,66,123,
3040,946,69,52,121,
3041,1004,98,52,150,
3042,995,83,64,147,
3043,1006,74,54,128,
3044,989,67,51,118,
3045,996,69,57,126,
3046,1034,68,61,129,
3047,993,95,63,158,
3048,979,64,43,107,
3049,1023,85,62,147,
3050,980,57,56,113,
3051,961,79,40,119,
3052,1063,75,52,127,
3053,1036,81,61,142,
3054,1078,71,67,138,
3055,1040,69,46,115,
3056,1066,88,58,146,
3057,972,85,57,142,
3058,993,73,56,129,
3059,1011,85,70,155,
3060,1033,78,49,127,
3061,1032,74,56,130,
3062,1004,66,62,128,
3063,1038,72,49,121,
3064,1026,93,63,156,
3065,1022,74,54,128,
3066,1043,70,61,131,
3067,1055,74,63,137,
3068,1021,69,64,133,
3069,1099,98,60,158,
3070,1001,76,50,126,
3071,995,83,61,144,
3072,1019,79,54,133,
3073,1015,81,53,134,
3074,1044,77,76,153,
3075,1041,73,69,142,
3076,993,70,58,128,
3077,971,69,60,129,
3078,1042,80,62,142,
3079,997,63,63,126,
3080,1034,85,53,138,
3081,1020,74,55,129,
3082,985,70,62,132,
3083,1037,61,66,127,
3084,966,63,58,121,
3085,1045,84,54,138,
3086,993,78,51,129,
3087,1055,72,74,146,
3088,977,71,56,127,
3089,1055,71,62,133,
3090,1003,64,48,112,
3091,983,64,53,117,
3092,1060,65,63,128,
3093,934,62,47,109,
3094,1060,73,57,130,
3095,1013,82,58,140,
3096,1006,72,56,128,
3097,1036,65,74,139,
3098,1042,76,68,144,
3099,1004,78,67,145,
3100,1081,69,64,133,
3101,1004,77,50,127,
3102,1003,64,57,121,
3103,986,81,56,137,
3104,982,81,52,133,
3105,1004,80,58,138,
3106,998,76,61,137,
3107,1057,85,62,147,
3108,1033,66,67,133,
3109,976,73,44,117,
3110,1050,75,57,132,
3111,1001,76,58,134,
3112,1009,74,49,123,
3113,1033,74,59,133,
3114,1037,83,57,140,
3115,1026,68,57,125,
3116,999,77,48,125,
3117,1016,68,57,125,
3118,1016,80,54,134,
3119,1007,71,46,117,
3120,1027,80,49,129,
3121,1008,66,50,116,
3122,992,68,56,124,
3123,1035,73,68,141,
3124,952,55,56,111,
3125,1006,72,45,117,
3126,1050,70,60,130,
3127,985,80,55,135,
3128,997,84,55,139,
3129,1001,83,56,139,
3130,1014,78,57,135,
3131,965,75,59,134,
3132,981,80,55,135,
3133,1003,59,67,126,
3134,986,78,60,138,
3135,1064,90,65,155,
3136,975,69,66,135,
3137,1028,77,61,138,
3138,1042,78,54,132,
3139,1010,84,53,137,
3140,1016,69,58,127,
3141,994,61,64,125,
3142,1055,57,73,130,
3143,1049,77,57,134,
3144,1001,63,58,121,
3145,995,67,61,128,
3146,989,63,57,120,
3147,971,79,54,133,
3148,1041,67,49,116,
3149,1071,94,64,158,
3150,1002,76,55,131,
3151,1048,83,52,135,
3152,1022,73,50,123,
3153,974,80,72,152,
3154,1031,87,68,155,
3155,1040,71,57,128,
3156,1050,81,67,148,
3157,1035,84,56,140,
3158,976,78,62,140,
3159,967,65,59,124,
3160,986,77,67,144,
3161,1038,77,62,139,
3162,1063,66,69,135,
3163,1029,77,48,125,
3164,999,71,55,126,
3165,1055,82,48,130,
3166,1035,74,51,125,
3167,1022,79,53,132,
3168,1035,85,70,155,
3169,1031,72,68,140,
3170,1035,63,69,132,
3171,976,60,48,108,
3172,964,62,56,118,
3173,1024,72,58,130,
3174,1002,86,60,146,
3175,995,102,49,151,
3176,1067,90,55,145,
3177,1060,75,71,146,
3178,965,70,57,127,
3179,1034,62,46,108,
3180,994,72,53,125,
3181,1044,76,71,147,
3182,1004,71,60,131,
3183,988,73,48,121,
3184,1012,68,48,116,
3185,962,75,62,137,
3186,1008,82,62,144,
3187,980,82,54,136,
3188,990,62,46,108,
3189,1045,82,55,137,
3190,1051,77,63,140,
3191,1029,90,73,163,
3192,963,85,50,135,
3193,975,68,58,126,
3194,966,67,47,114,
3195,991,63,62,125,
3196,1015,82,67,149,
3197,1004,73,33,106,
3198,953,65,54,119,
3199,1075,75,66,141,
3200,1057,78,62,140,
3201,989,77,52,129,
3202,952,66,52,118,
3203,966,71,41,112,
3204,1003,77,49,126,
3205,989,65,65,130,
3206,1011,59,65,124,
3207,1025,73,69,142,
3208,967,66,61,127,
3209,1005,68,61,129,
3210,1051,87,49,136,
3211,1007,91,55,146,
3212,1007,94,59,153,
3213,1038,73,66,139,
3214,1004,59,55,114,
3215,988,74,58,132,
3216,992,75,45,120,
3217,1032,64,48,112,
3218,1025,74,56,130,
3219,1002,70,51,121,
3220,981,76,59,135,
3221,975,67,62,129,
3222,1032,84,70,154,
3223,946,83,63,146,
3224,1026,79,73,152,
3225,1093,71,57,128,
3226,991,84,60,144,
3227,1010,65,54,119,
3228,1020,69,51,120,
3229,961,81,63,144,
3230,1050,82,69,151,
3231,1022,65,71,136,
3232,1048,76,55,131,
3233,993,74,59,133,
3234,1056,84,60,144,
3235,1020,87,52,139,
3236,1009,80,62,142,
3237,972,66,52,118,
3238,1029,87,53,140,
3239,1054,73,68,141,
3240,1044,72,52,124,
3241,968,71,84,155,
3242,1028,79,61,140,
3243,1041,72,79,151,
3244,1008,84,52,136,
3245,1025,88,60,148,
3246,1011,70,62,132,
3247,990,89,48,137,
3248,1114,81,48,129,
3249,1035,74,64,138,
3250,955,83,63,146,
3251,1039,68,55,123,
3252,997,61,57,118,
3253,1025,73,52,125,
3254,1056,70,79,149,
3255,1046,72,61,133,
3256,1048,76,53,129,
3257,988,80,50,130,
3258,990,63,49,112,
3259,1039,67,73,140,
3260,1012,78,54,132,
3261,1032,72,58,130,
3262,1018,86,65,151,
3263,1047,72,65,137,
3264,981,64,62,126,
3265,944,55,55,110,
3266,1036,76,68,144,
3267,1051,88,65,153,
3268,999,79,42,121,
3269,1024,74,53,127,
3270,1027,73,64,137,
3271,1071,68,66,134,
3272,978,62,59,121,
3273,1079,89,62,151,
3274,1008,74,42,116,
3275,1000,71,58,129,
3276,1030,79,52,131,
3277,995,72,48,120,
3278,993,58,64,122,
3279,998,75,57,132,
3280,948,56,50,106,
3281,1032,64,54,118,
3282,973,82,57,139,
3283,999,78,58,136,
3284,1024,65,77,142,
3285,1048,76,60,136,
3286,1046,65,61,126,
3287,1051,77,70,147,
3288,1026,78,59,137,
3289,1012,58,54,112,
3290,1057,61,62,123,
3291,1035,78,53,131,
3292,986,80,57,137,
3293,1037,72,49,121,
3294,1031,61,67,128,
3295,999,56,58,114,
3296,1112,75,71,146,
3297,1052,85,60,145,
3298,972,62,55,117,
3299,1024,80,49,129,
3300,991,71,59,130,
3301,1019,87,65,152,
3302,973,78,48,126,
3303,975,75,51,126,
3304,983,66,75,141,
3305,965,63,51,114,
3306,1003,69,52,121,
3307,978,59,57,116,
3308,1055,92,68,160,
3309,977,62,45,107,
3310,1094,85,56,141,
3311,946,64,43,107,
3312,985,64,76,140,
3313,1015,88,49,137,
3314,941,65,50,115,
3315,986,75,52,127,
3316,951,68,67,135,
3317,1033,76,54,130,
3318,1026,72,62,134,
3319,1011,68,65,133,
3320,1020,69,63,132,
3321,1009,76,51,127,
3322,997,68,56,124,
3323,980,68,63,131,
3324,1047,79,58,137,
3325,1085,74,68,142,
3326,1016,58,67,125,
3327,1001,76,63,139,
3328,1020,76,61,137,
3329,1022,77,68,145,
3330,949,56,66,122,
3331,995,78,57,135,
3332,1001,77,61,138,
3333,1046,70,56,126,
3334,1019,64,59,123,
3335,985,73,62,135,
3336,1024,78,62,140,
3337,994,80,63,143,
3338,1021,71,57,128,
3339,997,76,61,137,
3340,1004,72,59,131,
3341,1007,75,50,125,
3342,1052,83,62,145,
3343,1024,81,46,127,
3344,1004,78,56,134,
3345,1026,67,62,129,
3346,1030,66,43,109,
3347,1038,62,67,129,
3348,1066,73,52,125,
3349,958,57,55,112,
3350,955,76,51,127,
3351,1000,73,62,135,
3352,1028,76,68,144,
3353,989,71,58,129,
3354,1021,75,52,127,
3355,1049,75,65,140,
3356,1064,86,75,161,
3357,1035,75,46,121,
3358,968,61,48,109,
3359,997,70,60,130,
3360,986,79,55,134,
3361,1027,77,53,130,
3362,1070,86,53,139,
3363,1022,59,52,111,
3364,1045,79,66,145,
3365,1028,77,67,144,
3366,996,75,51,126,
3367,1036,73,53,126,
3368,1011,77,62,139,
3369,1008,58,70,128,
3370,1008,71,58,129,
3371,1071,79,64,143,
3372,1020,81,60,141,
3373,1020,67,53,120,
3374,1032,92,59,151,
3375,1027,83,44,127,
3376,1050,73,53,126,
3377,994,80,43,123,
3378,1037,69,56,125,
3379,998,85,54,139,
3380,999,68,63,131,
3381,999,69,61,130,
3382,998,69,63,132,
3383,1060,74,71,145,
3384,975,65,56,121,
3385,1024,74,61,135,
3386,1034,81,63,144,
3387,1021,61,69,130,
3388,1082,82,69,151,
3389,1025,77,49,126,
3390,975,75,51,126,
3391,1029,87,57,144,
3392,1051,74,58,132,
3393,1011,66,51,117,
3394,999,61,58,119,
3395,1012,74,44,118,
3396,1078,82,55,137,
3397,1051,79,55,134,
3398,1029,72,58,130,
3399,1084,74,62,136,
3400,1009,59,58,117,
3401,1031,75,51,126,
3402,1008,61,53,114,
3403,1038,67,62,129,
3404,982,60,73,133,
3405,1013,73,62,135,
3406,992,73,61,134,
3407,958,92,52,144,
3408,997,71,56,127,
3409,1003,71,73,144,
3410,976,75,51,126,
3411,974,61,57,118,
3412,1041,66,60,126,
3413,1105,68,59,127,
3414,1052,94,44,138,
3415,1009,66,64,130,
3416,1018,73,63,136,
3417,966,66,57,123,
3418,925,73,51,124,
3419,1027,72,54,126,
3420,1053,70,56,126,
3421,1010,64,56,120,
3422,1039,82,41,123,
3423,1007,65,60,125,
3424,1019,73,56,129,
3425,1042,77,58,135,
3426,1038,85,55,140,
3427,1027,69,63,132,
3428,1006,69,51,120,
3429,1049,68,64,132,
3430,1010,69,61,130,
3431,994,76,64,140,
3432,1064,85,61,146,
3433,980,75,49,124,
3434,1002,57,56,113,
3435,1027,97,70,167,
3436,1016,68,60,128,
3437,983,71,71,142,
3438,1106,89,53,142,
3439,1027,69,66,135,
3440,1003,78,68,146,
3441,985,69,55,124,
3442,953,66,50,116,
3443,1096,75,72,147,
3444,1020,85,61,146,
3445,1036,78,44,122,
3446,993,55,71,126,
3447,993,67,60,127,
3448,1026,88,57,145,
3449,1072,64,69,133,
3450,969,60,54,114,
3451,1011,77,45,122,
3452,1030,81,59,140,
3453,1088,83,57,140,
3454,1054,62,48,110,
3455,946,63,48,111,
3456,1015,65,59,124,
3457,1029,56,60,116,
3458,999,80,48,128,
3459,1020,75,50,125,
3460,994,78,66,144,
3461,1003,68,63,131,
3462,963,66,47,113,
3463,1032,76,59,135,
3464,1029,78,54,132,
3465,1005,68,58,126,
3466,1042,67,64,131,
3467,1028,68,51,119,
3468,1037,78,64,142,
3469,998,74,55,129,
3470,1009,62,45,107,
3471,1021,69,63,132,
3472,967,75,57,132,
3473,1038,73,66,139,
3474,982,85,54,139,
3475,995,67,45,112,
3476,1024,50,53,103,
3477,1010,64,57,121,
3478,983,65,61,126,
3479,1087,77,54,131,
3480,966,74,61,135,
3481,1014,77,51,128,
3482,955,75,47,122,
3483,1067,82,56,138,
3484,1028,68,56,124,
3485,1016,87,52,139,
3486,1003,85,58,143,
3487,1009,75,60,135,
3488,1023,70,58,128,
3489,1055,78,66,144,
3490,982,68,63,131,
3491,1003,70,67,137,
3492,976,60,51,111,
3493,983,77,49,126,
3494,1052,67,54,121,
3495,1068,76,46,122,
3496,1075,70,56,126,
3497,1015,80,61,141,
3498,1037,60,66,126,
3499,1023,73,72,145,
3500,1052,72,64,136,
3501,1023,62,61,123,
3502,990,85,51,136,
3503,1016,74,59,133,
3504,1022,78,53,131,
3505,991,61,50,111,
3506,951,82,55,137,
3507,1056,85,43,128,
3508,1089,69,76,145,
3509,1020,65,56,121,
3510,994,81,52,133,
3511,1123,74,55,129,
3512,1063,87,63,150,
3513,959,64,46,110,
3514,994,76,59,135,
3515,1010,91,49,140,
3516,1051,57,50,107,
3517,1011,77,59,136,
3518,993,62,60,122,
3519,1027,69,48,117,
3520,970,85,58,143,
3521,1097,82,52,134,
3522,1043,80,51,131,
3523,1001,74,43,117,
3524,933,82,43,125,
3525,994,70,53,123,
3526,994,75,54,129,
3527,1046,74,68,142,
3528,987,65,70,135,
3529,1035,71,54,125,
3530,974,84,63,147,
3531,1012,76,51,127,
3532,999,70,73,143,
3533,1012,83,62,145,
3534,986,63,53,116,
3535,994,83,58,141,
3536,1051,78,60,138,
3537,967,74,59,133,
3538,991,73,60,133,
3539,1028,72,74,146,
3540,1061,71,69,140,
3541,1041,79,59,138,
3542,1008,67,62,129,
3543,970,67,60,127,
3544,1047,70,68,138,
3545,976,76,52,128,
3546,994,79,56,135,
3547,969,82,51,133,
3548,1008,85,75,160,
3549,1013,73,53,126,
3550,1004,68,48,116,
3551,1029,73,73,146,
3552,1026,90,48,138,
3553,1018,67,45,112,
3554,1068,75,71,146,
3555,1050,87,54,141,
3556,1046,74,62,136,
3557,1058,67,63,130,
3558,974,98,47,145,
3559,1030,68,57,125,
3560,1026,88,48,136,
3561,1002,77,63,140,
3562,1003,67,57,124,
3563,1007,71,74,145,
3564,956,72,43,115,
3565,1053,79,57,136,
3566,1001,77,58,135,
3567,1015,84,55,139,
3568,1063,69,57,126,
3569,1129,70,68,138,
3570,953,66,41,107,
3571,1011,70,63,133,
3572,1103,91,67,158,
3573,918,90,57,147,
3574,1056,69,57,126,
3575,982,70,58,128,
3576,1049,75,55,130,
3577,1044,83,58,141,
3578,1000,64,41,105,
3579,989,68,60,128,
3580,1013,64,61,125,
3581,1103,83,64,147,
3582,1016,68,56,124,
3583,1014,73,51,124,
3584,1020,71,57,128,
3585,948,73,59,132,
3586,1019,78,58,136,
3587,998,64,53,117,
3588,1021,82,69,151,
3589,1056,76,51,127,
3590,1013,56,66,122,
3591,1019,76,62,138,
3592,979,65,50,115,
3593,1004,61,69,130,
3594,931,67,58,125,
3595,1049,89,65,154,
3596,1064,70,69,139,
3597,1048,87,71,158,
3598,1051,84,63,147,
3599,1051,83,67,150,
3600,1038,80,58,138,
3601,987,73,54,127,
3602,995,75,59,134,
3603,1026,69,61,130,
3604,976,82,56,138,
3605,997,66,55,121,
3606,1037,79,61,140,
3607,1029,65,50,115,
3608,954,69,50,119,
3609,976,83,55,138,
3610,1090,101,66,167,
3611,1008,87,51,138,
3612,996,71,49,120,
3613,996,79,61,140,
3614,1008,84,54,138,
3615,1013,79,48,127,
3616,1037,80,68,148,
3617,992,68,48,116,
3618,1011,85,59,144,
3619,1000,67,53,120,
3620,1020,71,59,130,
3621,1036,81,67,148,
3622,994,66,60,126,
3623,1015,67,56,123,
3624,1004,79,58,137,
3625,1014,60,62,122,
3626,974,76,59,135,
3627,978,66,59,125,
3628,1036,66,66,132,
3629,1053,91,63,154,
3630,1027,75,55,130,
3631,1017,73,58,131,
3632,939,67,48,115,
3633,1035,83,51,134,
3634,1036,78,54,132,
3635,1002,72,48,120,
3636,989,56,46,102,
3637,1008,62,49,111,
3638,1047,84,63,147,
3639,981,66,52,118,
3640,1001,64,65,129,
3641,1007,70,73,143,
3642,1051,95,45,140,
3643,1013,93,66,159,
3644,1028,73,59,132,
3645,1029,66,50,116,
3646,1020,67,57,124,
3647,949,75,51,126,
3648,995,73,59,132,
3649,1015,78,51,129,
3650,1025,91,54,145,
3651,983,70,55,125,
3652,995,62,63,125,
3653,1089,84,56,140,
3654,1054,74,49,123,
3655,1065,82,62,144,
3656,1025,69,72,141,
3657,1013,73,51,124,
3658,1071,85,69,154,
3659,1063,74,46,120,
3660,1040,61,68,129,
3661,1040,71,62,133,
3662,978,78,41,119,
3663,1011,65,46,111,
3664,1035,86,57,143,
3665,981,65,56,121,
3666,1052,72,63,135,
3667,1059,75,63,138,
3668,1023,81,68,149,
3669,992,68,62,130,
3670,987,86,48,134,
3671,1098,75,53,128,
3672,990,59,56,115,
3673,1012,60,67,127,
3674,992,59,60,119,
3675,1058,82,61,143,
3676,1010,73,50,123,
3677,942,68,52,120,
3678,1019,77,51,128,
3679,1028,74,54,128,
3680,1036,63,62,125,
3681,1035,75,50,125,
3682,1003,86,62,148,
3683,998,86,40,126,
3684,1044,76,64,140,
3685,964,67,59,126,
3686,966,72,52,124,
3687,1033,83,66,149,
3688,1014,76,56,132,
3689,991,76,58,134,
3690,1024,73,53,126,
3691,1007,54,50,104,
3692,980,72,67,139,
3693,998,65,59,124,
3694,1016,65,50,115,
3695,1023,75,69,144,
3696,1050,81,68,149,
3697,1071,77,59,136,
3698,1047,71,58,129,
3699,1002,80,59,139,
3700,950,72,55,127,
3701,997,73,55,128,
3702,1076,86,57,143,
3703,952,72,46,118,
3704,1028,69,47,116,
3705,1032,81,56,137,
3706,944,59,59,118,
3707,977,81,61,142,
3708,987,74,57,131,
3709,1064,83,64,147,
3710,955,65,64,129,
3711,1048,72,79,151,
3712,988,75,62,137,
3713,998,77,64,141,
3714,976,70,58,128,
3715,1036,77,62,139,
3716,1035,62,61,123,
3717,934,59,59,118,
3718,1011,79,54,133,
3719,1021,72,59,131,
3720,1059,78,80,158,
3721,1076,71,58,129,
3722,1103,99,61,160,
3723,1014,71,51,122,
3724,1010,78,49,127,
3725,1065,86,52,138,
3726,991,82,65,147,
3727,985,71,62,133,
3728,956,62,63,125,
3729,1022,69,70,139,
3730,1066,88,54,142,
3731,1031,65,61,126,
3732,1015,71,54,125,
3733,960,65,64,129,
3734,964,78,59,137,
3735,1039,82,57,139,
3736,1053,79,67,146,
3737,956,83,59,142,
3738,1023,83,62,145,
3739,1017,77,42,119,
3740,1098,84,63,147,
3741,1019,70,41,111,
3742,1006,72,56,128,
3743,1017,75,57,132,
3744,1012,88,59,147,
3745,1006,76,63,139,
3746,1011,78,63,141,
3747,1028,71,56,127,
3748,1024,80,57,137,
3749,994,75,60,135,
3750,1027,77,61,138,
3751,1041,87,63,150,
3752,1072,68,64,132,
3753,965,56,55,111,
3754,967,75,55,130,
3755,963,58,58,116,
3756,1060,78,56,134,
3757,998,73,61,134,
3758,999,69,53,122,
3759,973,72,65,137,
3760,1000,62,57,119,
3761,1044,72,63,135,
3762,1004,76,50,126,
3763,1015,79,57,136,
3764,1007,72,47,119,
3765,983,69,51,120,
3766,1012,73,68,141,
3767,977,83,59,142,
3768,1089,87,73,160,
3769,965,63,54,117,
3770,966,62,61,123,
3771,1022,87,51,138,
3772,1007,74,54,128,
3773,1006,64,60,124,
3774,1056,72,58,130,
3775,1047,62,62,124,
3776,998,64,58,122,
3777,1042,64,67,131,
3778,996,80,53,133,
3779,1045,70,49,119,
3780,1002,61,61,122,
3781,1050,70,55,125,
3782,1030,94,58,152,
3783,1002,75,70,145,
3784,998,62,58,120,
3785,1042,70,63,133,
3786,989,72,59,131,
3787,1041,72,67,139,
3788,1000,83,57,140,
3789,1035,75,56,131,
3790,1015,81,65,146,
3791,1099,67,69,136,
3792,1008,71,50,121,
3793,1014,85,54,139,
3794,1030,69,68,137,
3795,972,83,67,150,
3796,1041,80,54,134,
3797,1023,66,60,126,
3798,937,72,57,129,
3799,1029,63,63,126,
3800,1101,90,63,153,
3801,1058,67,57,124,
3802,1028,77,69,146,
3803,1051,59,73,132,
3804,994,69,57,126,
3805,1011,70,55,125,
3806,1036,80,56,136,
3807,994,70,51,121,
3808,1053,65,55,120,
3809,1017,80,52,132,
3810,1024,51,66,117,
3811,1093,73,66,139,
3812,1021,69,44,113,
3813,1019,81,55,136,
3814,1032,77,59,136,
3815,1013,71,63,134,
3816,973,77,63,140,
3817,1046,62,61,123,
3818,1041,83,60,143,
3819,1043,72,66,138,
3820,1041,74,54,128,
3821,960,75,53,128,
3822,1058,76,54,130,
3823,1041,71,50,121,
3824,989,64,57,121,
3825,1005,80,68,148,
3826,982,69,61,130,
3827,1013,76,58,134,
3828,1018,83,50,133,
3829,1081,82,62,144,
3830,1051,67,62,129,
3831,999,80,51,131,
3832,991,71,53,124,
3833,952,68,62,130,
3834,1010,75,51,126,
3835,966,76,76,152,
3836,1050,69,58,127,
3837,959,65,62,127,
3838,1008,78,72,150,
3839,993,77,57,134,
3840,1008,88,57,145,
3841,1031,69,50,119,
3842,949,68,66,134,
3843,1010,75,51,126,
3844,1072,83,66,149,
3845,1026,65,59,124,
3846,1012,80,57,137,
3847,1044,70,63,133,
3848,1055,84,45,129,
3849,1012,75,53,128,
3850,991,66,63,129,
3851,1035,75,60,135,
3852,1060,75,61,136,
3853,1001,74,47,121,
3854,1024,73,46,119,
3855,1000,78,40,118,
3856,1008,64,63,127,
3857,1008,77,56,133,
3858,1055,75,61,136,
3859,1041,70,56,126,
3860,1019,80,56,136,
3861,1052,71,66,137,
3862,990,69,54,123,
3863,987,64,61,125,
3864,1039,69,57,126,
3865,1015,80,49,129,
3866,1011,71,63,134,
3867,992,54,56,110,
3868,1020,70,52,122,
3869,1018,75,70,145,
3870,945,82,47,129,
3871,1006,81,42,123,
3872,1003,74,63,137,
3873,1029,101,62,163,
3874,1087,85,58,143,
3875,982,70,56,126,
3876,963,62,51,113,
3877,1006,78,60,138,
3878,1004,86,50,136,
3879,1017,82,65,147,
3880,1076,84,59,143,
3881,965,72,66,138,
3882,1068,76,75,151,
3883,1046,78,58,136,
3884,1001,72,57,129,
3885,1048,82,60,142,
3886,992,82,53,135,
3887,1018,83,76,159,
3888,1012,77,45,122,
3889,1022,81,55,136,
3890,1035,86,43,129,
3891,976,70,44,114,
3892,1069,85,66,151,
3893,976,68,52,120,
3894,981,70,59,129,
3895,1007,82,70,152,
3896,1057,79,56,135,
3897,998,74,55,129,
3898,1025,84,63,147,
3899,945,64,64,128,
3900,1023,80,53,133,
3901,1005,81,62,143,
3902,1019,76,60,136,
3903,1036,64,49,113,
3904,1059,86,65,151,
3905,1043,81,69,150,
3906,1040,77,63,140,
3907,955,71,57,128,
3908,1011,71,61,132,
3909,1016,99,52,151,
3910,1052,77,52,129,
3911,971,72,61,133,
3912,1046,61,64,125,
3913,1027,79,66,145,
3914,1001,74,61,135,
3915,942,54,61,115,
3916,1017,78,61,139,
3917,1067,97,47,144,
3918,962,55,61,116,
3919,1041,67,53,120,
3920,1075,84,60,144,
3921,991,80,57,137,
3922,1048,70,61,131,
3923,1065,85,60,145,
3924,1112,98,66,164,
3925,973,69,54,123,
3926,1072,58,68,126,
3927,982,81,44,125,
3928,1036,75,67,142,
3929,1010,69,57,126,
3930,1064,88,65,153,
3931,1045,79,63,142,
3932,1032,83,60,143,
3933,1075,70,59,129,
3934,1032,74,52,126,
3935,1059,71,55,126,
3936,952,76,57,133,
3937,1030,85,52,137,
3938,990,65,55,120,
3939,1044,67,53,120,
3940,980,80,56,136,
3941,1063,78,64,142,
3942,1042,88,67,155,
3943,1013,83,50,133,
3944,1050,96,53,149,
3945,996,70,57,127,
3946,997,84,56,140,
3947,1065,83,69,152,
3948,1005,71,60,131,
3949,1013,71,47,118,
3950,995,75,65,140,
3951,1053,65,73,138,
3952,1068,77,60,137,
3953,1005,77,68,145,
3954,1005,64,60,124,
3955,1071,73,52,125,
3956,1009,76,64,140,
3957,973,68,60,128,
3958,1019,76,60,136,
3959,1041,81,65,146,
3960,1022,72,62,134,
3961,945,70,57,127,
3962,1015,60,50,110,
3963,1045,75,54,129,
3964,1022,78,52,130,
3965,1026,76,49,125,
3966,967,72,45,117,
3967,1058,65,58,123,
3968,1104,98,64,162,
3969,1033,77,57,134,
3970,999,75,50,125,
3971,1002,60,56,116,
3972,1015,87,49,136,
3973,1014,61,45,106,
3974,1006,81,52,133,
3975,1050,69,52,121,
3976,991,82,58,140,
3977,1059,83,62,145,
3978,1028,65,50,115,
3979,1009,81,57,138,
3980,991,74,62,136,
3981,1041,79,61,140,
3982,1021,71,65,136,
3983,1001,80,49,129,
3984,1018,84,73,157,
3985,993,84,51,135,
3986,1018,70,50,120,
3987,1004,70,54,124,
3988,1039,79,64,143,
3989,1078,97,55,152,
3990,952,82,54,136,
3991,978,78,65,143,
3992,998,64,57,121,
3993,985,66,47,113,
3994,989,73,56,129,
3995,970,70,55,125,
3996,1028,78,55,133,
3997,1001,60,38,98,
3998,999,64,60,124,
3999,1016,75,52,127,
4000,973,61,58,119,
4001,978,67,49,116,
4002,963,67,50,117,
4003,994,65,69,134,
4004,1022,68,60,128,
4005,997,61,65,126,
4006,1008,69,60,129,
4007,1012,68,58,126,
4008,1085,85,74,159,
4009,987,68,55,123,
4010,1041,77,61,138,
4011,1068,74,57,131,
4012,978,57,56,113,
4013,1029,64,50,114,
4014,1051,85,77,162,
4015,982,73,56,129,
4016,1007,67,66,133,
4017,1050,83,80,163,
4018,1044,76,53,129,
4019,1061,67,68,135,
4020,1056,79,67,146,
4021,1009,72,61,133,
4022,995,69,50,119,
4023,996,66,49,115,
4024,1050,71,78,149,
4025,1043,69,50,119,
4026,1087,64,65,129,
4027,959,77,47,124,
4028,1000,77,51,128,
4029,1049,72,58,130,
4030,1001,70,63,133,
4031,946,71,64,135,
4032,1082,88,56,144,
4033,1033,73,57,130,
4034,1082,90,63,153,
4035,1022,61,54,115,
4036,1034,65,56,121,
4037,1044,67,56,123,
4038,998,72,77,149,
4039,1067,81,66,147,
4040,1060,85,54,139,
4041,1014,70,49,119,
4042,1023,68,68,136,
4043,1029,73,56,129,
4044,1062,88,57,145,
4045,1001,88,67,155,
4046,1064,77,62,139,
4047,1031,65,62,127,
4048,1066,80,53,133,
4049,1004,78,52,130,
4050,936,56,50,106,
4051,978,67,47,114,
4052,1016,60,56,116,
4053,1074,91,58,149,
4054,962,95,49,144,
4055,1021,72,52,124,
4056,1016,62,64,126,
4057,962,65,57,122,
4058,943,78,51,129,
4059,1020,74,55,129,
4060,1010,90,57,147,
4061,1037,63,55,118,
4062,1019,77,44,121,
4063,980,72,58,130,
4064,992,73,62,135,
4065,956,54,59,113,
4066,1011,74,55,129,
4067,984,85,58,143,
4068,1008,51,73,124,
4069,984,82,55,137,
4070,1063,81,62,143,
4071,990,70,48,118,
4072,1025,69,60,129,
4073,1016,92,62,154,
4074,971,63,59,122,
4075,966,62,42,104,
4076,976,76,47,123,
4077,989,67,60,127,
4078,1097,85,61,146,
4079,1034,68,48,116,
4080,1016,70,60,130,
4081,1010,72,71,143,
4082,952,80,43,123,
4083,1043,93,61,154,
4084,1018,73,59,132,
4085,1051,78,58,136,
4086,1042,59,71,130,
4087,1054,74,63,137,
4088,992,67,53,120,
4089,1035,78,54,132,
4090,1033,60,50,110,
4091,1061,74,72,146,
4092,1066,68,77,145,
4093,1050,82,39,121,
4094,1042,74,58,132,
4095,990,72,56,128,
4096,1018,60,53,113,
4097,1008,77,55,132,
4098,1027,75,49,124,
4099,974,51,46,97,
4100,988,64,53,117,
4101,974,60,67,127,
4102,1024,86,63,149,
4103,1005,71,48,119,
4104,1025,68,60,128,
4105,1006,68,51,119,
4106,1028,69,65,134,
4107,1041,71,54,125,
4108,1007,74,54,128,
4109,972,70,62,132,
4110,1005,63,61,124,
4111,986,65,42,107,
4112,1029,79,71,150,
4113,1003,83,66,149,
4114,1006,71,52,123,
4115,990,78,53,131,
4116,1012,79,52,131,
4117,1008,75,61,136,
4118,1079,75,65,140,
4119,1007,62,55,117,
4120,983,71,59,130,
4121,1027,69,62,131,
4122,1020,54,59,113,
4123,919,67,52,119,
4124,997,75,56,131,
4125,981,79,52,131,
4126,972,65,56,121,
4127,1016,76,50,126,
4128,1003,73,62,135,
4129,971,68,50,118,
4130,1080,91,52,143,
4131,957,54,64,118,
4132,1033,77,63,140,
4133,1095,93,59,152,
4134,1071,92,66,158,
4135,1037,69,58,127,
4136,1026,77,48,125,
4137,998,66,53,119,
4138,993,74,51,125,
4139,1075,86,47,133,
4140,1033,59,45,104,
4141,1021,88,64,152,
4142,1032,92,64,156,
4143,1057,80,62,142,
4144,1017,59,77,136,
4145,1076,83,55,138,
4146,969,80,59,139,
4147,976,63,54,117,
4148,1012,89,59,148,
4149,1029,53,50,103,
4150,1031,74,59,133,
4151,1039,82,50,132,
4152,1030,78,61,139,
4153,1019,74,74,148,
4154,1074,87,59,146,
4155,999,68,67,135,
4156,1039,74,63,137,
4157,1070,94,68,162,
4158,1048,73,47,120,
4159,1016,84,50,134,
4160,1026,69,65,134,
4161,1057,78,65,143,
4162,963,84,47,131,
4163,1045,78,56,134,
4164,949,86,50,136,
4165,1006,73,55,128,
4166,1000,70,59,129,
4167,1016,75,50,125,
4168,1050,82,55,137,
4169,1005,65,60,125,
4170,1043,68,70,138,
4171,1001,59,54,113,
4172,1073,85,60,145,
4173,1010,62,53,115,
4174,997,67,57,124,
4175,1024,69,65,134,
4176,979,87,43,130,
4177,992,71,59,130,
4178,997,92,58,150,
4179,1073,86,67,153,
4180,1061,75,61,136,
4181,937,68,64,132,
4182,991,75,56,131,
4183,1041,71,50,121,
4184,1027,69,52,121,
4185,960,55,53,108,
4186,1042,67,44,111,
4187,1000,65,63,128,
4188,1014,74,62,136,
4189,995,71,50,121,
4190,1033,66,62,128,
4191,986,60,60,120,
4192,1029,96,55,151,
4193,980,64,50,114,
4194,1062,78,51,129,
4195,998,68,70,138,
4196,1024,85,52,137,
4197,1012,70,61,131,
4198,1055,65,64,129,
4199,991,72,59,131,
4200,1064,80,63,143,
4201,1024,93,55,148,
4202,998,60,55,115,
4203,999,60,65,125,
4204,1056,84,57,141,
4205,977,85,66,151,
4206,995,75,50,125,
4207,1025,70,53,123,
4208,1011,66,54,120,
4209,1031,86,55,141,
4210,1044,69,56,125,
4211,1072,74,53,127,
4212,1079,92,45,137,
4213,1032,75,63,138,
4214,963,73,60,133,
4215,1038,84,67,151,
4216,982,81,54,135,
4217,1049,81,58,139,
4218,1052,79,59,138,
4219,1011,64,62,126,
4220,1001,76,47,123,
4221,1084,74,68,142,
4222,1021,77,66,143,
4223,1022,67,59,126,
4224,1074,82,64,146,
4225,997,52,64,116,
4226,1017,77,68,145,
4227,1040,90,41,131,
4228,1054,61,48,109,
4229,1054,77,55,132,
4230,995,65,47,112,
4231,983,83,49,132,
4232,1073,70,49,119,
4233,938,71,52,123,
4234,1036,53,58,111,
4235,1026,67,55,122,
4236,1012,73,66,139,
4237,1051,73,70,143,
4238,1059,77,75,152,
4239,1027,69,58,127,
4240,1054,69,55,124,
4241,1039,72,49,121,
4242,996,79,59,138,
4243,1004,74,66,140,
4244,1002,63,60,123,
4245,1008,76,63,139,
4246,975,64,64,128,
4247,1074,70,64,134,
4248,1009,66,58,124,
4249,1010,80,51,131,
4250,989,72,65,137,
4251,949,62,58,120,
4252,1034,86,45,131,
4253,956,64,50,114,
4254,984,65,63,128,
4255,1021,79,59,138,
4256,1100,82,56,138,
4257,1021,61,69,130,
4258,991,69,53,122,
4259,1000,74,49,123,
4260,1077,73,70,143,
4261,1031,74,53,127,
4262,1047,68,65,133,
4263,1055,78,75,153,
4264,1009,77,65,142,
4265,1019,79,57,136,
4266,1004,66,65,131,
4267,1038,86,58,144,
4268,1028,74,48,122,
4269,993,64,57,121,
4270,1021,82,60,142,
4271,1001,77,58,135,
4272,1017,80,50,130,
4273,1068,75,60,135,
4274,1017,67,46,113,
4275,1085,84,56,140,
4276,1015,74,53,127,
4277,1039,69,53,122,
4278,996,63,54,117,
4279,1041,81,57,138,
4280,1010,59,68,127,
4281,1067,58,62,120,
4282,992,77,45,122,
4283,1010,76,55,131,
4284,974,63,52,115,
4285,1007,72,50,122,
4286,953,68,59,127,
4287,1054,84,62,146,
4288,1044,65,49,114,
4289,997,70,65,135,
4290,1070,87,76,163,
4291,1062,82,61,143,
4292,993,76,54,130,
4293,982,76,50,126,
4294,1019,91,71,162,
4295,1079,87,65,152,
4296,1020,80,59,139,
4297,1023,68,59,127,
4298,1010,79,64,143,
4299,928,72,57,129,
4300,1034,68,68,136,
4301,1016,73,49,122,
4302,916,71,45,116,
4303,1048,64,56,120,
4304,1036,75,59,134,
4305,956,68,40,108,
4306,974,73,46,119,
4307,1023,77,50,127,
4308,1023,72,45,117,
4309,1001,75,50,125,
4310,1006,81,69,150,
4311,1017,71,60,131,
4312,998,82,76,158,
4313,1038,82,52,134,
4314,936,69,60,129,
4315,1048,78,50,128,
4316,1012,66,46,112,
4317,1045,69,58,127,
4318,1048,98,77,175,
4319,982,78,61,139,
4320,989,70,59,129,
4321,1014,80,53,133,
4322,1024,75,56,131,
4323,1085,70,67,137,
4324,1012,75,51,126,
4325,1034,66,55,121,
4326,996,78,69,147,
4327,1018,76,64,140,
4328,988,68,57,125,
4329,1032,81,60,141,
4330,1085,94,54,148,
4331,992,71,64,135,
4332,1028,76,72,148,
4333,992,71,63,134,
4334,984,90,55,145,
4335,971,65,53,118,
4336,1020,63,66,129,
4337,994,66,60,126,
4338,1080,69,51,120,
4339,1028,67,51,118,
4340,1040,66,74,140,
4341,1022,66,72,138,
4342,1041,77,62,139,
4343,1004,69,65,134,
4344,1028,82,65,147,
4345,1022,85,62,147,
4346,1029,71,57,128,
4347,1094,66,70,136,
4348,1046,80,69,149,
4349,979,83,46,129,
4350,997,67,57,124,
4351,995,55,61,116,
4352,962,67,56,123,
4353,1067,72,60,132,
4354,1042,72,64,136,
4355,995,69,49,118,
4356,1034,56,59,115,
4357,1012,55,54,109,
4358,992,71,57,128,
4359,1017,57,76,133,
4360,1109,81,53,134,
4361,994,62,55,117,
4362,976,76,59,135,
4363,1017,63,54,117,
4364,1026,74,60,134,
4365,1040,76,50,126,
4366,988,79,63,142,
4367,1009,81,55,136,
4368,1028,85,61,146,
4369,1008,71,54,125,
4370,1047,60,46,106,
4371,975,71,60,131,
4372,1006,70,64,134,
4373,1022,75,55,130,
4374,1055,92,58,150,
4375,1004,78,52,130,
4376,1038,79,65,144,
4377,1042,65,59,124,
4378,1008,95,53,148,
4379,1051,76,58,134,
4380,1081,80,51,131,
4381,1052,81,70,151,
4382,1003,61,60,121,
4383,1046,71,57,128,
4384,980,66,46,112,
4385,990,75,62,137,
4386,1019,77,49,126,
4387,988,65,54,119,
4388,978,66,54,120,
4389,1057,65,65,130,
4390,1019,70,48,118,
4391,1042,70,66,136,
4392,989,71,58,129,
4393,988,67,57,124,
4394,1041,80,48,128,
4395,1034,84,44,128,
4396,997,69,43,112,
4397,1043,82,58,140,
4398,998,74,77,151,
4399,998,89,47,136,
4400,1063,72,57,129,
4401,1072,69,57,126,
4402,991,72,46,118,
4403,1067,74,53,127,
4404,1078,88,53,141,
4405,993,66,69,135,
4406,1006,81,66,147,
4407,992,79,57,136,
4408,968,68,66,134,
4409,1071,79,56,135,
4410,998,61,56,117,
4411,1029,79,47,126,
4412,977,78,52,130,
4413,1007,70,50,120,
4414,956,68,56,124,
4415,994,75,52,127,
4416,1026,60,60,120,
4417,1028,72,63,135,
4418,979,71,51,122,
4419,997,53,51,104,
4420,998,64,59,123,
4421,971,79,60,139,
4422,1036,86,54,140,
4423,1023,68,68,136,
4424,959,75,45,120,
4425,1018,80,55,135,
4426,1057,51,61,112,
4427,987,79,60,139,
4428,1009,76,69,145,
4429,979,82,60,142,
4430,997,83,61,144,
4431,1051,83,52,135,
4432,1019,65,63,128,
4433,983,88,61,149,
4434,1043,80,72,152,
4435,954,78,61,139,
4436,993,83,53,136,
4437,970,82,46,128,
4438,1056,82,61,143,
4439,1019,81,41,122,
4440,954,81,44,125,
4441,1012,83,52,135,
4442,1077,63,52,115,
4443,971,76,65,141,
4444,965,66,50,116,
4445,1068,77,50,127,
4446,1068,85,60,145,
4447,1043,82,43,125,
4448,1056,69,71,140,
4449,1034,69,71,140,
4450,980,72,64,136,
4451,978,64,61,125,
4452,1072,78,61,139,
4453,1023,63,77,140,
4454,1019,60,69,129,
4455,1034,69,69,138,
4456,970,79,48,127,
4457,1022,90,59,149,
4458,984,63,58,121,
4459,994,83,63,146,
4460,1039,77,56,133,
4461,993,60,66,126,
4462,982,58,53,111,
4463,976,67,56,123,
4464,1012,62,56,118,
4465,1005,72,52,124,
4466,1051,64,35,99,
4467,955,75,45,120,
4468,1004,68,53,121,
4469,1039,89,51,140,
4470,1045,91,57,148,
4471,996,75,62,137,
4472,1048,81,54,135,
4473,990,70,63,133,
4474,1024,80,53,133,
4475,975,90,51,141,
4476,987,73,55,128,
4477,1008,71,48,119,
4478,1003,84,50,134,
4479,977,84,53,137,
4480,1068,75,56,131,
4481,1009,76,48,124,
4482,996,61,57,118,
4483,983,73,70,143,
4484,998,82,57,139,
4485,1074,88,53,141,
4486,1003,62,54,116,
4487,981,82,62,144,
4488,997,82,70,152,
4489,1007,79,51,130,
4490,1018,74,62,136,
4491,1013,68,63,131,
4492,1024,69,63,132,
4493,992,74,63,137,
4494,1062,70,57,127,
4495,1058,81,67,148,
4496,1059,73,55,128,
4497,1038,71,68,139,
4498,1058,81,64,145,
4499,1007,69,61,130,
4500,986,73,53,126,
4501,1032,73,54,127,
4502,1035,83,64,147,
4503,981,81,55,136,
4504,1061,84,49,133,
4505,946,74,54,128,
4506,934,79,50,129,
4507,1009,72,56,128,
4508,1005,64,55,119,
4509,1014,53,51,104,
4510,997,74,61,135,
4511,1045,74,77,151,
4512,961,67,54,121,
4513,1013,80,59,139,
4514,1020,69,58,127,
4515,1030,65,62,127,
4516,982,79,51,130,
4517,993,75,65,140,
4518,1008,81,53,134,
4519,1088,84,64,148,
4520,986,74,58,132,
4521,995,64,67,131,
4522,1050,71,63,134,
4523,1059,72,59,131,
4524,1053,65,70,135,
4525,1024,82,63,145,
4526,985,70,56,126,
4527,1013,83,47,130,
4528,1013,72,67,139,
4529,987,62,52,114,
4530,1016,86,53,139,
4531,1047,68,64,132,
4532,1037,76,58,134,
4533,933,63,39,102,
4534,1030,68,57,125,
4535,1056,80,53,133,
4536,1074,76,54,130,
4537,1072,81,49,130,
4538,996,75,56,131,
4539,1018,75,62,137,
4540,1019,61,70,131,
4541,1023,70,56,126,
4542,1017,67,50,117,
4543,1011,78,51,129,
4544,1004,65,45,110,
4545,1008,79,65,144,
4546,1065,90,57,147,
4547,1007,60,47,107,
4548,974,79,52,131,
4549,1021,70,57,127,
4550,990,82,64,146,
4551,957,65,52,117,
4552,1086,93,66,159,
4553,1020,61,77,138,
4554,997,68,55,123,
4555,988,66,52,118,
4556,1029,81,60,141,
4557,1045,63,62,125,
4558,1042,68,49,117,
4559,994,69,60,129,
4560,1010,89,57,146,
4561,989,82,49,131,
4562,1058,75,60,135,
4563,1009,67,63,130,
4564,990,60,60,120,
4565,975,61,62,123,
4566,995,77,55,132,
4567,1017,61,58,119,
4568,982,65,50,115,
4569,1032,86,56,142,
4570,1040,77,65,142,
4571,1052,67,78,145,
4572,1051,77,61,138,
4573,985,80,58,138,
4574,964,76,49,125,
4575,1006,77,61,138,
4576,1035,80,68,148,
4577,1010,80,41,121,
4578,987,79,53,132,
4579,1059,58,66,124,
4580,1006,54,55,109,
4581,1021,69,58,127,
4582,1029,64,61,125,
4583,1054,81,64,145,
4584,1040,77,67,144,
4585,992,63,56,119,
4586,991,61,51,112,
4587,1065,83,56,139,
4588,1016,71,69,140,
4589,1084,67,64,131,
4590,1028,73,61,134,
4591,1029,74,67,141,
4592,968,66,45,111,
4593,1009,68,73,141,
4594,1062,69,68,137,
4595,1034,76,47,123,
4596,1015,66,50,116,
4597,1016,57,62,119,
4598,972,58,49,107,
4599,1028,67,64,131,
4600,998,76,72,148,
4601,1009,69,63,132,
4602,994,62,55,117,
4603,1080,75,70,145,
4604,1006,61,58,119,
4605,951,63,49,112,
4606,1076,81,64,145,
4607,1037,65,55,120,
4608,1039,66,50,116,
4609,1014,76,66,142,
4610,1004,80,58,138,
4611,1033,75,54,129,
4612,1002,71,59,130,
4613,1033,75,75,150,
4614,1039,86,51,137,
4615,1041,67,60,127,
4616,1037,91,53,144,
4617,1000,66,56,122,
4618,1005,66,53,119,
4619,1018,70,62,132,
4620,1020,105,66,171,
4621,1035,78,63,141,
4622,1017,69,50,119,
4623,962,64,61,125,
4624,1047,69,69,138,
4625,962,70,58,128,
4626,1018,66,53,119,
4627,1024,76,72,148,
4628,1040,89,44,133,
4629,986,72,50,122,
4630,996,77,57,134,
4631,1039,76,57,133,
4632,1033,77,57,134,
4633,1043,75,68,143,
4634,1016,75,59,134,
4635,1031,73,59,132,
4636,1014,71,43,114,
4637,1034,62,56,118,
4638,1057,76,62,138,
4639,1031,79,66,145,
4640,1025,68,57,125,
4641,1073,69,60,129,
4642,1035,88,62,150,
4643,1043,85,66,151,
4644,1005,57,75,132,
4645,1032,75,60,135,
4646,1034,88,60,148,
4647,982,73,55,128,
4648,1005,68,65,133,
4649,1016,79,45,124,
4650,1045,75,76,151,
4651,1036,73,52,125,
4652,1089,69,68,137,
4653,1000,61,55,116,
4654,1069,88,61,149,
4655,965,90,65,155,
4656,1015,85,62,147,
4657,1089,91,67,158,
4658,1029,69,54,123,
4659,1016,59,65,124,
4660,937,51,54,105,
4661,1010,68,64,132,
4662,982,87,54,141,
4663,1077,90,65,155,
4664,1033,68,60,128,
4665,1020,74,52,126,
4666,1023,74,58,132,
4667,986,73,52,125,
4668,1006,77,78,155,
4669,1083,68,53,121,
4670,1025,73,64,137,
4671,1009,67,61,128,
4672,1085,75,62,137,
4673,1106,87,59,146,
4674,1072,86,77,163,
4675,1003,61,54,115,
4676,1019,60,64,124,
4677,993,78,73,151,
4678,969,68,51,119,
4679,1045,81,54,135,
4680,1000,67,72,139,
4681,1069,67,67,134,
4682,1039,82,56,138,
4683,1043,83,60,143,
4684,1025,69,56,125,
4685,1009,68,47,115,
4686,1006,67,45,112,
4687,1037,95,60,155,
4688,1001,82,61,143,
4689,973,77,38,115,
4690,1144,85,67,152,
4691,1053,82,67,149,
4692,1028,72,73,145,
4693,1029,75,68,143,
4694,1007,80,56,136,
4695,924,72,59,131,
4696,1014,73,63,136,
4697,976,84,46,130,
4698,960,76,59,135,
4699,1040,66,66,132,
4700,1074,58,57,115,
4701,978,69,53,122,
4702,995,67,56,123,
4703,1007,73,63,136,
4704,1047,85,54,139,
4705,991,68,65,133,
4706,1107,78,70,148,
4707,968,67,52,119,
4708,1013,71,58,129,
4709,1007,88,71,159,
4710,1015,78,56,134,
4711,1042,72,70,142,
4712,926,62,61,123,
4713,1021,73,50,123,
4714,1055,98,72,170,
4715,996,80,59,139,
4716,1010,83,52,135,
4717,1019,61,72,133,
4718,1034,86,55,141,
4719,993,74,58,132,
4720,991,82,62,144,
4721,1037,63,61,124,
4722,1037,75,56,131,
4723,1006,93,39,132,
4724,1002,75,62,137,
4725,952,69,60,129,
4726,1078,73,55,128,
4727,984,88,55,143,
4728,1007,74,61,135,
4729,1019,80,68,148,
4730,996,73,64,137,
4731,1057,66,62,128,
4732,972,71,64,135,
4733,1025,73,65,138,
4734,1028,69,69,138,
4735,1022,73,62,135,
4736,1007,70,63,133,
4737,1026,68,61,129,
4738,1059,71,64,135,
4739,1063,72,62,134,
4740,1001,73,57,130,
4741,992,72,62,134,
4742,1000,79,55,134,
4743,1009,90,48,138,
4744,998,81,48,129,
4745,1024,77,68,145,
4746,1042,82,53,135,
4747,966,67,49,116,
4748,1032,77,53,130,
4749,1038,75,55,130,
4750,1051,78,65,143,
4751,962,82,70,152,
4752,1009,98,60,158,
4753,1040,62,63,125,
4754,991,82,61,143,
4755,947,62,49,111,
4756,1006,85,48,133,
4757,1024,64,56,120,
4758,1075,69,61,130,
4759,1022,73,69,142,
4760,1009,80,57,137,
4761,1006,80,66,146,
4762,1022,60,55,115,
4763,1000,73,71,144,
4764,997,87,48,135,
4765,1022,76,61,137,
4766,987,87,57,144,
4767,995,66,65,131,
4768,1063,79,64,143,
4769,997,65,52,117,
4770,958,71,59,130,
4771,1017,82,52,134,
4772,1035,71,63,134,
4773,1043,79,53,132,
4774,1002,85,45,130,
4775,1073,90,66,156,
4776,1036,73,54,127,
4777,1043,68,54,122,
4778,985,64,52,116,
4779,1036,84,59,143,
4780,1024,80,58,138,
4781,1043,66,57,123,
4782,1017,67,60,127,
4783,1006,69,76,145,
4784,981,60,57,117,
4785,972,65,65,130,
4786,1008,67,63,130,
4787,1020,75,67,142,
4788,1027,87,63,150,
4789,978,92,48,140,
4790,1027,80,61,141,
4791,961,69,60,129,
4792,976,83,54,137,
4793,1049,77,54,131,
4794,1027,80,57,137,
4795,1066,75,55,130,
4796,1015,67,72,139,
4797,977,83,63,146,
4798,1006,72,57,129,
4799,1022,78,51,129,
4800,1017,77,59,136,
4801,1019,82,59,141,
4802,1014,63,71,134,
4803,958,68,65,133,
4804,1056,91,61,152,
4805,1026,73,57,130,
4806,1009,68,70,138,
4807,1011,83,61,144,
4808,1008,74,65,139,
4809,1020,89,51,140,
4810,993,61,59,120,
4811,996,62,72,134,
4812,1033,79,55,134,
4813,1051,88,66,154,
4814,1001,92,56,148,
4815,1050,88,57,145,
4816,969,75,45,120,
4817,1061,82,63,145,
4818,1013,88,56,144,
4819,1036,69,61,130,
4820,984,74,42,116,
4821,1069,64,68,132,
4822,1065,85,56,141,
4823,973,68,50,118,
4824,983,72,53,125,
4825,1015,94,53,147,
4826,1028,67,54,121,
4827,981,81,53,134,
4828,1087,80,58,138,
4829,1078,75,59,134,
4830,1051,82,58,140,
4831,1072,71,60,131,
4832,1025,91,58,149,
4833,1005,70,54,124,
4834,1000,72,56,128,
4835,992,78,48,126,
4836,1026,62,66,128,
4837,994,76,70,146,
4838,1062,84,56,140,
4839,1005,69,60,129,
4840,1003,66,56,122,
4841,990,71,52,123,
4842,1048,83,56,139,
4843,1049,86,62,148,
4844,1058,64,55,119,
4845,1013,75,54,129,
4846,1058,68,56,124,
4847,1020,69,71,140,
4848,931,62,51,113,
4849,1041,79,55,134,
4850,1050,77,67,144,
4851,1007,72,49,121,
4852,979,77,67,144,
4853,1038,75,65,140,
4854,1042,85,44,129,
4855,921,71,63,134,
4856,1002,73,57,130,
4857,1036,73,62,135,
4858,991,83,51,134,
4859,999,84,65,149,
4860,1019,75,53,128,
4861,977,91,56,147,
4862,977,77,49,126,
4863,990,61,54,115,
4864,976,61,54,115,
4865,1020,67,55,122,
4866,1049,67,64,131,
4867,994,60,56,116,
4868,981,69,58,127,
4869,1028,63,51,114,
4870,1015,75,53,128,
4871,1003,75,39,114,
4872,973,79,54,133,
4873,1024,71,65,136,
4874,992,62,54,116,
4875,1013,68,61,129,
4876,960,76,62,138,
4877,1006,63,53,116,
4878,1018,81,57,138,
4879,1055,95,50,145,
4880,1028,67,63,130,
4881,1022,78,61,139,
4882,1030,65,72,137,
4883,1037,77,46,123,
4884,1023,78,50,128,
4885,1028,76,55,131,
4886,1059,75,55,130,
4887,1015,65,66,131,
4888,1041,76,71,147,
4889,1029,69,71,140,
4890,938,68,56,124,
4891,970,57,53,110,
4892,974,80,45,125,
4893,1073,74,56,130,
4894,1052,66,60,126,
4895,1023,81,49,130,
4896,962,73,62,135,
4897,1023,72,62,134,
4898,1061,87,70,157,
4899,950,85,47,132,
4900,1018,82,59,141,
4901,959,62,47,109,
4902,981,71,46,117,
4903,1012,83,68,151,
4904,1029,74,60,134,
4905,1043,91,58,149,
4906,1003,73,58,131,
4907,1020,71,58,129,
4908,991,81,47,128,
4909,1004,80,51,131,
4910,1065,93,54,147,
4911,983,89,49,138,
4912,999,68,60,128,
4913,1038,57,63,120,
4914,1026,76,55,131,
4915,1019,70,59,129,
4916,1051,76,61,137,
4917,1008,67,58,125,
4918,1001,77,65,142,
4919,986,75,68,143,
4920,1013,68,64,132,
4921,989,65,52,117,
4922,1004,76,50,126,
4923,1041,63,54,117,
4924,1025,98,66,164,
4925,996,79,49,128,
4926,984,84,53,137,
4927,1023,61,58,119,
4928,984,65,54,119,
4929,1002,79,49,128,
4930,1035,81,57,138,
4931,1045,78,64,142,
4932,1062,82,52,134,
4933,1056,86,47,133,
4934,1011,69,55,124,
4935,983,73,46,119,
4936,1009,76,52,128,
4937,1018,77,54,131,
4938,1024,89,64,153,
4939,953,60,76,136,
4940,963,75,58,133,
4941,997,64,72,136,
4942,1019,61,44,105,
4943,971,63,49,112,
4944,990,47,52,99,
4945,969,64,50,114,
4946,1060,76,60,136,
4947,1026,80,62,142,
4948,997,69,69,138,
4949,1019,84,65,149,
4950,966,63,66,129,
4951,1017,72,48,120,
4952,1004,80,60,140,
4953,1008,67,63,130,
4954,1031,83,61,144,
4955,1046,77,59,136,
4956,986,86,58,144,
4957,1052,99,52,151,
4958,1042,76,51,127,
4959,1022,71,54,125,
4960,1025,78,63,141,
4961,1028,82,64,146,
4962,1003,72,57,129,
4963,1058,69,59,128,
4964,1029,69,68,137,
4965,991,89,56,145,
4966,1049,74,67,141,
4967,956,72,47,119,
4968,990,72,56,128,
4969,1056,90,63,153,
4970,1010,77,57,134,
4971,1018,91,60,151,
4972,1037,79,45,124,
4973,1012,71,59,130,
4974,1042,75,51,126,
4975,948,63,66,129,
4976,1027,76,53,129,
4977,1031,88,57,145,
4978,989,63,45,108,
4979,996,74,54,128,
4980,1029,69,69,138,
4981,999,69,55,124,
4982,994,80,68,148,
4983,1031,85,58,143,
4984,1074,92,56,148,
4985,1024,80,58,138,
4986,1054,93,53,146,
4987,1013,74,62,136,
4988,1039,78,48,126,
4989,988,68,56,124,
4990,1011,80,49,129,
4991,1064,89,63,152,
4992,1041,86,67,153,
4993,968,75,58,133,
4994,1073,64,68,132,
4995,986,75,56,131,
4996,1031,80,63,143,
4997,1093,85,49,134,
4998,1010,81,62,143,
4999,1015,58,61,119,
5000,1013,87,62,149,
5001,1024,76,53,129,
5002,1014,64,56,120,
5003,1017,80,59,139,
5004,1039,72,48,120,
5005,1033,63,66,129,
5006,1041,73,59,132,
5007,1032,74,46,120,
5008,1066,80,59,139,
5009,1049,92,48,140,
5010,1021,68,46,114,
5011,1049,76,60,136,
5012,1058,92,67,159,
5013,1044,61,72,133,
5014,986,90,54,144,
5015,994,76,66,142,
5016,1049,67,56,123,
5017,1015,69,50,119,
5018,1021,72,51,123,
5019,1021,83,56,139,
5020,963,84,50,134,
5021,988,69,56,125,
5022,969,63,67,130,
5023,1001,72,52,124,
5024,997,74,53,127,
5025,1061,84,49,133,
5026,1074,91,63,154,
5027,1006,77,55,132,
5028,1052,77,56,133,
5029,1024,80,69,149,
5030,1031,78,65,143,
5031,1032,73,57,130,
5032,1037,75,53,128,
5033,981,71,48,119,
5034,987,64,61,125,
5035,952,63,69,132,
5036,1068,70,70,140,
5037,983,74,53,127,
5038,1018,68,68,136,
5039,1021,75,58,133,
5040,1035,66,72,138,
5041,1020,69,66,135,
5042,987,70,46,116,
5043,1045,69,65,134,
5044,1049,64,55,119,
5045,1032,78,56,134,
5046,1034,70,58,128,
5047,1011,59,48,107,
5048,1003,58,65,123,
5049,1054,86,53,139,
5050,1039,86,65,151,
5051,1027,81,58,139,
5052,1025,95,65,160,
5053,992,65,49,114,
5054,1014,71,61,132,
5055,1041,75,65,140,
5056,1003,70,53,123,
5057,1060,61,62,123,
5058,1030,71,59,130,
5059,1069,88,57,145,
5060,1013,90,55,145,
5061,1009,93,62,155,
5062,1042,65,57,122,
5063,1013,76,58,134,
5064,996,83,58,141,
5065,994,68,62,130,
5066,1002,78,59,137,
5067,1009,64,52,116,
5068,1006,59,45,104,
5069,970,79,57,136,
5070,1037,72,62,134,
5071,1069,78,53,131,
5072,1044,60,67,127,
5073,1015,85,47,132,
5074,969,78,63,141,
5075,1016,60,48,108,
5076,1011,79,58,137,
5077,995,68,68,136,
5078,980,71,50,121,
5079,1053,78,54,132,
5080,1000,62,61,123,
5081,1029,75,58,133,
5082,997,77,55,132,
5083,994,83,48,131,
5084,1016,68,58,126,
5085,1023,77,65,142,
5086,1023,60,60,120,
5087,1009,54,57,111,
5088,1070,86,50,136,
5089,998,68,70,138,
5090,991,77,63,140,
5091,1027,67,51,118,
5092,990,66,64,130,
5093,1042,80,62,142,
5094,1001,90,44,134,
5095,985,67,55,122,
5096,1020,60,52,112,
5097,954,60,53,113,
5098,1045,81,67,148,
5099,1030,80,49,129,
5100,1018,72,40,112,
5101,1042,82,53,135,
5102,1011,84,52,136,
5103,1098,86,60,146,
5104,1055,67,61,128,
5105,1081,73,56,129,
5106,982,60,51,111,
5107,1049,73,53,126,
5108,985,70,61,131,
5109,1073,73,53,126,
5110,948,83,43,126,
5111,1003,75,53,128,
5112,994,89,52,141,
5113,1020,66,61,127,
5114,1026,66,53,119,
5115,1111,80,55,135,
5116,965,76,56,132,
5117,1067,77,70,147,
5118,1025,82,60,142,
5119,983,71,60,131,
5120,988,71,60,131,
5121,1057,68,61,129,
5122,1052,71,68,139,
5123,1006,71,55,126,
5124,1043,74,55,129,
5125,1017,64,52,116,
5126,981,72,50,122,
5127,1044,78,60,138,
5128,1011,74,68,142,
5129,1036,70,48,118,
5130,1016,83,53,136,
5131,1012,76,63,139,
5132,990,58,52,110,
5133,1018,66,65,131,
5134,970,73,57,130,
5135,1049,70,60,130,
5136,1034,85,55,140,
5137,1080,85,71,156,
5138,986,81,56,137,
5139,975,58,48,106,
5140,1049,76,70,146,
5141,1026,77,59,136,
5142,1052,79,59,138,
5143,1015,80,63,143,
5144,985,73,57,130,
5145,1053,70,59,129,
5146,1032,84,58,142,
5147,1040,71,71,142,
5148,1038,90,61,151,
5149,1017,79,73,152,
5150,1065,79,59,138,
5151,1025,72,68,140,
5152,972,60,67,127,
5153,1030,72,52,124,
5154,990,74,58,132,
5155,994,73,45,118,
5156,1050,82,50,132,
5157,971,62,52,114,
5158,999,77,53,130,
5159,987,72,64,136,
5160,1015,79,68,147,
5161,1009,66,43,109,
5162,1018,81,56,137,
5163,1031,87,49,136,
5164,1013,59,62,121,
5165,1011,81,55,136,
5166,1017,88,48,136,
5167,1019,80,64,144,
5168,1021,88,62,150,
5169,1005,71,59,130,
5170,1010,83,64,147,
5171,1035,68,38,106,
5172,1041,77,50,127,
5173,1004,78,59,137,
5174,1067,73,57,130,
5175,991,72,37,109,
5176,986,72,54,126,
5177,1029,65,62,127,
5178,1059,80,79,159,
5179,982,80,52,132,
5180,1012,55,54,109,
5181,1000,77,58,135,
5182,978,70,51,121,
5183,1031,62,61,123,
5184,1020,63,53,116,
5185,1028,92,66,158,
5186,1102,84,66,150,
5187,1013,77,52,129,
5188,976,73,61,134,
5189,973,68,48,116,
5190,1091,93,57,150,
5191,1036,88,59,147,
5192,989,80,60,140,
5193,1030,85,48,133,
5194,1080,75,57,132,
5195,973,76,57,133,
5196,1038,80,61,141,
5197,1024,85,49,134,
5198,1001,83,57,140,
5199,1000,68,44,112,
5200,958,75,50,125,
5201,1019,77,56,133,
5202,985,68,48,116,
5203,1009,86,44,130,
5204,976,71,59,130,
5205,1036,93,67,160,
5206,995,68,59,127,
5207,1059,88,63,151,
5208,1006,64,76,140,
5209,1059,80,66,146,
5210,965,68,58,126,
5211,1027,73,62,135,
5212,948,83,52,135,
5213,1042,70,63,133,
5214,1020,65,66,131,
5215,1010,71,76,147,
5216,1030,75,54,129,
5217,1049,63,59,122,
5218,997,70,57,127,
5219,1058,72,60,132,
5220,1038,80,68,148,
5221,986,79,44,123,
5222,1006,83,53,136,
5223,981,71,59,130,
5224,1002,70,61,131,
5225,1036,77,66,143,
5226,1055,79,57,136,
5227,1010,73,61,134,
5228,1018,79,62,141,
5229,990,65,62,127,
5230,1010,63,64,127,
5231,1009,77,47,124,
5232,1046,77,50,127,
5233,1005,56,54,110,
5234,1028,84,74,158,
5235,1064,83,58,141,
5236,985,72,52,124,
5237,1015,85,64,149,
5238,1055,81,50,131,
5239,990,86,59,145,
5240,1027,54,62,116,
5241,1010,70,54,124,
5242,1008,81,50,131,
5243,978,66,60,126,
5244,1010,60,49,109,
5245,1052,67,52,119,
5246,1036,76,59,135,
5247,1024,74,51,125,
5248,983,64,62,126,
5249,1013,83,51,134,
5250,1013,88,54,142,
5251,1037,95,53,148,
5252,1065,77,56,133,
5253,966,85,56,141,
5254,1074,80,65,145,
5255,997,65,48,113,
5256,1060,69,54,123,
5257,999,87,59,146,
5258,1002,89,53,142,
5259,998,76,49,125,
5260,1019,79,63,142,
5261,1019,75,56,131,
5262,1036,87,49,136,
5263,1066,72,56,128,
5264,1022,80,61,141,
5265,988,77,65,142,
5266,995,66,65,131,
5267,985,74,48,122,
5268,1019,73,60,133,
5269,1043,89,61,150,
5270,933,78,63,141,
5271,1034,78,53,131,
5272,996,76,46,122,
5273,1002,67,57,124,
5274,1029,77,53,130,
5275,1021,75,59,134,
5276,993,81,56,137,
5277,974,63,47,110,
5278,1035,58,65,123,
5279,1015,73,59,132,
5280,999,86,44,130,
5281,973,81,57,138,
5282,1059,61,73,134,
5283,1026,66,60,126,
5284,987,72,58,130,
5285,1050,66,56,122,
5286,1030,72,74,146,
5287,1014,77,43,120,
5288,1012,70,59,129,
5289,992,76,61,137,
5290,1036,65,53,118,
5291,1033,68,51,119,
5292,1031,81,56,137,
5293,988,70,52,122,
5294,1006,78,62,140,
5295,1021,74,53,127,
5296,977,71,53,124,
5297,993,77,65,142,
5298,951,76,39,115,
5299,977,80,56,136,
5300,1001,84,50,134,
5301,979,67,69,136,
5302,938,67,48,115,
5303,1081,83,67,150,
5304,1071,78,68,146,
5305,1048,74,62,136,
5306,1025,73,59,132,
5307,1071,89,68,157,
5308,1062,65,68,133,
5309,1044,78,61,139,
5310,988,64,66,130,
5311,998,79,61,140,
5312,1000,77,63,140,
5313,1089,82,69,151,
5314,1003,79,50,129,
5315,1052,70,55,125,
5316,1025,77,57,134,
5317,1003,74,64,138,
5318,1043,71,61,132,
5319,1010,80,58,138,
5320,1016,69,63,132,
5321,988,72,54,126,
5322,1029,75,59,134,
5323,978,61,65,126,
5324,1047,82,51,133,
5325,957,73,51,124,
5326,1017,76,59,135,
5327,1025,66,56,122,
5328,1005,82,68,150,
5329,1077,90,67,157,
5330,944,76,50,126,
5331,1026,60,51,111,
5332,1001,81,64,145,
5333,1040,76,54,130,
5334,1004,71,59,130,
5335,1047,73,58,131,
5336,1039,84,53,137,
5337,1008,66,63,129,
5338,1019,84,64,148,
5339,1066,78,49,127,
5340,960,64,52,116,
5341,995,63,61,124,
5342,1003,72,57,129,
5343,1029,76,61,137,
5344,1060,77,55,132,
5345,1083,71,63,134,
5346,977,67,52,119,
5347,1076,79,53,132,
5348,1009,76,58,134,
5349,1012,73,62,135,
5350,1030,61,56,117,
5351,1061,72,53,125,
5352,987,73,46,119,
5353,1058,74,52,126,
5354,1001,74,50,124,
5355,1008,68,54,122,
5356,1006,77,57,134,
5357,1039,79,59,138,
5358,1039,84,53,137,
5359,993,75,63,138,
5360,1024,73,63,136,
5361,1044,81,75,156,
5362,1063,69,62,131,
5363,998,63,55,118,
5364,1042,79,54,133,
5365,1054,90,50,140,
5366,1053,74,53,127,
5367,1000,70,50,120,
5368,970,69,42,111,
5369,1060,88,61,149,
5370,1007,71,56,127,
5371,1025,81,53,134,
5372,947,63,50,113,
5373,1033,100,47,147,
5374,1062,93,47,140,
5375,1065,89,55,144,
5376,955,74,63,137,
5377,975,84,47,131,
5378,1042,73,77,150,
5379,1027,72,61,133,
5380,1029,81,67,148,
5381,1001,84,58,142,
5382,1051,75,61,136,
5383,1019,69,61,130,
5384,1016,75,50,125,
5385,1043,75,56,131,
5386,962,66,46,112,
5387,989,78,50,128,
5388,1028,82,68,150,
5389,1005,97,55,152,
5390,1023,75,55,130,
5391,1033,79,49,128,
5392,972,72,54,126,
5393,1003,71,65,136,
5394,955,78,48,126,
5395,1023,74,51,125,
5396,1033,57,70,127,
5397,1053,75,50,125,
5398,985,86,60,146,
5399,1027,73,62,135,
5400,976,78,67,145,
5401,1014,75,49,124,
5402,990,72,61,133,
5403,1055,93,67,160,
5404,1019,73,61,134,
5405,1010,81,56,137,
5406,1010,68,64,132,
5407,985,61,59,120,
5408,1065,84,55,139,
5409,999,87,59,146,
5410,986,67,54,121,
5411,1051,81,52,133,
5412,1051,82,56,138,
5413,1035,71,58,129,
5414,979,80,67,147,
5415,975,57,56,113,
5416,968,75,55,130,
5417,1012,73,71,144,
5418,1041,69,62,131,
5419,1071,76,62,138,
5420,995,76,60,136,
5421,989,77,52,129,
5422,977,81,62,143,
5423,1036,85,60,145,
5424,1021,68,52,120,
5425,1041,90,52,142,
5426,1090,71,66,137,
5427,1071,82,69,151,
5428,997,55,65,120,
5429,1007,75,60,135,
5430,1032,68,79,147,
5431,1023,77,55,132,
5432,1002,73,60,133,
5433,1036,70,74,144,
5434,1023,73,62,135,
5435,1009,61,47,108,
5436,1011,82,56,138,
5437,1026,78,55,133,
5438,1016,73,61,134,
5439,980,85,63,148,
5440,1005,86,55,141,
5441,991,67,49,116,
5442,998,72,46,118,
5443,1081,59,69,128,
5444,1053,73,50,123,
5445,1011,79,49,128,
5446,1036,80,73,153,
5447,1020,83,55,138,
5448,1046,80,63,143,
5449,1003,65,56,121,
5450,1009,77,62,139,
5451,1018,79,48,127,
5452,975,53,65,118,
5453,1051,80,58,138,
5454,1030,70,69,139,
5455,1046,80,53,133,
5456,1007,68,49,117,
5457,1037,73,59,132,
5458,1053,89,58,147,
5459,1001,66,59,125,
5460,995,75,61,136,
5461,1040,81,64,145,
5462,1018,83,54,137,
5463,1013,66,43,109,
5464,1017,59,53,112,
5465,984,60,62,122,
5466,1061,76,67,143,
5467,1102,79,60,139,
5468,1034,75,59,134,
5469,1016,77,76,153,
5470,1033,72,50,122,
5471,1058,80,51,131,
5472,1004,63,50,113,
5473,1014,83,65,148,
5474,1006,61,61,122,
5475,1022,64,67,131,
5476,1029,80,51,131,
5477,1000,82,59,141,
5478,983,56,46,102,
5479,1064,105,57,162,
5480,1043,72,65,137,
5481,1051,85,58,143,
5482,1021,85,49,134,
5483,1022,73,46,119,
5484,982,70,65,135,
5485,1001,69,56,125,
5486,1001,83,59,142,
5487,1034,78,55,133,
5488,1060,75,58,133,
5489,1037,83,76,159,
5490,1008,70,63,133,
5491,1027,70,61,131,
5492,1020,77,56,133,
5493,1001,60,56,116,
5494,968,73,42,115,
5495,964,84,68,152,
5496,1065,82,63,145,
5497,1062,76,70,146,
5498,1035,77,59,136,
5499,1042,71,72,143,
5500,1005,62,48,110,
5501,1029,77,57,134,
5502,988,68,50,118,
5503,1027,85,61,146,
5504,977,61,55,116,
5505,970,73,48,121,
5506,1057,75,75,150,
5507,992,82,63,145,
5508,1008,84,58,142,
5509,1059,80,64,144,
5510,1035,85,61,146,
5511,1000,95,57,152,
5512,1004,60,54,114,
5513,958,52,61,113,
5514,1102,78,68,146,
5515,984,70,45,115,
5516,1065,91,57,148,
5517,1007,80,57,137,
5518,994,73,44,117,
5519,1065,88,61,149,
5520,960,58,44,102,
5521,1058,81,70,151,
5522,1019,72,74,146,
5523,1010,69,63,132,
5524,1027,86,59,145,
5525,1028,80,52,132,
5526,1043,77,57,134,
5527,996,76,49,125,
5528,1039,67,69,136,
5529,998,89,49,138,
5530,1010,86,52,138,
5531,1028,69,56,125,
5532,987,62,62,124,
5533,1109,88,63,151,
5534,1037,73,59,132,
5535,1086,68,57,125,
5536,1072,63,58,121,
5537,1010,70,64,134,
5538,1091,59,59,118,
5539,1013,74,59,133,
5540,1022,77,55,132,
5541,1047,81,59,140,
5542,983,53,55,108,
5543,1049,75,70,145,
5544,1006,66,53,119,
5545,965,77,54,131,
5546,1099,88,60,148,
5547,1076,77,55,132,
5548,959,64,49,113,
5549,1000,75,64,139,
5550,1015,70,53,123,
5551,1028,59,72,131,
5552,1030,74,41,115,
5553,983,75,58,133,
5554,1043,79,55,134,
5555,963,76,49,125,
5556,998,82,59,141,
5557,1058,53,62,115,
5558,1078,66,52,118,
5559,1064,81,68,149,
5560,1021,72,52,124,
5561,989,70,63,133,
5562,1003,74,61,135,
5563,1094,97,66,163,
5564,1002,78,51,129,
5565,1035,86,57,143,
5566,970,68,64,132,
5567,1009,77,59,136,
5568,1035,68,56,124,
5569,1001,69,75,144,
5570,941,65,57,122,
5571,1033,65,69,134,
5572,972,82,44,126,
5573,1041,78,62,140,
5574,1057,79,68,147,
5575,1029,71,64,135,
5576,1018,78,66,144,
5577,1009,75,57,132,
5578,993,76,59,135,
5579,1057,79,61,140,
5580,960,82,50,132,
5581,1054,66,59,125,
5582,1044,75,64,139,
5583,947,58,40,98,
5584,1055,84,66,150,
5585,1004,72,65,137,
5586,1008,61,57,118,
5587,1007,74,51,125,
5588,980,79,67,146,
5589,1034,69,47,116,
5590,1036,84,58,142,
5591,1098,64,73,137,
5592,1065,72,57,129,
5593,1013,79,65,144,
5594,1040,71,70,141,
5595,975,69,62,131,
5596,1061,70,58,128,
5597,989,82,56,138,
5598,1043,68,60,128,
5599,1047,81,61,142,
5600,1005,64,46,110,
5601,1035,86,64,150,
5602,1014,74,53,127,
5603,990,80,57,137,
5604,958,81,42,123,
5605,1036,85,52,137,
5606,1029,62,46,108,
5607,1050,74,60,134,
5608,1113,86,77,163,
5609,998,79,54,133,
5610,989,72,73,145,
5611,1025,72,56,128,
5612,1036,79,70,149,
5613,955,58,38,96,
5614,1011,82,60,142,
5615,1022,89,40,129,
5616,1036,85,52,137,
5617,1016,59,61,120,
5618,952,81,57,138,
5619,1026,58,55,113,
5620,989,49,65,114,
5621,1031,67,68,135,
5622,1027,68,61,129,
5623,976,84,52,136,
5624,978,81,56,137,
5625,1003,69,55,124,
5626,1072,73,58,131,
5627,1034,63,66,129,
5628,1023,75,61,136,
5629,1033,82,53,135,
5630,1041,72,68,140,
5631,1009,81,53,134,
5632,919,66,56,122,
5633,969,72,62,134,
5634,1023,75,67,142,
5635,983,66,68,134,
5636,1007,73,48,121,
5637,991,71,65,136,
5638,1079,80,60,140,
5639,980,63,59,122,
5640,1061,84,42,126,
5641,1003,72,45,117,
5642,1025,72,56,128,
5643,1032,83,65,148,
5644,1007,58,48,106,
5645,1015,63,58,121,
5646,1033,98,62,160,
5647,1050,68,62,130,
5648,1048,75,54,129,
5649,974,81,63,144,
5650,988,71,63,134,
5651,1015,78,63,141,
5652,1058,71,65,136,
5653,1073,78,76,154,
5654,1012,69,64,133,
5655,1078,82,54,136,
5656,1001,70,53,123,
5657,1023,69,55,124,
5658,991,77,46,123,
5659,1035,72,62,134,
5660,1042,84,61,145,
5661,1070,80,66,146,
5662,999,82,59,141,
5663,1076,79,60,139,
5664,1048,76,51,127,
5665,1049,92,56,148,
5666,1077,87,57,144,
5667,1033,79,51,130,
5668,1043,75,67,142,
5669,1015,69,70,139,
5670,1004,69,60,129,
5671,972,64,69,133,
5672,968,71,54,125,
5673,1079,83,50,133,
5674,1007,77,58,135,
5675,1035,63,59,122,
5676,964,82,59,141,
5677,1001,67,50,117,
5678,1022,76,60,136,
5679,1036,67,53,120,
5680,1055,78,53,131,
5681,1066,78,75,153,
5682,1037,63,57,120,
5683,1001,73,67,140,
5684,984,63,56,119,
5685,1027,72,50,122,
5686,986,73,45,118,
5687,1015,71,75,146,
5688,1018,73,50,123,
5689,1059,96,65,161,
5690,1026,90,61,151,
5691,1010,88,61,149,
5692,995,65,58,123,
5693,1036,51,75,126,
5694,1035,80,43,123,
5695,1028,89,45,134,
5696,988,80,48,128,
5697,1004,77,62,139,
5698,1052,79,54,133,
5699,976,68,58,126,
5700,1017,62,55,117,
5701,1013,73,41,114,
5702,1000,66,55,121,
5703,1008,89,63,152,
5704,1025,70,63,133,
5705,989,74,50,124,
5706,979,65,57,122,
5707,996,71,64,135,
5708,992,60,63,123,
5709,1000,69,55,124,
5710,969,70,42,112,
5711,1015,68,62,130,
5712,1034,88,59,147,
5713,972,70,45,115,
5714,1028,76,76,152,
5715,996,85,49,134,
5716,993,75,53,128,
5717,993,49,65,114,
5718,998,62,56,118,
5719,954,60,54,114,
5720,1053,68,60,128,
5721,1014,79,59,138,
5722,1039,74,68,142,
5723,1065,69,75,144,
5724,1062,73,68,141,
5725,983,73,51,124,
5726,1011,84,47,131,
5727,993,68,55,123,
5728,1028,67,71,138,
5729,1037,82,71,153,
5730,1012,67,52,119,
5731,1023,71,66,137,
5732,1003,63,64,127,
5733,979,71,54,125,
5734,1004,69,57,126,
5735,980,79,52,131,
5736,1045,71,82,153,
5737,1002,75,68,143,
5738,1006,68,55,123,
5739,1015,80,49,129,
5740,956,64,50,114,
5741,1063,70,64,134,
5742,995,77,48,125,
5743,1018,73,58,131,
5744,1061,75,71,146,
5745,984,67,77,144,
5746,1054,69,48,117,
5747,951,63,59,122,
5748,1030,73,65,138,
5749,1021,91,66,157,
5750,1049,70,59,129,
5751,1044,55,64,119,
5752,1087,71,73,144,
5753,1025,66,49,115,
5754,991,71,53,124,
5755,987,79,57,136,
5756,975,71,53,124,
5757,1042,77,57,134,
5758,994,74,58,132,
5759,979,80,58,138,
5760,1035,68,51,119,
5761,1006,90,40,130,
5762,1025,77,53,130,
5763,1018,82,53,135,
5764,995,64,61,125,
5765,996,70,57,127,
5766,984,75,57,132,
5767,1033,83,59,142,
5768,1004,77,57,134,
5769,1056,86,50,136,
5770,972,83,57,140,
5771,1013,65,66,131,
5772,1032,77,51,128,
5773,1050,77,61,138,
5774,1036,71,62,133,
5775,1014,85,51,136,
5776,1003,79,49,128,
5777,1012,92,54,146,
5778,1007,74,51,125,
5779,1014,70,57,127,
5780,1010,58,62,120,
5781,1033,63,50,113,
5782,1044,95,40,135,
5783,991,57,59,116,
5784,995,75,46,121,
5785,1082,74,58,132,
5786,985,80,58,138,
5787,1040,62,61,123,
5788,1043,71,66,137,
5789,1026,85,42,127,
5790,1006,59,58,117,
5791,995,80,56,136,
5792,1024,80,47,127,
5793,1033,75,69,144,
5794,1049,75,59,134,
5795,969,65,65,130,
5796,1042,77,64,141,
5797,1038,86,46,132,
5798,1001,66,62,128,
5799,994,63,65,128,
5800,1088,79,55,134,
5801,996,73,56,129,
5802,984,55,65,120,
5803,947,67,57,124,
5804,977,66,70,136,
5805,1020,69,63,132,
5806,985,68,59,127,
5807,1011,85,61,146,
5808,995,84,47,131,
5809,1005,91,57,148,
5810,996,68,70,138,
5811,1016,67,59,126,
5812,988,76,63,139,
5813,1079,69,59,128,
5814,1000,80,51,131,
5815,1049,64,69,133,
5816,1005,71,50,121,
5817,1043,72,53,125,
5818,1008,77,51,128,
5819,968,87,41,128,
5820,981,77,62,139,
5821,956,62,52,114,
5822,1011,73,62,135,
5823,998,73,43,116,
5824,1020,65,51,116,
5825,977,72,71,143,
5826,1014,83,52,135,
5827,1027,67,51,118,
5828,1013,75,58,133,
5829,1073,85,60,145,
5830,1068,88,54,142,
5831,972,79,40,119,
5832,1011,63,38,101,
5833,1061,76,60,136,
5834,982,82,44,126,
5835,982,76,55,131,
5836,1033,64,62,126,
5837,1013,68,51,119,
5838,972,63,71,134,
5839,1012,69,51,120,
5840,1056,68,55,123,
5841,1026,82,60,142,
5842,1050,54,61,115,
5843,1007,69,46,115,
5844,1027,80,69,149,
5845,1010,64,55,119,
5846,1113,85,62,147,
5847,1045,73,60,133,
5848,1032,77,72,149,
5849,1010,77,60,137,
5850,1016,88,63,151,
5851,1006,75,58,133,
5852,1036,78,54,132,
5853,1034,72,67,139,
5854,1097,76,68,144,
5855,1020,74,54,128,
5856,1011,67,71,138,
5857,1025,77,57,134,
5858,1009,79,59,138,
5859,981,60,56,116,
5860,1005,71,60,131,
5861,1015,76,58,134,
5862,994,69,54,123,
5863,1014,88,52,140,
5864,1047,78,60,138,
5865,1010,73,54,127,
5866,990,70,58,128,
5867,1029,79,43,122,
5868,973,59,58,117,
5869,1025,86,59,145,
5870,1001,71,53,124,
5871,1092,87,56,143,
5872,1017,76,58,134,
5873,1040,67,43,110,
5874,1078,84,60,144,
5875,1033,77,52,129,
5876,1066,72,65,137,
5877,1053,82,62,144,
5878,978,87,50,137,
5879,1025,84,59,143,
5880,1068,71,54,125,
5881,1018,71,57,128,
5882,949,62,57,119,
5883,1057,83,45,128,
5884,986,63,64,127,
5885,1041,65,56,121,
5886,960,70,58,128,
5887,1012,80,60,140,
5888,1065,73,76,149,
5889,1012,76,64,140,
5890,976,80,35,115,
5891,1047,74,55,129,
5892,985,67,55,122,
5893,1022,86,65,151,
5894,1014,78,57,135,
5895,950,72,46,118,
5896,1004,58,65,123,
5897,1057,90,56,146,
5898,972,83,49,132,
5899,961,70,56,126,
5900,1065,70,77,147,
5901,1022,77,58,135,
5902,993,76,60,136,
5903,997,71,64,135,
5904,1037,73,57,130,
5905,1088,84,58,142,
5906,1005,78,55,133,
5907,1002,88,56,144,
5908,982,83,46,129,
5909,1027,76,58,134,
5910,1041,75,49,124,
5911,984,69,51,120,
5912,1036,85,66,151,
5913,1024,83,57,140,
5914,996,64,53,117,
5915,1000,49,48,97,
5916,1027,77,63,140,
5917,973,69,60,129,
5918,995,65,67,132,
5919,970,65,47,112,
5920,1072,71,81,152,
5921,1026,72,49,121,
5922,934,72,42,114,
5923,1086,71,59,130,
5924,1061,81,50,131,
5925,984,81,51,132,
5926,1077,73,49,122,
5927,1006,72,46,118,
5928,987,85,52,137,
5929,1000,70,59,129,
5930,982,64,52,116,
5931,981,65,58,123,
5932,1001,77,55,132,
5933,1007,67,58,125,
5934,1039,77,46,123,
5935,1048,81,52,133,
5936,1039,75,50,125,
5937,1057,79,60,139,
5938,990,65,58,123,
5939,1003,72,50,122,
5940,1018,78,66,144,
5941,1053,77,50,127,
5942,1020,92,54,146,
5943,1024,64,51,115,
5944,977,68,42,110,
5945,1000,78,53,131,
5946,1034,75,60,135,
5947,983,67,55,122,
5948,970,75,41,116,
5949,1019,68,55,123,
5950,1022,80,55,135,
5951,1080,61,75,136,
5952,1002,71,57,128,
5953,1039,67,60,127,
5954,970,72,47,119,
5955,1007,71,61,132,
5956,1043,64,60,124,
5957,1005,69,52,121,
5958,953,80,46,126,
5959,998,75,53,128,
5960,1047,83,71,154,
5961,945,70,61,131,
5962,1020,73,69,142,
5963,1012,66,55,121,
5964,974,65,64,129,
5965,995,74,56,130,
5966,1041,64,65,129,
5967,1021,75,57,132,
5968,1075,82,52,134,
5969,988,68,48,116,
5970,1017,67,54,121,
5971,1028,71,50,121,
5972,1051,85,58,143,
5973,994,69,49,118,
5974,1059,83,66,149,
5975,990,69,57,126,
5976,1061,73,61,134,
5977,1007,74,56,130,
5978,1104,80,51,131,
5979,1048,69,70,139,
5980,1022,85,56,141,
5981,1009,77,61,138,
5982,1027,72,67,139,
5983,1026,77,63,140,
5984,996,77,66,143,
5985,1002,60,56,116,
5986,1088,79,70,149,
5987,1061,83,69,152,
5988,1034,78,57,135,
5989,1058,83,58,141,
5990,1079,88,71,159,
5991,994,76,56,132,
5992,1052,72,63,135,
5993,1005,66,51,117,
5994,969,71,68,139,
5995,1047,83,62,145,
5996,1017,71,44,115,
5997,1000,83,60,143,
5998,1006,66,55,121,
5999,1052,79,65,144,
6000,1039,83,54,137,
6001,1053,88,59,147,
6002,1020,56,56,112,
6003,1019,75,48,123,
6004,1061,71,62,133,
6005,1004,77,59,136,
6006,1033,82,54,136,
6007,1010,77,60,137,
6008,961,79,51,130,
6009,1015,68,56,124,
6010,1034,81,65,146,
6011,1055,64,65,129,
6012,1062,76,66,142,
6013,1026,70,57,127,
6014,1009,73,59,132,
6015,986,70,54,124,
6016,1053,84,72,156,
6017,1019,65,53,118,
6018,981,66,65,131,
6019,1041,79,57,136,
6020,1013,62,55,117,
6021,1023,85,60,145,
6022,1112,68,60,128,
6023,1043,81,63,144,
6024,1080,95,67,162,
6025,1054,76,55,131,
6026,1027,74,62,136,
6027,1027,74,54,128,
6028,982,59,54,113,
6029,1085,81,70,151,
6030,1046,77,43,120,
6031,973,65,59,124,
6032,1042,64,66,130,
6033,1000,75,64,139,
6034,986,69,49,118,
6035,993,81,58,139,
6036,1052,78,64,142,
6037,1021,90,63,153,
6038,1036,64,67,131,
6039,1060,68,61,129,
6040,1030,67,60,127,
6041,1014,72,45,117,
6042,1023,83,63,146,
6043,1050,80,54,134,
6044,1061,73,59,132,
6045,1042,73,64,137,
6046,959,67,41,108,
6047,1053,73,57,130,
6048,1017,79,46,125,
6049,974,83,55,138,
6050,1008,82,57,139,
6051,1046,92,55,147,
6052,1073,76,57,133,
6053,996,68,50,118,
6054,1008,66,54,120,
6055,1064,69,63,132,
6056,1036,77,60,137,
6057,1008,86,59,145,
6058,1023,77,50,127,
6059,1075,75,59,134,
6060,1051,78,59,137,
6061,1006,69,48,117,
6062,1036,63,67,130,
6063,951,65,63,128,
6064,1011,68,56,124,
6065,978,68,56,124,
6066,997,80,56,136,
6067,1053,66,62,128,
6068,1013,68,56,124,
6069,983,74,62,136,
6070,1009,72,61,133,
6071,1061,71,70,141,
6072,1054,70,63,133,
6073,977,62,65,127,
6074,1020,65,52,117,
6075,1026,69,62,131,
6076,974,76,56,132,
6077,1000,75,61,136,
6078,1023,82,64,146,
6079,998,71,75,146,
6080,986,76,55,131,
6081,1015,85,58,143,
6082,1048,68,73,141,
6083,1037,74,71,145,
6084,1025,72,63,135,
6085,997,70,51,121,
6086,1079,84,56,140,
6087,958,75,50,125,
6088,1041,85,55,140,
6089,1055,80,62,142,
6090,1013,85,70,155,
6091,1020,75,73,148,
6092,979,85,63,148,
6093,1062,88,54,142,
6094,972,56,57,113,
6095,989,69,62,131,
6096,999,67,59,126,
6097,964,74,48,122,
6098,980,61,71,132,
6099,1054,82,70,152,
6100,1062,82,58,140,
6101,1006,68,68,136,
6102,1008,78,58,136,
6103,1024,82,58,140,
6104,1026,74,54,128,
6105,1081,72,53,125,
6106,1036,81,60,141,
6107,974,63,48,111,
6108,1038,79,57,136,
6109,977,75,49,124,
6110,961,79,44,123,
6111,996,62,47,109,
6112,974,70,56,126,
6113,1071,77,76,153,
6114,1020,80,55,135,
6115,1061,58,79,137,
6116,1086,68,55,123,
6117,1074,81,51,132,
6118,994,73,72,145,
6119,972,75,66,141,
6120,1006,61,64,125,
6121,1043,66,45,111,
6122,1136,79,58,137,
6123,1013,89,60,149,
6124,1040,56,53,109,
6125,977,68,55,123,
6126,1063,71,56,127,
6127,1004,88,57,145,
6128,1034,67,65,132,
6129,1031,76,64,140,
6130,982,77,64,141,
6131,1005,61,54,115,
6132,1033,72,58,130,
6133,1027,67,59,126,
6134,1001,63,60,123,
6135,1045,90,56,146,
6136,1039,67,65,132,
6137,962,61,58,119,
6138,1014,75,47,122,
6139,1004,82,57,139,
6140,958,68,57,125,
6141,1066,70,61,131,
6142,1024,80,50,130,
6143,1057,67,69,136,
6144,1002,84,57,141,
6145,1000,59,59,118,
6146,995,68,44,112,
6147,1016,72,74,146,
6148,1038,71,55,126,
6149,1036,74,56,130,
6150,964,62,65,127,
6151,1030,74,59,133,
6152,957,65,45,110,
6153,1009,77,63,140,
6154,983,56,59,115,
6155,999,82,46,128,
6156,1071,88,51,139,
6157,1023,87,58,145,
6158,997,76,47,123,
6159,1015,88,50,138,
6160,1075,64,67,131,
6161,989,75,48,123,
6162,1028,61,56,117,
6163,1024,73,63,136,
6164,1003,72,64,136,
6165,1006,69,52,121,
6166,1007,76,45,121,
6167,989,78,58,136,
6168,1059,67,70,137,
6169,1030,79,47,126,
6170,945,67,51,118,
6171,1100,84,72,156,
6172,1009,74,65,139,
6173,1055,69,77,146,
6174,1036,80,67,147,
6175,1011,62,65,127,
6176,1051,85,71,156,
6177,1000,67,50,117,
6178,1046,86,58,144,
6179,1017,81,65,146,
6180,1013,59,53,112,
6181,1012,83,51,134,
6182,1029,78,57,135,
6183,1007,85,53,138,
6184,1033,72,53,125,
6185,1002,84,48,132,
6186,1006,65,60,125,
6187,989,86,56,142,
6188,1019,74,55,129,
6189,1004,63,59,122,
6190,1058,71,52,123,
6191,1034,74,71,145,
6192,1021,69,68,137,
6193,1032,88,50,138,
6194,968,77,41,118,
6195,1013,64,68,132,
6196,1036,69,61,130,
6197,1038,69,68,137,
6198,996,89,56,145,
6199,1004,56,69,125,
6200,1025,88,67,155,
6201,940,68,55,123,
6202,1061,84,52,136,
6203,961,77,70,147,
6204,1016,48,50,98,
6205,1039,70,66,136,
6206,1039,71,46,117,
6207,1010,68,56,124,
6208,1009,55,56,111,
6209,1043,63,71,134,
6210,973,71,56,127,
6211,1062,74,62,136,
6212,1094,81,48,129,
6213,1081,63,54,117,
6214,974,81,56,137,
6215,1057,73,55,128,
6216,1017,64,58,122,
6217,1007,88,57,145,
6218,961,67,62,129,
6219,999,55,58,113,
6220,1059,69,64,133,
6221,1025,72,63,135,
6222,1023,91,56,147,
6223,972,76,53,129,
6224,1028,74,53,127,
6225,959,82,52,134,
6226,980,79,51,130,
6227,967,61,58,119,
6228,995,76,61,137,
6229,1041,77,64,141,
6230,1014,72,49,121,
6231,1014,74,49,123,
6232,1004,80,60,140,
6233,978,76,68,144,
6234,1060,68,63,131,
6235,1026,76,62,138,
6236,1086,91,53,144,
6237,1049,86,71,157,
6238,997,81,56,137,
6239,1039,73,64,137,
6240,1046,79,75,154,
6241,1035,83,56,139,
6242,1027,76,47,123,
6243,1054,65,63,128,
6244,1005,87,70,157,
6245,1051,74,65,139,
6246,1058,78,57,135,
6247,1012,65,43,108,
6248,1042,81,70,151,
6249,1040,79,60,139,
6250,970,74,51,125,
6251,953,74,52,126,
6252,955,89,54,143,
6253,958,73,45,118,
6254,1011,84,62,146,
6255,1035,83,59,142,
6256,1041,88,53,141,
6257,1004,74,47,121,
6258,1011,58,72,130,
6259,989,53,55,108,
6260,1048,81,61,142,
6261,1016,81,57,138,
6262,1040,65,53,118,
6263,997,80,52,132,
6264,1044,78,55,133,
6265,1041,62,65,127,
6266,1006,60,50,110,
6267,1032,66,52,118,
6268,1012,61,55,116,
6269,1055,86,58,144,
6270,1017,72,60,132,
6271,985,66,66,132,
6272,1001,58,68,126,
6273,976,52,56,108,
6274,1011,80,52,132,
6275,1038,73,62,135,
6276,1016,75,66,141,
6277,1026,80,73,153,
6278,1103,77,66,143,
6279,1009,66,49,115,
6280,980,53,55,108,
6281,995,56,65,121,
6282,1014,89,38,127,
6283,1037,80,53,133,
6284,1026,68,48,116,
6285,1000,74,59,133,
6286,1026,81,68,149,
6287,986,61,54,115,
6288,1041,77,58,135,
6289,1084,94,65,159,
6290,1025,72,64,136,
6291,1026,71,57,128,
6292,1010,76,56,132,
6293,1005,74,56,130,
6294,1019,81,67,148,
6295,1017,79,66,145,
6296,976,78,62,140,
6297,1013,78,68,146,
6298,993,69,62,131,
6299,995,67,57,124,
6300,1017,79,54,133,
6301,976,75,51,126,
6302,1005,72,59,131,
6303,1066,86,65,151,
6304,965,74,62,136,
6305,1031,72,64,136,
6306,1053,84,61,145,
6307,1008,64,59,123,
6308,1038,70,65,135,
6309,992,67,66,133,
6310,1048,72,54,126,
6311,955,61,65,126,
6312,1010,86,52,138,
6313,1011,71,50,121,
6314,967,71,56,127,
6315,1030,70,68,138,
6316,986,62,59,121,
6317,1026,66,70,136,
6318,1034,72,59,131,
6319,1052,86,50,136,
6320,988,74,59,133,
6321,999,79,55,134,
6322,969,67,54,121,
6323,1011,69,59,128,
6324,1013,75,52,127,
6325,1005,85,54,139,
6326,1031,74,58,132,
6327,1038,70,59,129,
6328,1027,63,59,122,
6329,1083,80,66,146,
6330,985,78,60,138,
6331,1029,73,62,135,
6332,981,72,57,129,
6333,1043,82,73,155,
6334,986,69,56,125,
6335,958,72,56,128,
6336,989,83,66,149,
6337,1024,73,72,145,
6338,999,83,56,139,
6339,1009,81,56,137,
6340,1028,76,50,126,
6341,937,79,49,128,
6342,1017,82,57,139,
6343,1038,77,49,126,
6344,1006,65,66,131,
6345,956,66,54,120,
6346,1006,83,61,144,
6347,997,70,52,122,
6348,978,83,58,141,
6349,1005,82,47,129,
6350,1048,87,59,146,
6351,1018,76,71,147,
6352,1004,72,59,131,
6353,1042,64,57,121,
6354,1003,92,49,141,
6355,1087,87,59,146,
6356,1053,86,63,149,
6357,990,71,48,119,
6358,970,77,53,130,
6359,1045,76,63,139,
6360,981,74,54,128,
6361,1027,74,75,149,
6362,1054,69,52,121,
6363,980,75,49,124,
6364,1079,74,65,139,
6365,1006,71,46,117,
6366,1006,72,66,138,
6367,1009,71,68,139,
6368,1015,64,63,127,
6369,1054,72,55,127,
6370,1067,86,61,147,
6371,984,70,69,139,
6372,1045,91,61,152,
6373,972,64,38,102,
6374,998,78,49,127,
6375,1040,94,66,160,
6376,1036,91,57,148,
6377,1017,84,56,140,
6378,1011,75,64,139,
6379,1003,64,51,115,
6380,1001,66,62,128,
6381,1001,64,55,119,
6382,1028,71,48,119,
6383,1066,85,57,142,
6384,1046,63,70,133,
6385,1017,60,57,117,
6386,927,61,53,114,
6387,1032,71,70,141,
6388,1075,79,67,146,
6389,1006,61,58,119,
6390,1023,76,57,133,
6391,1012,63,49,112,
6392,1026,68,58,126,
6393,979,73,62,135,
6394,1059,89,67,156,
6395,980,78,64,142,
6396,985,80,54,134,
6397,1021,78,61,139,
6398,1016,74,59,133,
6399,1053,89,52,141,
6400,1014,78,56,134,
6401,1041,81,74,155,
6402,1056,90,54,144,
6403,1033,77,55,132,
6404,982,78,55,133,
6405,1039,81,56,137,
6406,961,69,61,130,
6407,1033,71,70,141,
6408,1049,74,49,123,
6409,991,64,45,109,
6410,977,73,60,133,
6411,1023,61,53,114,
6412,1029,84,52,136,
6413,973,72,59,131,
6414,1026,70,60,130,
6415,1031,69,54,123,
6416,1015,77,53,130,
6417,1046,59,59,118,
6418,1035,65,54,119,
6419,990,55,63,118,
6420,1031,81,65,146,
6421,1031,84,68,152,
6422,1019,90,56,146,
6423,958,73,57,130,
6424,1067,86,59,145,
6425,967,62,62,124,
6426,1013,65,66,131,
6427,1035,71,51,122,
6428,1031,76,47,123,
6429,1038,100,58,158,
6430,1036,78,51,129,
6431,984,61,70,131,
6432,1010,66,65,131,
6433,982,73,47,120,
6434,996,57,55,112,
6435,985,66,53,119,
6436,999,67,52,119,
6437,982,69,45,114,
6438,984,64,54,118,
6439,959,78,59,137,
6440,1070,73,66,139,
6441,1009,63,60,123,
6442,1050,83,55,138,
6443,1017,83,43,126,
6444,1058,77,57,134,
6445,1014,91,55,146,
6446,1016,74,69,143,
6447,1050,78,51,129,
6448,1040,73,63,136,
6449,989,72,65,137,
6450,1038,63,66,129,
6451,990,80,50,130,
6452,1040,61,63,124,
6453,1014,75,59,134,
6454,1028,63,68,131,
6455,1021,82,69,151,
6456,1030,86,53,139,
6457,1034,88,58,146,
6458,1062,80,52,132,
6459,999,67,65,132,
6460,990,78,62,140,
6461,1072,91,64,155,
6462,1025,79,63,142,
6463,992,70,51,121,
6464,1007,73,64,137,
6465,1006,63,68,131,
6466,1081,69,72,141,
6467,1028,71,46,117,
6468,1041,75,61,136,
6469,957,71,44,115,
6470,1062,68,55,123,
6471,1022,68,57,125,
6472,964,85,51,136,
6473,1059,71,53,124,
6474,1019,68,62,130,
6475,1059,68,61,129,
6476,1044,80,44,124,
6477,992,67,39,106,
6478,931,67,45,112,
6479,1063,73,67,140,
6480,1020,66,52,118,
6481,1076,86,53,139,
6482,972,78,44,122,
6483,1041,81,64,145,
6484,1066,64,41,105,
6485,1014,83,60,143,
6486,1034,78,58,136,
6487,1064,90,57,147,
6488,999,72,48,120,
6489,1039,92,69,161,
6490,1062,62,54,116,
6491,1046,76,69,145,
6492,1042,89,43,132,
6493,1034,71,59,130,
6494,985,61,50,111,
6495,1018,84,55,139,
6496,1038,79,46,125,
6497,1062,90,64,154,
6498,975,62,46,108,
6499,1040,61,58,119,
6500,1015,88,55,143,
6501,981,81,59,140,
6502,1073,89,62,151,
6503,1052,76,64,140,
6504,998,77,55,132,
6505,1000,80,55,135,
6506,1060,86,56,142,
6507,1023,65,57,122,
6508,948,67,60,127,
6509,1017,76,54,130,
6510,1047,67,53,120,
6511,1068,79,70,149,
6512,1028,70,67,137,
6513,988,66,53,119,
6514,1075,75,63,138,
6515,1054,85,61,146,
6516,1007,74,56,130,
6517,995,80,48,128,
6518,988,72,58,130,
6519,983,50,56,106,
6520,1041,81,66,147,
6521,1060,72,64,136,
6522,1003,60,63,123,
6523,1075,79,80,159,
6524,1011,79,60,139,
6525,1056,77,54,131,
6526,1001,72,67,139,
6527,1039,62,49,111,
6528,1041,74,59,133,
6529,963,67,56,123,
6530,1007,72,64,136,
6531,1066,75,60,135,
6532,999,70,54,124,
6533,1061,87,58,145,
6534,1022,84,56,140,
6535,1008,72,64,136,
6536,980,60,57,117,
6537,1002,65,59,124,
6538,1015,66,62,128,
6539,1024,75,51,126,
6540,1061,74,52,126,
6541,1034,82,56,138,
6542,957,66,56,122,
6543,981,68,63,131,
6544,1040,55,66,121,
6545,992,65,67,132,
6546,1081,84,52,136,
6547,968,64,62,126,
6548,1009,78,67,145,
6549,1112,88,68,156,
6550,1037,70,66,136,
6551,987,54,54,108,
6552,1017,76,56,132,
6553,1000,61,71,132,
6554,980,87,59,146,
6555,1083,83,54,137,
6556,1032,76,62,138,
6557,998,82,58,140,
6558,961,72,63,135,
6559,938,75,51,126,
6560,1031,72,71,143,
6561,1012,78,55,133,
6562,1010,85,55,140,
6563,998,90,69,159,
6564,1116,85,67,152,
6565,1014,73,53,126,
6566,1022,74,64,138,
6567,969,68,54,122,
6568,1077,85,66,151,
6569,965,62,59,121,
6570,1002,70,49,119,
6571,989,69,61,130,
6572,929,77,65,142,
6573,988,75,57,132,
6574,962,83,53,136,
6575,1071,74,61,135,
6576,1006,79,64,143,
6577,1066,70,61,131,
6578,1049,70,55,125,
6579,1002,69,62,131,
6580,1000,66,65,131,
6581,1022,88,62,150,
6582,956,76,38,114,
6583,1048,82,60,142,
6584,1051,69,68,137,
6585,1002,78,49,127,
6586,982,59,48,107,
6587,974,75,49,124,
6588,1058,78,61,139,
6589,966,69,53,122,
6590,1083,75,60,135,
6591,1022,70,59,129,
6592,1067,77,73,150,
6593,1037,80,72,152,
6594,989,54,62,116,
6595,1015,70,54,124,
6596,1035,67,55,122,
6597,1029,79,62,141,
6598,957,59,51,110,
6599,1023,73,61,134,
6600,996,84,62,146,
6601,981,87,62,149,
6602,996,70,59,129,
6603,1004,65,54,119,
6604,1035,65,69,134,
6605,1006,73,55,128,
6606,1015,76,50,126,
6607,1000,59,49,108,
6608,1045,67,59,126,
6609,1064,85,72,157,
6610,982,60,58,118,
6611,1019,83,62,145,
6612,1026,59,58,117,
6613,1065,57,72,129,
6614,982,73,67,140,
6615,1032,67,55,122,
6616,989,73,53,126,
6617,1030,63,62,125,
6618,992,72,53,125,
6619,1003,70,59,129,
6620,1085,92,67,159,
6621,1110,90,64,154,
6622,1069,77,59,136,
6623,1063,84,54,138,
6624,1015,83,67,150,
6625,1082,88,64,152,
6626,1051,83,54,137,
6627,1068,90,72,162,
6628,1015,78,57,135,
6629,1068,72,68,140,
6630,1018,75,51,126,
6631,1027,79,63,142,
6632,1053,70,39,109,
6633,1006,54,67,121,
6634,1039,62,49,111,
6635,1001,77,44,121,
6636,1015,62,67,129,
6637,949,49,50,99,
6638,1029,75,67,142,
6639,1035,81,64,145,
6640,976,87,41,128,
6641,1021,76,61,137,
6642,1013,76,65,141,
6643,1063,54,52,106,
6644,1024,86,64,150,
6645,1002,59,55,114,
6646,1011,62,51,113,
6647,985,75,61,136,
6648,1094,86,75,161,
6649,979,84,59,143,
6650,1071,67,54,121,
6651,1033,76,63,139,
6652,1060,80,45,125,
6653,981,83,57,140,
6654,1060,77,46,123,
6655,1018,61,68,129,
6656,965,73,52,125,
6657,994,73,63,136,
6658,1000,78,52,130,
6659,1070,87,64,151,
6660,993,75,54,129,
6661,1005,71,56,127,
6662,1022,69,40,109,
6663,1044,70,58,128,
6664,1020,68,58,126,
6665,1053,73,60,133,
6666,1027,73,49,122,
6667,988,70,61,131,
6668,1003,66,56,122,
6669,1084,78,52,130,
6670,1064,72,64,136,
6671,1015,53,68,121,
6672,1006,79,57,136,
6673,1031,65,56,121,
6674,1000,85,61,146,
6675,972,63,65,128,
6676,1015,81,54,135,
6677,1052,66,63,129,
6678,995,75,52,127,
6679,987,75,58,133,
6680,996,76,58,134,
6681,1081,72,57,129,
6682,1041,68,56,124,
6683,974,56,50,106,
6684,998,71,57,128,
6685,997,76,52,128,
6686,1016,80,69,149,
6687,1045,81,61,142,
6688,977,68,54,122,
6689,950,68,49,117,
6690,989,86,60,146,
6691,1058,72,49,121,
6692,1014,65,58,123,
6693,1013,80,55,135,
6694,1037,70,63,133,
6695,1011,68,59,127,
6696,1002,74,63,137,
6697,1051,86,76,162,
6698,994,70,57,127,
6699,1034,61,63,124,
6700,990,84,45,129,
6701,1104,92,56,148,
6702,1024,79,56,135,
6703,1025,76,53,129,
6704,1057,80,57,137,
6705,1016,59,51,110,
6706,1091,74,62,136,
6707,1045,75,57,132,
6708,1067,79,51,130,
6709,1018,63,45,108,
6710,1024,81,65,146,
6711,1028,75,75,150,
6712,951,71,49,120,
6713,1000,82,51,133,
6714,1023,91,47,138,
6715,973,76,62,138,
6716,1021,69,59,128,
6717,1039,76,63,139,
6718,962,59,58,117,
6719,1097,80,60,140,
6720,1008,69,60,129,
6721,1044,74,58,132,
6722,1022,50,71,121,
6723,1011,79,56,135,
6724,1032,65,45,110,
6725,1001,63,51,114,
6726,1018,77,59,136,
6727,1021,71,68,139,
6728,992,67,55,122,
6729,1035,77,66,143,
6730,1057,67,62,129,
6731,1034,68,72,140,
6732,1040,77,65,142,
6733,1006,70,59,129,
6734,1075,64,73,137,
6735,1010,70,59,129,
6736,1031,55,60,115,
6737,943,71,60,131,
6738,1019,68,61,129,
6739,1003,53,60,113,
6740,1028,66,53,119,
6741,996,83,54,137,
6742,1062,90,47,137,
6743,1045,73,56,129,
6744,1007,90,49,139,
6745,1012,70,58,128,
6746,1061,88,57,145,
6747,1031,72,48,120,
6748,1024,66,61,127,
6749,999,59,60,119,
6750,954,74,52,126,
6751,981,66,59,125,
6752,1029,80,45,125,
6753,1048,71,52,123,
6754,992,64,61,125,
6755,1019,70,57,127,
6756,1066,81,62,143,
6757,991,77,49,126,
6758,1077,68,62,130,
6759,1038,79,63,142,
6760,1049,69,60,129,
6761,1006,70,51,121,
6762,992,68,61,129,
6763,1024,71,51,122,
6764,1025,75,61,136,
6765,1041,81,72,153,
6766,981,81,48,129,
6767,1009,80,56,136,
6768,1015,75,49,124,
6769,1044,83,57,140,
6770,1007,70,63,133,
6771,1010,75,70,145,
6772,1081,65,58,123,
6773,991,71,46,117,
6774,1034,74,61,135,
6775,1050,72,60,132,
6776,1039,66,64,130,
6777,1014,67,60,127,
6778,1007,58,47,105,
6779,1055,71,42,113,
6780,1044,65,52,117,
6781,966,79,64,143,
6782,1015,83,52,135,
6783,1062,71,60,131,
6784,1026,72,65,137,
6785,1061,62,59,121,
6786,988,66,66,132,
6787,1067,82,61,143,
6788,1051,88,62,150,
6789,1037,77,48,125,
6790,1041,53,68,121,
6791,1048,74,50,124,
6792,1011,66,64,130,
6793,973,76,49,125,
6794,1005,88,58,146,
6795,1030,77,68,145,
6796,1022,70,50,120,
6797,1009,84,47,131,
6798,1033,72,59,131,
6799,1052,67,60,127,
6800,1076,69,72,141,
6801,980,58,54,112,
6802,991,86,63,149,
6803,1049,72,53,125,
6804,1009,83,59,142,
6805,1020,75,67,142,
6806,1045,69,55,124,
6807,973,79,60,139,
6808,980,72,46,118,
6809,1098,85,64,149,
6810,1081,72,59,131,
6811,1027,71,59,130,
6812,1031,68,62,130,
6813,1037,92,46,138,
6814,1005,64,56,120,
6815,1017,75,46,121,
6816,998,69,43,112,
6817,1086,68,66,134,
6818,1055,72,53,125,
6819,1009,75,54,129,
6820,1035,68,56,124,
6821,1021,71,46,117,
6822,1020,75,46,121,
6823,1066,67,71,138,
6824,998,75,51,126,
6825,986,77,52,129,
6826,987,71,48,119,
6827,1058,77,47,124,
6828,1007,59,50,109,
6829,994,81,54,135,
6830,1057,72,65,137,
6831,1007,55,58,113,
6832,1012,71,61,132,
6833,1033,91,52,143,
6834,1025,92,49,141,
6835,1017,83,56,139,
6836,1019,66,52,118,
6837,970,78,63,141,
6838,1045,62,55,117,
6839,1004,76,59,135,
6840,1030,78,47,125,
6841,997,75,55,130,
6842,1052,87,45,132,
6843,1035,69,50,119,
6844,992,77,55,132,
6845,1055,47,57,104,
6846,1009,75,48,123,
6847,988,71,63,134,
6848,1027,80,71,151,
6849,1022,72,61,133,
6850,1011,72,56,128,
6851,1064,60,71,131,
6852,1015,74,61,135,
6853,981,64,45,109,
6854,949,68,56,124,
6855,1010,88,52,140,
6856,1032,65,60,125,
6857,1027,81,60,141,
6858,979,67,63,130,
6859,1014,75,60,135,
6860,988,75,56,131,
6861,1062,75,58,133,
6862,979,59,50,109,
6863,1050,75,57,132,
6864,990,77,70,147,
6865,1001,78,55,133,
6866,985,80,51,131,
6867,962,90,58,148,
6868,1021,67,59,126,
6869,1007,68,73,141,
6870,1048,74,58,132,
6871,1019,61,53,114,
6872,1078,91,64,155,
6873,1010,68,52,120,
6874,1064,64,57,121,
6875,1033,92,55,147,
6876,960,71,57,128,
6877,1033,75,56,131,
6878,959,60,57,117,
6879,1060,77,69,146,
6880,1032,76,56,132,
6881,981,76,46,122,
6882,1036,98,69,167,
6883,984,72,64,136,
6884,1020,60,67,127,
6885,980,69,52,121,
6886,976,59,61,120,
6887,1005,68,52,120,
6888,1066,66,59,125,
6889,957,63,59,122,
6890,972,49,58,107,
6891,1081,86,79,165,
6892,1016,70,46,116,
6893,1049,80,65,145,
6894,1011,61,65,126,
6895,1096,77,50,127,
6896,983,79,47,126,
6897,995,65,58,123,
6898,1045,64,59,123,
6899,1048,72,72,144,
6900,1011,67,57,124,
6901,1015,80,61,141,
6902,959,62,56,118,
6903,1038,78,50,128,
6904,1037,84,75,159,
6905,1005,66,51,117,
6906,1001,74,76,150,
6907,989,87,54,141,
6908,999,62,56,118,
6909,1033,77,72,149,
6910,1011,64,38,102,
6911,971,74,63,137,
6912,1002,67,66,133,
6913,1008,75,68,143,
6914,1020,74,68,142,
6915,1026,70,49,119,
6916,1016,62,47,109,
6917,1010,76,57,133,
6918,997,65,60,125,
6919,1050,77,63,140,
6920,1006,89,50,139,
6921,1004,79,54,133,
6922,1018,79,68,147,
6923,1067,77,59,136,
6924,1014,67,46,113,
6925,1064,82,50,132,
6926,1012,85,61,146,
6927,986,77,68,145,
6928,1058,58,83,141,
6929,1007,72,56,128,
6930,1041,73,62,135,
6931,979,77,51,128,
6932,1007,90,64,154,
6933,997,76,61,137,
6934,964,55,57,112,
6935,1008,74,60,134,
6936,1039,65,60,125,
6937,982,86,51,137,
6938,1068,75,60,135,
6939,1065,74,74,148,
6940,1046,80,72,152,
6941,986,70,44,114,
6942,988,55,49,104,
6943,1002,76,49,125,
6944,1023,60,43,103,
6945,1025,71,49,120,
6946,1042,69,62,131,
6947,1146,89,59,148,
6948,1017,97,59,156,
6949,1011,73,56,129,
6950,999,72,66,138,
6951,1020,66,59,125,
6952,1027,70,71,141,
6953,1024,66,51,117,
6954,1001,87,68,155,
6955,1029,79,72,151,
6956,973,86,58,144,
6957,1001,73,52,125,
6958,1034,72,57,129,
6959,1050,78,57,135,
6960,1046,81,49,130,
6961,999,74,68,142,
6962,1002,77,63,140,
6963,1003,68,57,125,
6964,999,69,51,120,
6965,1034,76,43,119,
6966,934,61,41,102,
6967,1016,80,65,145,
6968,1012,71,58,129,
6969,1012,74,53,127,
6970,993,82,56,138,
6971,1033,78,64,142,
6972,1035,66,60,126,
6973,1002,83,59,142,
6974,1000,82,44,126,
6975,983,74,66,140,
6976,955,61,59,120,
6977,986,78,51,129,
6978,981,70,64,134,
6979,1039,68,73,141,
6980,998,71,66,137,
6981,993,53,56,109,
6982,1033,74,65,139,
6983,1038,91,66,157,
6984,1072,77,54,131,
6985,990,75,55,130,
6986,1027,72,53,125,
6987,1024,86,72,158,
6988,975,71,60,131,
6989,1056,67,55,122,
6990,1041,82,73,155,
6991,997,68,52,120,
6992,1009,68,65,133,
6993,1064,65,55,120,
6994,963,73,68,141,
6995,1025,67,57,124,
6996,972,60,63,123,
6997,1029,82,54,136,
6998,1002,63,69,132,
6999,1015,75,56,131,
7000,997,76,57,133,
7001,994,86,56,142,
7002,1005,88,76,164,
7003,968,56,64,120,
7004,1038,81,55,136,
7005,1030,71,63,134,
7006,987,58,54,112,
7007,1054,72,59,131,
7008,975,65,45,110,
7009,982,69,50,119,
7010,1024,74,48,122,
7011,1059,74,81,155,
7012,993,67,72,139,
7013,993,77,56,133,
7014,1014,82,48,130,
7015,1053,66,66,132,
7016,1044,94,71,165,
7017,1018,73,65,138,
7018,1056,83,55,138,
7019,1015,78,57,135,
7020,999,83,62,145,
7021,1045,90,71,161,
7022,1017,84,60,144,
7023,985,70,61,131,
7024,1034,75,53,128,
7025,1066,80,71,151,
7026,1052,74,49,123,
7027,989,75,69,144,
7028,1037,71,48,119,
7029,1007,76,66,142,
7030,1052,66,68,134,
7031,1018,73,61,134,
7032,955,91,58,149,
7033,978,83,54,137,
7034,1015,84,58,142,
7035,987,90,58,148,
7036,1031,79,57,136,
7037,950,66,53,119,
7038,992,81,49,130,
7039,1031,70,69,139,
7040,1065,72,69,141,
7041,1017,78,56,134,
7042,996,56,60,116,
7043,1031,73,58,131,
7044,1011,75,47,122,
7045,1013,63,48,111,
7046,1046,74,74,148,
7047,1072,67,62,129,
7048,1000,67,58,125,
7049,1005,80,58,138,
7050,984,74,45,119,
7051,1043,78,68,146,
7052,1036,74,46,120,
7053,963,77,55,132,
7054,1044,73,47,120,
7055,970,58,62,120,
7056,1045,70,53,123,
7057,962,85,58,143,
7058,1049,78,59,137,
7059,998,84,59,143,
7060,968,58,61,119,
7061,1019,65,52,117,
7062,975,87,63,150,
7063,1026,79,68,147,
7064,1022,63,62,125,
7065,1028,95,58,153,
7066,1012,78,46,124,
7067,1016,77,53,130,
7068,1011,81,58,139,
7069,993,87,35,122,
7070,998,81,58,139,
7071,1041,68,55,123,
7072,1000,72,51,123,
7073,990,63,43,106,
7074,1009,66,44,110,
7075,1013,75,42,117,
7076,977,74,61,135,
7077,1003,75,64,139,
7078,1044,82,45,127,
7079,1056,74,75,149,
7080,1050,72,44,116,
7081,1021,70,56,126,
7082,1052,81,60,141,
7083,1047,59,51,110,
7084,1055,82,66,148,
7085,1005,67,67,134,
7086,947,58,64,122,
7087,1033,68,54,122,
7088,971,78,65,143,
7089,990,75,58,133,
7090,1031,79,48,127,
7091,1011,84,64,148,
7092,1030,81,70,151,
7093,1063,71,58,129,
7094,1014,75,57,132,
7095,1007,79,52,131,
7096,1035,81,59,140,
7097,1055,87,48,135,
7098,971,77,52,129,
7099,991,73,53,126,
7100,1014,82,55,137,
7101,985,72,56,128,
7102,985,63,51,114,
7103,989,78,60,138,
7104,958,82,53,135,
7105,967,70,53,123,
7106,1018,85,64,149,
7107,1069,72,64,136,
7108,1053,69,68,137,
7109,1033,71,75,146,
7110,974,75,47,122,
7111,1037,73,65,138,
7112,1061,89,59,148,
7113,981,71,58,129,
7114,1023,75,59,134,
7115,999,71,48,119,
7116,1024,62,64,126,
7117,1014,69,62,131,
7118,1019,68,62,130,
7119,1014,78,57,135,
7120,1013,63,57,120,
7121,986,74,46,120,
7122,1023,82,67,149,
7123,1052,73,69,142,
7124,939,56,79,135,
7125,1073,82,74,156,
7126,1045,86,54,140,
7127,1094,73,55,128,
7128,1030,74,64,138,
7129,1066,78,44,122,
7130,1011,78,60,138,
7131,1031,82,69,151,
7132,985,87,60,147,
7133,1027,79,64,143,
7134,998,67,56,123,
7135,1007,85,55,140,
7136,973,68,47,115,
7137,1055,68,68,136,
7138,1003,88,58,146,
7139,964,66,49,115,
7140,991,70,59,129,
7141,1017,76,52,128,
7142,998,60,64,124,
7143,959,69,50,119,
7144,1028,82,51,133,
7145,993,61,49,110,
7146,1017,73,59,132,
7147,1056,66,65,131,
7148,982,71,61,132,
7149,1031,77,58,135,
7150,1059,97,64,161,
7151,1015,62,59,121,
7152,985,68,49,117,
7153,965,72,60,132,
7154,1001,72,62,134,
7155,993,76,60,136,
7156,994,79,51,130,
7157,1015,77,48,125,
7158,1009,77,57,134,
7159,1047,82,59,141,
7160,1056,79,68,147,
7161,1065,83,47,130,
7162,1009,64,61,125,
7163,1010,71,47,118,
7164,1078,77,75,152,
7165,968,72,60,132,
7166,1074,70,61,131,
7167,986,65,58,123,
7168,1014,75,54,129,
7169,1043,84,48,132,
7170,1027,70,52,122,
7171,970,68,48,116,
7172,1018,69,61,130,
7173,977,72,58,130,
7174,999,74,57,131,
7175,973,67,55,122,
7176,988,75,53,128,
7177,987,65,53,118,
7178,972,86,58,144,
7179,998,62,54,116,
7180,991,75,51,126,
7181,1018,74,60,134,
7182,1002,74,68,142,
7183,1035,75,71,146,
7184,999,66,54,120,
7185,1048,81,58,139,
7186,1026,69,61,130,
7187,1033,71,54,125,
7188,997,71,52,123,
7189,983,79,41,120,
7190,1030,80,50,130,
7191,1050,85,74,159,
7192,974,50,68,118,
7193,1028,86,52,138,
7194,989,70,51,121,
7195,1032,81,56,137,
7196,1023,81,74,155,
7197,1013,60,60,120,
7198,1022,77,55,132,
7199,1060,75,54,129,
7200,1116,89,72,161,
7201,1035,84,60,144,
7202,954,66,62,128,
7203,1025,98,51,149,
7204,1067,69,84,153,
7205,1044,78,68,146,
7206,1013,87,63,150,
7207,1010,72,47,119,
7208,1028,79,57,136,
7209,1060,87,52,139,
7210,1056,71,64,135,
7211,1040,78,63,141,
7212,1126,87,65,152,
7213,1082,82,46,128,
7214,1002,73,47,120,
7215,1026,87,51,138,
7216,1017,66,56,122,
7217,1000,62,44,106,
7218,985,80,49,129,
7219,1018,78,59,137,
7220,1076,86,51,137,
7221,997,73,61,134,
7222,1028,68,70,138,
7223,1039,75,70,145,
7224,996,70,54,124,
7225,1000,70,63,133,
7226,1008,66,62,128,
7227,1053,61,48,109,
7228,993,70,57,127,
7229,1027,76,62,138,
7230,1020,69,55,124,
7231,988,71,69,140,
7232,1051,86,64,150,
7233,986,77,49,126,
7234,987,88,46,134,
7235,1030,82,55,137,
7236,1028,71,62,133,
7237,1037,78,60,138,
7238,1024,84,53,137,
7239,1066,84,59,143,
7240,1025,56,46,102,
7241,1093,74,69,143,
7242,1021,84,55,139,
7243,960,71,49,120,
7244,1022,63,55,118,
7245,1026,77,59,136,
7246,1058,71,62,133,
7247,1027,85,52,137,
7248,970,66,72,138,
7249,1039,59,67,126,
7250,1015,81,66,147,
7251,1007,62,60,122,
7252,996,86,55,141,
7253,962,74,50,124,
7254,1018,68,61,129,
7255,1026,71,68,139,
7256,1020,85,56,141,
7257,1039,63,51,114,
7258,1022,68,55,123,
7259,1058,88,68,156,
7260,1123,88,69,157,
7261,990,66,62,128,
7262,1000,69,57,126,
7263,999,82,52,134,
7264,1024,82,49,131,
7265,1043,108,60,168,
7266,1026,62,57,119,
7267,975,68,56,124,
7268,991,71,48,119,
7269,1038,70,53,123,
7270,1021,66,54,120,
7271,1009,69,66,135,
7272,983,68,49,117,
7273,1000,74,53,127,
7274,971,73,56,129,
7275,999,78,58,136,
7276,1017,85,53,138,
7277,1001,80,38,118,
7278,1001,68,56,124,
7279,1048,88,72,160,
7280,1049,66,58,124,
7281,987,75,52,127,
7282,967,71,45,116,
7283,1023,65,60,125,
7284,1003,68,67,135,
7285,1035,75,54,129,
7286,962,62,69,131,
7287,1037,74,57,131,
7288,1028,73,76,149,
7289,1033,78,55,133,
7290,1011,57,73,130,
7291,1054,64,54,118,
7292,1043,69,61,130,
7293,1003,65,59,124,
7294,1001,76,57,133,
7295,1001,65,45,110,
7296,1012,59,57,116,
7297,1005,70,51,121,
7298,983,67,63,130,
7299,1028,70,51,121,
7300,1043,82,66,148,
7301,959,68,52,120,
7302,1103,77,66,143,
7303,1001,75,61,136,
7304,1052,79,74,153,
7305,1004,59,51,110,
7306,1047,70,57,127,
7307,1031,76,56,132,
7308,1076,89,64,153,
7309,1045,76,61,137,
7310,999,44,49,93,
7311,1026,78,65,143,
7312,1018,75,45,120,
7313,1016,80,61,141,
7314,1031,68,65,133,
7315,968,63,46,109,
7316,1024,72,64,136,
7317,998,66,72,138,
7318,1075,69,49,118,
7319,993,62,59,121,
7320,998,57,63,120,
7321,1010,60,60,120,
7322,980,83,55,138,
7323,980,61,53,114,
7324,968,64,61,125,
7325,1038,85,62,147,
7326,1036,74,62,136,
7327,1004,63,50,113,
7328,1031,85,70,155,
7329,1007,60,61,121,
7330,990,83,56,139,
7331,1043,83,50,133,
7332,1005,74,64,138,
7333,1069,85,45,130,
7334,1008,80,63,143,
7335,1018,89,53,142,
7336,1000,67,63,130,
7337,1014,76,58,134,
7338,989,62,71,133,
7339,1012,68,63,131,
7340,990,67,58,125,
7341,1058,75,48,123,
7342,1018,73,59,132,
7343,978,77,59,136,
7344,1007,66,59,125,
7345,1034,77,59,136,
7346,1024,70,55,125,
7347,1002,81,60,141,
7348,1037,78,51,129,
7349,1020,73,53,126,
7350,1034,75,66,141,
7351,1055,92,67,159,
7352,1057,65,57,122,
7353,977,88,64,152,
7354,1036,82,53,135,
7355,1042,79,66,145,
7356,1013,68,56,124,
7357,1002,84,59,143,
7358,998,59,46,105,
7359,1014,62,55,117,
7360,999,70,65,135,
7361,941,59,51,110,
7362,1068,69,73,142,
7363,1028,77,49,126,
7364,1011,75,51,126,
7365,999,75,56,131,
7366,990,83,53,136,
7367,1005,74,56,130,
7368,1007,81,51,132,
7369,1030,72,62,134,
7370,1051,83,49,132,
7371,974,68,62,130,
7372,1029,93,62,155,
7373,960,67,56,123,
7374,1002,71,56,127,
7375,1042,88,59,147,
7376,1073,72,54,126,
7377,1030,78,59,137,
7378,1005,74,52,126,
7379,1009,82,55,137,
7380,1033,65,41,106,
7381,1018,72,69,141,
7382,1047,65,74,139,
7383,1026,69,62,131,
7384,1050,84,51,135,
7385,1063,83,61,144,
7386,1084,78,57,135,
7387,1040,53,61,114,
7388,982,61,64,125,
7389,1030,83,47,130,
7390,1005,74,59,133,
7391,1034,83,53,136,
7392,971,72,57,129,
7393,984,73,57,130,
7394,1034,71,48,119,
7395,1008,61,54,115,
7396,980,67,55,122,
7397,1003,80,70,150,
7398,1024,65,52,117,
7399,1052,100,56,156,
7400,1000,64,57,121,
7401,1063,86,63,149,
7402,1002,62,56,118,
7403,995,79,48,127,
7404,969,93,53,146,
7405,976,66,49,115,
7406,1003,72,59,131,
7407,1006,81,53,134,
7408,1084,75,56,131,
7409,1017,60,58,118,
7410,1033,86,63,149,
7411,1051,81,61,142,
7412,1068,66,52,118,
7413,1017,76,50,126,
7414,999,79,71,150,
7415,1048,63,59,122,
7416,1106,77,74,151,
7417,1001,64,52,116,
7418,1002,69,59,128,
7419,1036,61,82,143,
7420,1100,80,51,131,
7421,1007,65,61,126,
7422,971,70,55,125,
7423,966,79,51,130,
7424,1033,76,50,126,
7425,990,68,56,124,
7426,992,71,59,130,
7427,987,76,56,132,
7428,1064,69,50,119,
7429,958,67,64,131,
7430,978,63,69,132,
7431,989,62,49,111,
7432,1068,68,56,124,
7433,958,61,53,114,
7434,995,83,49,132,
7435,1048,74,63,137,
7436,1020,74,54,128,
7437,1008,75,64,139,
7438,1050,77,76,153,
7439,1051,72,54,126,
7440,1043,80,66,146,
7441,1015,80,59,139,
7442,1018,64,45,109,
7443,997,70,61,131,
7444,1021,68,61,129,
7445,1003,79,46,125,
7446,1067,73,63,136,
7447,1007,83,59,142,
7448,1062,84,65,149,
7449,1020,78,45,123,
7450,1012,71,59,130,
7451,1014,64,59,123,
7452,1050,69,58,127,
7453,962,68,59,127,
7454,1071,85,71,156,
7455,1026,72,69,141,
7456,974,85,44,129,
7457,1107,71,54,125,
7458,1040,73,75,148,
7459,1104,75,71,146,
7460,977,62,51,113,
7461,1084,82,53,135,
7462,1028,79,62,141,
7463,994,57,64,121,
7464,1012,69,57,126,
7465,1052,89,61,150,
7466,990,75,47,122,
7467,982,65,64,129,
7468,1055,74,49,123,
7469,1001,77,67,144,
7470,1040,68,56,124,
7471,1043,76,59,135,
7472,1011,72,59,131,
7473,1002,76,54,130,
7474,1019,79,60,139,
7475,1045,80,61,141,
7476,1067,80,67,147,
7477,985,72,56,128,
7478,992,79,63,142,
7479,988,66,66,132,
7480,1041,86,49,135,
7481,1021,81,58,139,
7482,1081,86,71,157,
7483,1011,68,59,127,
7484,1105,74,70,144,
7485,964,81,58,139,
7486,1025,74,66,140,
7487,984,82,48,130,
7488,1064,75,49,124,
7489,1011,74,62,136,
7490,1000,67,54,121,
7491,1022,65,61,126,
7492,1025,78,58,136,
7493,1022,59,54,113,
7494,1039,80,47,127,
7495,1046,71,78,149,
7496,1042,80,64,144,
7497,959,77,72,149,
7498,1005,65,70,135,
7499,1001,62,60,122,
7500,1006,71,54,125,
7501,1057,62,65,127,
7502,958,62,58,120,
7503,997,79,48,127,
7504,977,83,55,138,
7505,1055,72,54,126,
7506,1018,63,45,108,
7507,1047,81,63,144,
7508,1019,64,60,124,
7509,1015,87,58,145,
7510,987,63,49,112,
7511,1031,73,54,127,
7512,1042,72,50,122,
7513,1030,77,58,135,
7514,1035,84,54,138,
7515,1036,103,64,167,
7516,992,72,52,124,
7517,1038,77,53,130,
7518,1011,70,61,131,
7519,998,77,45,122,
7520,1012,63,59,122,
7521,1052,74,58,132,
7522,1062,89,69,158,
7523,1027,73,63,136,
7524,1030,75,66,141,
7525,1041,67,55,122,
7526,1038,79,46,125,
7527,1016,79,55,134,
7528,1026,75,61,136,
7529,1052,75,56,131,
7530,1017,65,59,124,
7531,995,65,58,123,
7532,1006,79,75,154,
7533,1028,64,49,113,
7534,1016,75,54,129,
7535,984,85,63,148,
7536,1006,74,67,141,
7537,1058,70,53,123,
7538,1052,84,72,156,
7539,1009,88,55,143,
7540,996,74,71,145,
7541,1087,74,80,154,
7542,1061,76,61,137,
7543,964,58,60,118,
7544,980,79,48,127,
7545,984,68,41,109,
7546,1058,69,56,125,
7547,1001,88,51,139,
7548,1010,60,69,129,
7549,1005,65,60,125,
7550,948,66,68,134,
7551,1042,82,67,149,
7552,1036,70,59,129,
7553,1006,69,64,133,
7554,1011,82,56,138,
7555,1008,80,57,137,
7556,1040,78,66,144,
7557,1010,94,55,149,
7558,1002,81,71,152,
7559,1014,70,61,131,
7560,1016,72,52,124,
7561,999,86,60,146,
7562,1045,73,66,139,
7563,1096,82,52,134,
7564,1023,76,49,125,
7565,984,68,52,120,
7566,966,68,40,108,
7567,989,72,71,143,
7568,1029,83,60,143,
7569,1012,70,66,136,
7570,1004,73,55,128,
7571,981,68,63,131,
7572,1001,84,58,142,
7573,1051,74,66,140,
7574,1042,88,55,143,
7575,1027,71,65,136,
7576,1024,76,58,134,
7577,1012,88,54,142,
7578,1061,73,47,120,
7579,977,60,56,116,
7580,1008,88,53,141,
7581,1015,76,53,129,
7582,1017,83,61,144,
7583,1036,72,53,125,
7584,1021,82,55,137,
7585,979,63,61,124,
7586,993,74,50,124,
7587,1034,68,64,132,
7588,1049,86,63,149,
7589,998,71,58,129,
7590,1045,63,66,129,
7591,998,89,61,150,
7592,1015,81,58,139,
7593,985,80,57,137,
7594,971,74,49,123,
7595,996,73,53,126,
7596,1026,61,64,125,
7597,1015,82,57,139,
7598,1000,91,62,153,
7599,1028,67,51,118,
7600,1102,76,61,137,
7601,1010,84,74,158,
7602,1001,78,57,135,
7603,1019,68,54,122,
7604,961,65,62,127,
7605,978,75,66,141,
7606,1016,80,49,129,
7607,1050,86,58,144,
7608,953,85,48,133,
7609,1023,79,68,147,
7610,1074,66,57,123,
7611,909,70,46,116,
7612,1008,80,62,142,
7613,979,69,67,136,
7614,958,83,52,135,
7615,1071,84,66,150,
7616,1025,70,55,125,
7617,1010,69,55,124,
7618,1011,83,61,144,
7619,1044,84,77,161,
7620,990,73,62,135,
7621,1032,76,67,143,
7622,990,77,54,131,
7623,1058,97,68,165,
7624,1035,75,61,136,
7625,959,58,47,105,
7626,1038,80,60,140,
7627,1053,68,53,121,
7628,1032,76,61,137,
7629,911,72,52,124,
7630,1042,76,64,140,
7631,1044,77,58,135,
7632,1045,70,52,122,
7633,1025,70,56,126,
7634,1042,71,59,130,
7635,1018,82,72,154,
7636,1030,54,54,108,
7637,979,71,59,130,
7638,1045,77,57,134,
7639,965,70,56,126,
7640,1014,74,53,127,
7641,1001,80,55,135,
7642,1028,74,53,127,
7643,1015,74,59,133,
7644,969,83,61,144,
7645,983,78,74,152,
7646,997,61,61,122,
7647,1001,65,51,116,
7648,1007,64,52,116,
7649,1014,86,55,141,
7650,1000,62,60,122,
7651,1050,91,63,154,
7652,1032,76,58,134,
7653,1062,82,55,137,
7654,1008,65,50,115,
7655,1075,63,60,123,
7656,1077,87,73,160,
7657,992,63,63,126,
7658,1000,60,49,109,
7659,1021,76,74,150,
7660,1028,74,71,145,
7661,1026,75,47,122,
7662,1019,62,39,101,
7663,1008,79,46,125,
7664,972,56,59,115,
7665,993,58,54,112,
7666,974,69,43,112,
7667,1008,82,56,138,
7668,1018,71,60,131,
7669,1015,72,52,124,
7670,1021,68,65,133,
7671,963,77,43,120,
7672,1002,76,53,129,
7673,997,82,53,135,
7674,1003,69,60,129,
7675,1010,75,63,138,
7676,999,79,68,147,
7677,1058,74,59,133,
7678,1028,77,60,137,
7679,1044,68,55,123,
7680,1039,89,60,149,
7681,1002,63,66,129,
7682,1033,68,54,122,
7683,1088,84,60,144,
7684,1103,78,68,146,
7685,1078,85,61,146,
7686,1004,76,64,140,
7687,1041,68,66,134,
7688,1036,74,67,141,
7689,1015,68,56,124,
7690,968,80,41,121,
7691,1032,90,63,153,
7692,1042,57,65,122,
7693,1012,76,53,129,
7694,1016,58,53,111,
7695,1038,76,47,123,
7696,1096,86,71,157,
7697,1022,72,51,123,
7698,999,74,59,133,
7699,1041,80,65,145,
7700,1001,85,71,156,
7701,1070,69,69,138,
7702,1028,76,58,134,
7703,1013,77,59,136,
7704,1018,70,59,129,
7705,995,73,63,136,
7706,1005,73,64,137,
7707,1004,78,50,128,
7708,1045,67,63,130,
7709,961,60,56,116,
7710,978,69,65,134,
7711,955,78,50,128,
7712,1017,62,54,116,
7713,1011,75,55,130,
7714,1074,98,54,152,
7715,1005,72,59,131,
7716,999,61,49,110,
7717,969,63,53,116,
7718,1050,78,65,143,
7719,1032,85,83,168,
7720,970,62,45,107,
7721,1054,84,62,146,
7722,1013,65,59,124,
7723,1040,73,69,142,
7724,992,71,48,119,
7725,1054,72,60,132,
7726,1036,68,65,133,
7727,977,78,68,146,
7728,1037,75,50,125,
7729,999,82,54,136,
7730,955,72,54,126,
7731,1037,69,63,132,
7732,1066,82,67,149,
7733,955,63,54,117,
7734,1032,72,66,138,
7735,1024,74,57,131,
7736,1027,58,58,116,
7737,1004,86,48,134,
7738,1007,80,61,141,
7739,1006,85,66,151,
7740,1023,62,72,134,
7741,1017,63,65,128,
7742,1009,73,67,140,
7743,1062,73,58,131,
7744,1043,76,57,133,
7745,1050,66,62,128,
7746,1031,78,61,139,
7747,1042,70,58,128,
7748,1095,91,57,148,
7749,1019,87,48,135,
7750,1014,67,67,134,
7751,1040,65,64,129,
7752,1013,72,57,129,
7753,999,76,60,136,
7754,1038,68,52,120,
7755,1022,80,71,151,
7756,984,87,59,146,
7757,1067,80,62,142,
7758,991,85,57,142,
7759,1053,76,47,123,
7760,1003,80,61,141,
7761,1035,72,67,139,
7762,997,65,66,131,
7763,1009,65,58,123,
7764,1092,81,66,147,
7765,1014,83,55,138,
7766,1058,72,72,144,
7767,1016,64,62,126,
7768,1097,87,61,148,
7769,1058,76,62,138,
7770,1066,88,58,146,
7771,1006,68,48,116,
7772,1021,74,52,126,
7773,1021,62,62,124,
7774,1029,77,60,137,
7775,997,70,81,151,
7776,1020,83,59,142,
7777,1047,78,63,141,
7778,1024,61,51,112,
7779,1046,81,56,137,
7780,1042,79,64,143,
7781,1027,78,61,139,
7782,1032,82,57,139,
7783,951,80,58,138,
7784,1013,65,51,116,
7785,1034,80,61,141,
7786,1033,84,51,135,
7787,1019,64,62,126,
7788,1049,77,68,145,
7789,974,78,51,129,
7790,1024,67,65,132,
7791,1005,79,59,138,
7792,1082,75,51,126,
7793,1059,85,68,153,
7794,1035,71,65,136,
7795,1036,70,68,138,
7796,1011,82,51,133,
7797,1060,84,53,137,
7798,1057,79,53,132,
7799,997,77,52,129,
7800,973,56,56,112,
7801,1092,72,66,138,
7802,996,76,66,142,
7803,984,56,58,114,
7804,1007,71,45,116,
7805,1114,83,58,141,
7806,988,83,73,156,
7807,985,76,51,127,
7808,1023,73,54,127,
7809,1055,69,70,139,
7810,982,77,52,129,
7811,962,63,64,127,
7812,1038,64,68,132,
7813,994,60,61,121,
7814,1061,79,63,142,
7815,1048,78,51,129,
7816,1013,67,72,139,
7817,1030,92,55,147,
7818,1035,74,52,126,
7819,1059,78,66,144,
7820,1047,63,59,122,
7821,1006,78,52,130,
7822,1037,67,54,121,
7823,1013,72,52,124,
7824,939,66,50,116,
7825,1036,97,72,169,
7826,997,82,55,137,
7827,958,64,51,115,
7828,1007,61,48,109,
7829,1054,83,54,137,
7830,1016,68,62,130,
7831,1040,63,48,111,
7832,1029,67,46,113,
7833,959,53,48,101,
7834,931,82,53,135,
7835,1025,62,63,125,
7836,1040,85,49,134,
7837,974,61,56,117,
7838,1033,86,57,143,
7839,1039,89,61,150,
7840,1026,82,61,143,
7841,999,64,60,124,
7842,977,64,59,123,
7843,1005,76,69,145,
7844,1027,63,75,138,
7845,1029,84,47,131,
7846,1019,68,51,119,
7847,1025,59,56,115,
7848,980,62,54,116,
7849,1022,77,48,125,
7850,1048,70,76,146,
7851,1026,67,59,126,
7852,1070,82,58,140,
7853,1065,85,51,136,
7854,1033,82,66,148,
7855,988,64,45,109,
7856,939,79,69,148,
7857,993,73,59,132,
7858,1032,67,73,140,
7859,1046,99,69,168,
7860,1050,63,56,119,
7861,980,75,39,114,
7862,1010,70,49,119,
7863,989,70,50,120,
7864,1001,75,57,132,
7865,1044,67,52,119,
7866,1011,71,52,123,
7867,1017,80,60,140,
7868,993,72,57,129,
7869,1080,70,57,127,
7870,1003,78,48,126,
7871,1061,81,63,144,
7872,1039,68,71,139,
7873,1017,72,54,126,
7874,1033,69,65,134,
7875,984,59,52,111,
7876,1015,66,70,136,
7877,1054,83,52,135,
7878,1040,70,61,131,
7879,1044,73,46,119,
7880,987,75,46,121,
7881,1016,67,55,122,
7882,934,64,62,126,
7883,1037,88,52,140,
7884,980,61,51,112,
7885,1012,76,52,128,
7886,1056,72,79,151,
7887,989,72,62,134,
7888,980,84,69,153,
7889,1020,77,49,126,
7890,966,66,56,122,
7891,1008,65,50,115,
7892,1062,69,59,128,
7893,1078,77,73,150,
7894,1009,64,51,115,
7895,1107,93,68,161,
7896,967,65,53,118,
7897,1004,79,64,143,
7898,1046,77,46,123,
7899,1024,77,55,132,
7900,993,66,71,137,
7901,1036,66,60,126,
7902,992,73,52,125,
7903,1054,74,52,126,
7904,1070,79,69,148,
7905,1048,65,62,127,
7906,1041,78,58,136,
7907,1032,79,68,147,
7908,1015,80,58,138,
7909,987,80,52,132,
7910,987,68,61,129,
7911,1020,85,62,147,
7912,1000,82,60,142,
7913,1046,69,65,134,
7914,1058,76,62,138,
7915,998,63,56,119,
7916,1059,76,63,139,
7917,1021,58,59,117,
7918,1021,87,50,137,
7919,1048,79,64,143,
7920,1023,72,47,119,
7921,1020,70,62,132,
7922,974,55,56,111,
7923,995,88,61,149,
7924,1073,91,49,140,
7925,1031,76,51,127,
7926,992,63,59,122,
7927,1033,76,54,130,
7928,1059,87,63,150,
7929,1028,55,50,105,
7930,999,75,59,134,
7931,1048,74,45,119,
7932,1008,80,55,135,
7933,992,57,64,121,
7934,1041,80,52,132,
7935,1018,78,55,133,
7936,1049,68,58,126,
7937,991,68,59,127,
7938,1048,79,64,143,
7939,1043,80,42,122,
7940,954,66,56,122,
7941,998,64,61,125,
7942,982,72,44,116,
7943,1039,65,62,127,
7944,983,61,54,115,
7945,1059,84,61,145,
7946,1006,71,57,128,
7947,1064,94,61,155,
7948,976,74,46,120,
7949,1020,77,73,150,
7950,1061,70,61,131,
7951,1007,67,48,115,
7952,1149,72,61,133,
7953,1017,79,54,133,
7954,1007,83,60,143,
7955,968,62,58,120,
7956,1026,72,52,124,
7957,1076,94,67,161,
7958,1029,83,58,141,
7959,1019,70,63,133,
7960,1056,71,65,136,
7961,1074,89,59,148,
7962,1049,75,59,134,
7963,981,70,46,116,
7964,1038,89,64,153,
7965,945,53,62,115,
7966,1057,69,70,139,
7967,1037,71,56,127,
7968,1058,77,58,135,
7969,992,78,52,130,
7970,997,70,66,136,
7971,1059,85,49,134,
7972,979,87,58,145,
7973,1049,75,63,138,
7974,952,68,60,128,
7975,1030,74,65,139,
7976,1027,55,56,111,
7977,1029,72,55,127,
7978,995,70,56,126,
7979,1030,76,49,125,
7980,1053,69,77,146,
7981,1068,77,58,135,
7982,995,87,48,135,
7983,1031,67,54,121,
7984,1018,79,57,136,
7985,1071,79,60,139,
7986,980,73,53,126,
7987,993,83,53,136,
7988,1037,65,59,124,
7989,981,82,44,126,
7990,1041,69,61,130,
7991,976,71,60,131,
7992,1009,74,57,131,
7993,1018,92,53,145,
7994,1046,96,58,154,
7995,999,83,49,132,
7996,1010,63,60,123,
7997,1064,83,68,151,
7998,996,73,58,131,
7999,1046,69,51,120,
8000,969,68,55,123,
8001,987,80,58,138,
8002,1055,68,63,131,
8003,1057,78,71,149,
8004,1003,72,54,126,
8005,1041,80,63,143,
8006,1049,73,58,131,
8007,1035,63,61,124,
8008,998,68,58,126,
8009,989,84,52,136,
8010,982,71,60,131,
8011,1059,86,59,145,
8012,984,54,52,106,
8013,1035,78,54,132,
8014,1048,79,66,145,
8015,1023,88,60,148,
8016,1051,80,58,138,
8017,1013,79,53,132,
8018,1023,70,44,114,
8019,974,76,53,129,
8020,1045,78,60,138,
8021,1049,70,54,124,
8022,1078,87,53,140,
8023,1103,85,45,130,
8024,1012,75,54,129,
8025,997,66,56,122,
8026,959,74,52,126,
8027,1074,68,63,131,
8028,1003,56,63,119,
8029,1074,90,66,156,
8030,1060,84,49,133,
8031,1041,73,56,129,
8032,1080,97,67,164,
8033,987,68,49,117,
8034,958,80,54,134,
8035,937,58,61,119,
8036,931,66,42,108,
8037,1007,72,57,129,
8038,1042,76,60,136,
8039,1039,69,59,128,
8040,982,70,59,129,
8041,1078,85,62,147,
8042,1027,72,51,123,
8043,1011,67,55,122,
8044,997,65,56,121,
8045,1056,74,63,137,
8046,1047,86,54,140,
8047,1088,82,64,146,
8048,1024,85,62,147,
8049,1009,65,66,131,
8050,992,69,50,119,
8051,1012,65,55,120,
8052,1021,91,63,154,
8053,1000,77,58,135,
8054,1023,66,67,133,
8055,977,76,56,132,
8056,997,66,52,118,
8057,1014,61,56,117,
8058,938,71,57,128,
8059,1013,73,66,139,
8060,976,69,62,131,
8061,1010,79,60,139,
8062,1059,66,60,126,
8063,1031,59,68,127,
8064,975,76,52,128,
8065,1051,82,61,143,
8066,985,73,52,125,
8067,997,67,60,127,
8068,1003,81,68,149,
8069,1019,72,57,129,
8070,1014,72,46,118,
8071,1062,83,59,142,
8072,1018,74,69,143,
8073,1043,76,56,132,
8074,1028,73,51,124,
8075,1035,76,44,120,
8076,976,67,67,134,
8077,1103,86,70,156,
8078,1018,71,54,125,
8079,1084,74,51,125,
8080,1022,77,53,130,
8081,1011,74,51,125,
8082,1026,65,54,119,
8083,1067,74,61,135,
8084,1036,67,63,130,
8085,1002,73,57,130,
8086,1059,96,41,137,
8087,1046,62,64,126,
8088,1044,65,71,136,
8089,1090,68,57,125,
8090,1008,80,63,143,
8091,1012,67,68,135,
8092,1026,74,59,133,
8093,1051,74,48,122,
8094,1049,84,66,150,
8095,1022,72,65,137,
8096,1078,84,73,157,
8097,1015,84,57,141,
8098,1001,81,52,133,
8099,998,81,51,132,
8100,1013,79,56,135,
8101,1061,72,59,131,
8102,969,70,55,125,
8103,1021,83,60,143,
8104,1012,75,58,133,
8105,1046,91,49,140,
8106,1015,71,70,141,
8107,1023,58,53,111,
8108,969,76,63,139,
8109,1020,66,61,127,
8110,1039,66,55,121,
8111,1034,67,45,112,
8112,983,69,52,121,
8113,1022,69,53,122,
8114,1026,82,47,129,
8115,990,79,54,133,
8116,1082,94,52,146,
8117,1043,75,56,131,
8118,1028,73,73,146,
8119,1053,65,54,119,
8120,1027,63,50,113,
8121,1035,84,45,129,
8122,988,73,46,119,
8123,1010,63,53,116,
8124,1018,73,59,132,
8125,1065,85,64,149,
8126,1010,82,66,148,
8127,1049,81,70,151,
8128,1066,75,55,130,
8129,1072,77,65,142,
8130,1026,84,40,124,
8131,1007,62,73,135,
8132,985,72,60,132,
8133,1034,80,64,144,
8134,1077,76,63,139,
8135,1008,77,60,137,
8136,987,67,49,116,
8137,1023,81,53,134,
8138,990,73,54,127,
8139,1016,74,66,140,
8140,1026,65,49,114,
8141,1021,57,53,110,
8142,1060,85,67,152,
8143,1006,66,68,134,
8144,1022,90,62,152,
8145,989,62,44,106,
8146,1031,85,56,141,
8147,1027,66,61,127,
8148,1047,80,64,144,
8149,1034,74,50,124,
8150,991,82,52,134,
8151,1101,85,61,146,
8152,972,55,46,101,
8153,1071,78,64,142,
8154,1008,86,60,146,
8155,1002,80,64,144,
8156,1034,74,67,141,
8157,1032,90,71,161,
8158,1049,75,58,133,
8159,1014,84,61,145,
8160,1026,71,64,135,
8161,1062,77,55,132,
8162,1057,73,63,136,
8163,1069,81,66,147,
8164,984,70,50,120,
8165,957,71,44,115,
8166,1001,70,64,134,
8167,1059,85,46,131,
8168,972,69,42,111,
8169,1005,66,54,120,
8170,1066,78,56,134,
8171,1073,81,65,146,
8172,1077,79,60,139,
8173,992,55,55,110,
8174,1026,73,64,137,
8175,1011,65,61,126,
8176,1029,79,49,128,
8177,961,74,64,138,
8178,1044,67,53,120,
8179,1063,78,54,132,
8180,954,88,46,134,
8181,1011,77,52,129,
8182,1096,70,61,131,
8183,1059,79,78,157,
8184,1071,71,72,143,
8185,1051,62,62,124,
8186,1001,65,62,127,
8187,1002,63,53,116,
8188,1048,72,57,129,
8189,998,80,47,127,
8190,1022,64,57,121,
8191,1081,77,67,144,
8192,1042,69,54,123,
8193,978,69,64,133,
8194,981,64,57,121,
8195,988,73,65,138,
8196,963,62,52,114,
8197,999,81,60,141,
8198,1048,86,62,148,
8199,977,73,48,121,
8200,958,61,70,131,
8201,1008,64,61,125,
8202,970,70,65,135,
8203,1022,91,57,148,
8204,1001,79,69,148,
8205,1066,68,71,139,
8206,1025,81,49,130,
8207,1034,70,51,121,
8208,1082,63,66,129,
8209,1028,63,51,114,
8210,1054,68,73,141,
8211,1066,77,51,128,
8212,1022,102,55,157,
8213,996,60,59,119,
8214,1000,59,51,110,
8215,990,73,61,134,
8216,997,67,58,125,
8217,1066,73,63,136,
8218,998,81,60,141,
8219,1046,91,71,162,
8220,1042,73,57,130,
8221,986,84,57,141,
8222,997,84,61,145,
8223,1004,66,49,115,
8224,1041,81,60,141,
8225,1001,72,52,124,
8226,1030,85,61,146,
8227,1014,72,59,131,
8228,973,69,61,130,
8229,1000,72,59,131,
8230,991,64,39,103,
8231,1007,66,48,114,
8232,1042,70,53,123,
8233,1043,67,57,124,
8234,1015,70,58,128,
8235,1003,76,55,131,
8236,1038,78,58,136,
8237,998,79,54,133,
8238,1054,70,65,135,
8239,1074,83,62,145,
8240,997,90,62,152,
8241,1043,71,61,132,
8242,1023,77,53,130,
8243,988,69,82,151,
8244,951,74,50,124,
8245,1017,79,59,138,
8246,964,66,60,126,
8247,1007,74,47,121,
8248,1001,68,58,126,
8249,1040,71,57,128,
8250,1026,66,70,136,
8251,1051,90,56,146,
8252,1035,83,66,149,
8253,994,81,70,151,
8254,1012,71,61,132,
8255,1070,93,61,154,
8256,1037,90,52,142,
8257,1005,66,66,132,
8258,976,81,57,138,
8259,1044,81,51,132,
8260,1046,62,69,131,
8261,1040,77,57,134,
8262,1055,85,69,154,
8263,1040,61,57,118,
8264,1028,77,59,136,
8265,1025,92,65,157,
8266,967,66,53,119,
8267,1035,88,57,145,
8268,1031,80,53,133,
8269,1042,69,49,118,
8270,1034,70,62,132,
8271,966,65,59,124,
8272,1060,89,51,140,
8273,987,77,62,139,
8274,1045,55,72,127,
8275,1027,72,52,124,
8276,972,61,47,108,
8277,981,76,54,130,
8278,1055,63,43,106,
8279,1009,66,53,119,
8280,1013,73,60,133,
8281,1016,84,62,146,
8282,1043,77,58,135,
8283,1030,73,58,131,
8284,1046,70,52,122,
8285,1033,78,62,140,
8286,1085,84,50,134,
8287,954,81,42,123,
8288,1034,74,58,132,
8289,1005,63,56,119,
8290,977,79,48,127,
8291,1033,65,49,114,
8292,1107,92,55,147,
8293,1018,78,60,138,
8294,1058,77,69,146,
8295,970,75,53,128,
8296,969,62,47,109,
8297,1087,80,60,140,
8298,1006,74,55,129,
8299,1025,75,50,125,
8300,1009,83,61,144,
8301,996,82,62,144,
8302,1071,77,62,139,
8303,1053,80,54,134,
8304,934,60,53,113,
8305,1010,63,65,128,
8306,999,66,70,136,
8307,1085,85,62,147,
8308,1018,83,54,137,
8309,1007,70,57,127,
8310,1022,70,53,123,
8311,963,62,57,119,
8312,991,57,47,104,
8313,1007,63,58,121,
8314,1008,73,61,134,
8315,1060,86,46,132,
8316,1025,79,48,127,
8317,1056,74,57,131,
8318,998,83,51,134,
8319,1027,69,56,125,
8320,1016,84,62,146,
8321,1005,63,66,129,
8322,1018,88,62,150,
8323,985,64,57,121,
8324,971,72,61,133,
8325,985,75,49,124,
8326,1016,70,63,133,
8327,1010,91,54,145,
8328,1005,72,54,126,
8329,1022,88,64,152,
8330,1026,75,55,130,
8331,1054,71,53,124,
8332,1005,62,58,120,
8333,1050,73,66,139,
8334,946,71,47,118,
8335,1063,68,69,137,
8336,960,71,48,119,
8337,1072,101,70,171,
8338,984,69,55,124,
8339,1036,75,54,129,
8340,1025,69,70,139,
8341,1014,77,50,127,
8342,996,67,56,123,
8343,1044,76,66,142,
8344,958,75,58,133,
8345,997,64,68,132,
8346,989,70,46,116,
8347,1028,66,51,117,
8348,1012,69,69,138,
8349,983,71,44,115,
8350,1000,78,51,129,
8351,1041,65,58,123,
8352,1031,77,53,130,
8353,1080,84,62,146,
8354,1015,83,57,140,
8355,975,65,51,116,
8356,1008,77,50,127,
8357,1021,65,47,112,
8358,1042,55,65,120,
8359,987,68,71,139,
8360,1052,70,45,115,
8361,1016,86,63,149,
8362,1065,65,50,115,
8363,987,68,55,123,
8364,1037,74,73,147,
8365,1029,76,52,128,
8366,1014,57,80,137,
8367,993,64,51,115,
8368,1012,69,54,123,
8369,983,67,66,133,
8370,1047,70,53,123,
8371,969,69,62,131,
8372,1021,81,57,138,
8373,1036,79,48,127,
8374,1040,66,62,128,
8375,1089,91,62,153,
8376,1011,64,56,120,
8377,1006,79,67,146,
8378,1019,85,59,144,
8379,999,76,46,122,
8380,1068,92,73,165,
8381,1027,76,54,130,
8382,1031,64,50,114,
8383,1030,84,55,139,
8384,1070,82,58,140,
8385,959,69,46,115,
8386,1037,73,56,129,
8387,1016,85,68,153,
8388,956,76,55,131,
8389,987,56,51,107,
8390,1063,74,59,133,
8391,1037,75,60,135,
8392,1044,61,60,121,
8393,986,83,56,139,
8394,1012,73,61,134,
8395,1055,88,68,156,
8396,1068,74,60,134,
8397,973,69,56,125,
8398,1018,82,52,134,
8399,999,61,57,118,
8400,1045,58,65,123,
8401,1008,74,74,148,
8402,1019,79,52,131,
8403,969,84,63,147,
8404,1004,57,61,118,
8405,1072,74,72,146,
8406,994,76,46,122,
8407,984,92,67,159,
8408,1050,75,59,134,
8409,1036,76,47,123,
8410,1007,62,65,127,
8411,1017,79,62,141,
8412,1011,73,53,126,
8413,1004,84,57,141,
8414,988,73,47,120,
8415,1033,71,61,132,
8416,983,73,53,126,
8417,1017,97,56,153,
8418,1026,81,49,130,
8419,1022,88,47,135,
8420,1019,75,56,131,
8421,977,78,53,131,
8422,986,71,52,123,
8423,1054,91,51,142,
8424,1145,90,66,156,
8425,1024,86,57,143,
8426,1052,84,70,154,
8427,1030,70,54,124,
8428,1051,69,61,130,
8429,1048,76,65,141,
8430,972,70,49,119,
8431,1010,79,61,140,
8432,1067,82,50,132,
8433,1031,80,55,135,
8434,1008,65,62,127,
8435,1033,76,53,129,
8436,995,71,59,130,
8437,1016,69,62,131,
8438,1021,56,67,123,
8439,1059,74,65,139,
8440,1007,70,60,130,
8441,978,61,62,123,
8442,1010,78,63,141,
8443,986,78,51,129,
8444,1018,74,62,136,
8445,999,87,62,149,
8446,1061,73,47,120,
8447,1029,74,52,126,
8448,997,73,46,119,
8449,986,86,59,145,
8450,1046,79,64,143,
8451,1044,88,54,142,
8452,991,68,54,122,
8453,1036,73,58,131,
8454,1071,82,52,134,
8455,993,71,53,124,
8456,1049,73,63,136,
8457,1014,70,62,132,
8458,1027,85,57,142,
8459,1057,71,65,136,
8460,1004,64,61,125,
8461,1019,77,62,139,
8462,1029,84,78,162,
8463,1064,67,53,120,
8464,1081,76,59,135,
8465,988,79,61,140,
8466,1091,94,73,167,
8467,1019,68,62,130,
8468,1001,76,62,138,
8469,1086,76,57,133,
8470,1029,72,50,122,
8471,1038,72,70,142,
8472,999,80,61,141,
8473,1028,87,50,137,
8474,1068,71,73,144,
8475,1012,80,74,154,
8476,1037,78,63,141,
8477,1011,73,58,131,
8478,988,71,59,130,
8479,1028,70,42,112,
8480,969,71,44,115,
8481,1015,57,53,110,
8482,1017,80,50,130,
8483,1071,86,63,149,
8484,1035,78,63,141,
8485,1031,75,54,129,
8486,1019,77,67,144,
8487,979,74,68,142,
8488,1048,71,52,123,
8489,1011,72,51,123,
8490,1017,68,55,123,
8491,1048,73,61,134,
8492,1035,80,56,136,
8493,981,73,51,124,
8494,1027,79,62,141,
8495,1051,63,62,125,
8496,1019,76,53,129,
8497,1052,87,48,135,
8498,1057,76,74,150,
8499,1010,79,46,125,
8500,994,79,55,134,
8501,1070,71,67,138,
8502,1030,69,69,138,
8503,1041,77,56,133,
8504,1052,79,50,129,
8505,979,74,61,135,
8506,1017,69,55,124,
8507,1010,90,49,139,
8508,1010,88,44,132,
8509,1004,67,56,123,
8510,1003,79,59,138,
8511,1072,65,69,134,
8512,1063,89,64,153,
8513,1064,82,60,142,
8514,1011,72,48,120,
8515,1009,67,52,119,
8516,1000,66,60,126,
8517,1033,73,52,125,
8518,1032,85,58,143,
8519,1018,76,74,150,
8520,1000,75,54,129,
8521,1016,71,63,134,
8522,973,71,53,124,
8523,1048,71,60,131,
8524,1054,67,77,144,
8525,938,65,56,121,
8526,959,61,50,111,
8527,1042,84,48,132,
8528,996,81,58,139,
8529,1057,89,55,144,
8530,1044,80,62,142,
8531,1005,85,44,129,
8532,1070,91,68,159,
8533,998,76,71,147,
8534,1011,83,68,151,
8535,973,89,51,140,
8536,1023,80,67,147,
8537,988,63,49,112,
8538,1011,70,56,126,
8539,1001,81,56,137,
8540,1004,83,64,147,
8541,996,83,65,148,
8542,976,68,66,134,
8543,1006,70,43,113,
8544,1040,79,50,129,
8545,974,89,45,134,
8546,1055,75,63,138,
8547,1007,56,49,105,
8548,992,68,57,125,
8549,1009,86,50,136,
8550,1034,78,60,138,
8551,1059,86,69,155,
8552,1022,70,51,121,
8553,1027,79,60,139,
8554,988,67,49,116,
8555,1066,78,56,134,
8556,996,73,56,129,
8557,986,59,58,117,
8558,1054,94,62,156,
8559,962,65,56,121,
8560,973,68,50,118,
8561,997,66,50,116,
8562,974,70,65,135,
8563,983,70,54,124,
8564,997,64,54,118,
8565,974,69,58,127,
8566,1025,81,67,148,
8567,1064,77,59,136,
8568,1026,75,70,145,
8569,961,80,59,139,
8570,965,74,54,128,
8571,1001,69,67,136,
8572,1054,67,70,137,
8573,1019,89,58,147,
8574,986,59,59,118,
8575,1039,73,56,129,
8576,1014,81,63,144,
8577,993,87,50,137,
8578,993,61,64,125,
8579,969,60,50,110,
8580,1031,82,78,160,
8581,1042,74,53,127,
8582,1006,76,56,132,
8583,1039,78,63,141,
8584,1003,74,57,131,
8585,1009,77,54,131,
8586,971,78,56,134,
8587,1043,75,75,150,
8588,1024,73,63,136,
8589,1023,78,60,138,
8590,1016,83,69,152,
8591,997,70,66,136,
8592,982,68,54,122,
8593,1025,68,65,133,
8594,1068,86,66,152,
8595,994,77,55,132,
8596,968,63,63,126,
8597,992,62,57,119,
8598,1054,65,47,112,
8599,993,74,49,123,
8600,1026,76,58,134,
8601,1032,84,61,145,
8602,1020,82,63,145,
8603,1031,75,58,133,
8604,1022,80,54,134,
8605,995,75,54,129,
8606,1040,84,56,140,
8607,966,67,54,121,
8608,1018,70,54,124,
8609,1027,79,49,128,
8610,1051,82,58,140,
8611,1019,69,51,120,
8612,1056,75,60,135,
8613,1075,68,58,126,
8614,1083,82,51,133,
8615,1004,71,62,133,
8616,1017,79,54,133,
8617,1026,77,60,137,
8618,996,78,67,145,
8619,1039,85,50,135,
8620,985,77,53,130,
8621,1005,75,66,141,
8622,1045,76,60,136,
8623,993,65,75,140,
8624,968,62,56,118,
8625,998,86,60,146,
8626,1065,68,60,128,
8627,1046,73,67,140,
8628,1037,65,43,108,
8629,976,77,55,132,
8630,973,68,46,114,
8631,1075,73,54,127,
8632,1048,82,43,125,
8633,970,63,60,123,
8634,1057,70,60,130,
8635,1017,68,47,115,
8636,978,73,56,129,
8637,1001,63,56,119,
8638,1022,74,60,134,
8639,1013,53,48,101,
8640,996,73,61,134,
8641,985,78,61,139,
8642,1051,72,52,124,
8643,1032,77,60,137,
8644,1039,82,65,147,
8645,1026,62,65,127,
8646,1028,90,53,143,
8647,959,82,56,138,
8648,1020,80,46,126,
8649,1054,86,70,156,
8650,1035,83,56,139,
8651,1039,82,51,133,
8652,1048,78,46,124,
8653,985,72,58,130,
8654,1059,78,67,145,
8655,961,90,55,145,
8656,982,67,53,120,
8657,997,74,49,123,
8658,1003,74,57,131,
8659,995,79,45,124,
8660,1023,85,61,146,
8661,1055,81,62,143,
8662,1056,81,52,133,
8663,1017,62,54,116,
8664,995,75,53,128,
8665,994,68,57,125,
8666,1000,58,72,130,
8667,1019,103,61,164,
8668,1034,64,66,130,
8669,1046,82,65,147,
8670,960,58,72,130,
8671,996,74,66,140,
8672,1002,75,54,129,
8673,1052,81,68,149,
8674,1064,79,51,130,
8675,977,82,60,142,
8676,1036,75,62,137,
8677,1018,85,64,149,
8678,1008,66,59,125,
8679,985,73,55,128,
8680,1016,73,79,152,
8681,973,76,60,136,
8682,1018,65,59,124,
8683,1010,74,70,144,
8684,989,72,50,122,
8685,1014,74,60,134,
8686,1026,89,56,145,
8687,1040,87,47,134,
8688,1043,61,63,124,
8689,951,71,48,119,
8690,1041,92,62,154,
8691,1037,60,48,108,
8692,973,83,60,143,
8693,1070,72,58,130,
8694,1046,70,65,135,
8695,1004,65,64,129,
8696,1038,57,56,113,
8697,982,66,59,125,
8698,1068,76,59,135,
8699,1023,75,59,134,
8700,1031,71,62,133,
8701,960,61,56,117,
8702,956,77,53,130,
8703,1022,78,53,131,
8704,1037,88,57,145,
8705,981,76,56,132,
8706,1037,77,48,125,
8707,980,60,55,115,
8708,1092,71,49,120,
8709,1051,93,66,159,
8710,988,71,59,130,
8711,1003,63,67,130,
8712,979,63,58,121,
8713,990,80,54,134,
8714,1010,63,58,121,
8715,1038,71,73,144,
8716,1021,69,44,113,
8717,1005,74,54,128,
8718,1043,83,66,149,
8719,980,75,48,123,
8720,997,72,60,132,
8721,1045,75,66,141,
8722,954,60,53,113,
8723,996,73,51,124,
8724,1001,59,61,120,
8725,1029,59,60,119,
8726,1011,80,59,139,
8727,990,76,55,131,
8728,988,82,63,145,
8729,1037,68,52,120,
8730,991,83,63,146,
8731,1017,77,50,127,
8732,1057,77,67,144,
8733,1012,70,65,135,
8734,1033,81,46,127,
8735,985,74,57,131,
8736,1077,71,67,138,
8737,979,63,55,118,
8738,1051,64,64,128,
8739,1016,70,49,119,
8740,1004,72,70,142,
8741,1027,83,60,143,
8742,980,63,54,117,
8743,1021,89,54,143,
8744,951,76,63,139,
8745,1029,71,57,128,
8746,1019,68,60,128,
8747,998,65,57,122,
8748,1020,72,60,132,
8749,1037,83,61,144,
8750,1028,62,65,127,
8751,1069,77,56,133,
8752,978,77,55,132,
8753,1017,72,60,132,
8754,986,60,53,113,
8755,992,57,56,113,
8756,999,81,52,133,
8757,1019,86,53,139,
8758,998,88,58,146,
8759,1048,65,64,129,
8760,1017,71,50,121,
8761,987,68,64,132,
8762,1091,89,66,155,
8763,985,74,62,136,
8764,1028,85,56,141,
8765,975,84,60,144,
8766,958,72,53,125,
8767,1041,72,75,147,
8768,1025,79,57,136,
8769,1034,61,39,100,
8770,1019,67,60,127,
8771,1000,71,52,123,
8772,957,55,60,115,
8773,969,79,55,134,
8774,948,60,66,126,
8775,982,62,51,113,
8776,1046,77,57,134,
8777,1007,64,60,124,
8778,942,56,64,120,
8779,1064,73,61,134,
8780,1022,77,50,127,
8781,1021,81,59,140,
8782,1007,75,48,123,
8783,1038,90,58,148,
8784,1047,91,66,157,
8785,1004,67,60,127,
8786,996,75,50,125,
8787,996,78,57,135,
8788,1008,85,63,148,
8789,987,71,77,148,
8790,1056,89,49,138,
8791,979,74,49,123,
8792,991,68,53,121,
8793,985,87,52,139,
8794,1004,64,64,128,
8795,985,76,62,138,
8796,991,76,62,138,
8797,988,78,57,135,
8798,970,65,44,109,
8799,1018,75,52,127,
8800,984,87,44,131,
8801,1012,70,69,139,
8802,1062,84,46,130,
8803,1022,77,52,129,
8804,1050,84,62,146,
8805,1000,68,65,133,
8806,975,76,62,138,
8807,981,79,59,138,
8808,1031,63,68,131,
8809,1076,89,67,156,
8810,1012,67,56,123,
8811,961,76,64,140,
8812,1073,75,71,146,
8813,1033,69,62,131,
8814,1025,74,48,122,
8815,1034,82,61,143,
8816,1072,76,55,131,
8817,1026,81,44,125,
8818,1048,81,62,143,
8819,1049,86,63,149,
8820,1064,92,53,145,
8821,1058,79,54,133,
8822,985,67,77,144,
8823,985,68,49,117,
8824,1080,74,62,136,
8825,1035,77,55,132,
8826,1000,65,51,116,
8827,1032,70,63,133,
8828,1009,84,48,132,
8829,996,60,49,109,
8830,951,79,40,119,
8831,982,66,53,119,
8832,1031,73,82,155,
8833,969,62,47,109,
8834,1035,63,54,117,
8835,1028,88,60,148,
8836,1016,70,52,122,
8837,1060,76,63,139,
8838,996,68,65,133,
8839,976,81,63,144,
8840,1082,85,58,143,
8841,1026,81,65,146,
8842,1014,63,69,132,
8843,996,93,47,140,
8844,1023,74,61,135,
8845,1001,77,59,136,
8846,1003,66,49,115,
8847,967,71,55,126,
8848,1031,77,67,144,
8849,991,74,55,129,
8850,1047,76,47,123,
8851,1031,72,59,131,
8852,1018,67,72,139,
8853,1041,76,56,132,
8854,1076,62,53,115,
8855,1005,72,61,133,
8856,1000,76,51,127,
8857,996,67,66,133,
8858,1020,83,48,131,
8859,1019,70,70,140,
8860,996,71,56,127,
8861,1044,97,68,165,
8862,1083,88,69,157,
8863,1029,65,47,112,
8864,1020,77,59,136,
8865,977,82,61,143,
8866,1056,64,59,123,
8867,1011,77,63,140,
8868,1013,79,57,136,
8869,1084,83,62,145,
8870,1075,85,66,151,
8871,990,76,58,134,
8872,994,88,62,150,
8873,1020,83,55,138,
8874,1139,87,63,150,
8875,991,78,44,122,
8876,988,61,51,112,
8877,1028,81,56,137,
8878,938,66,59,125,
8879,980,74,63,137,
8880,1009,85,57,142,
8881,1000,65,58,123,
8882,984,88,56,144,
8883,1063,83,71,154,
8884,1094,84,51,135,
8885,1027,77,54,131,
8886,1034,81,60,141,
8887,1011,62,55,117,
8888,1037,84,61,145,
8889,1033,68,83,151,
8890,1031,72,56,128,
8891,1032,58,58,116,
8892,987,68,61,129,
8893,975,73,56,129,
8894,1076,77,62,139,
8895,1029,71,57,128,
8896,990,63,51,114,
8897,1053,85,59,144,
8898,1120,68,73,141,
8899,1081,64,60,124,
8900,1055,69,62,131,
8901,1032,85,67,152,
8902,1052,91,54,145,
8903,1002,65,56,121,
8904,998,59,53,112,
8905,1043,82,47,129,
8906,1065,77,62,139,
8907,1036,65,59,124,
8908,1004,70,52,122,
8909,986,76,56,132,
8910,1062,84,70,154,
8911,1007,75,50,125,
8912,1030,73,74,147,
8913,1052,78,57,135,
8914,984,62,50,112,
8915,1039,77,51,128,
8916,1000,83,61,144,
8917,1120,86,55,141,
8918,983,78,49,127,
8919,1002,72,49,121,
8920,1015,63,52,115,
8921,994,71,66,137,
8922,1037,82,70,152,
8923,1039,68,71,139,
8924,1076,77,60,137,
8925,1011,83,61,144,
8926,989,62,73,135,
8927,1018,76,49,125,
8928,1015,72,65,137,
8929,1034,76,66,142,
8930,1023,74,76,150,
8931,982,72,61,133,
8932,1011,73,71,144,
8933,1009,74,56,130,
8934,1037,88,65,153,
8935,1020,62,50,112,
8936,1021,81,64,145,
8937,1020,81,62,143,
8938,1052,70,58,128,
8939,1066,84,67,151,
8940,1035,83,54,137,
8941,1100,73,88,161,
8942,1018,80,53,133,
8943,1019,85,47,132,
8944,1057,84,71,155,
8945,1065,77,57,134,
8946,1050,68,51,119,
8947,1015,77,62,139,
8948,1005,72,58,130,
8949,1000,68,61,129,
8950,1030,64,56,120,
8951,1016,60,68,128,
8952,992,65,51,116,
8953,972,67,57,124,
8954,1016,68,58,126,
8955,1019,78,43,121,
8956,1052,76,48,124,
8957,995,74,53,127,
8958,1028,74,49,123,
8959,1014,81,65,146,
8960,1032,63,52,115,
8961,1008,77,47,124,
8962,1023,75,67,142,
8963,972,71,54,125,
8964,1038,60,61,121,
8965,1080,75,60,135,
8966,993,74,56,130,
8967,1018,68,63,131,
8968,1047,63,60,123,
8969,1032,66,67,133,
8970,954,80,57,137,
8971,956,70,63,133,
8972,963,85,57,142,
8973,1018,51,66,117,
8974,1019,89,52,141,
8975,1056,77,69,146,
8976,1036,61,55,116,
8977,987,69,48,117,
8978,1076,77,63,140,
8979,971,74,51,125,
8980,991,77,49,126,
8981,982,86,55,141,
8982,1073,79,70,149,
8983,946,66,51,117,
8984,925,67,42,109,
8985,987,78,58,136,
8986,1087,94,62,156,
8987,1041,69,70,139,
8988,997,73,50,123,
8989,1053,81,60,141,
8990,998,74,47,121,
8991,1011,71,43,114,
8992,971,61,58,119,
8993,1015,70,61,131,
8994,1040,81,71,152,
8995,1010,89,62,151,
8996,1056,88,57,145,
8997,974,64,48,112,
8998,1037,69,73,142,
8999,1011,84,50,134,
9000,987,86,57,143,
9001,974,63,52,115,
9002,1051,65,68,133,
9003,1051,78,68,146,
9004,1054,72,64,136,
9005,1056,75,50,125,
9006,1005,67,54,121,
9007,993,75,70,145,
9008,1015,79,56,135,
9009,1091,80,56,136,
9010,1051,73,66,139,
9011,933,60,67,127,
9012,1010,80,55,135,
9013,1094,81,65,146,
9014,980,50,52,102,
9015,950,62,62,124,
9016,1029,98,59,157,
9017,1021,76,56,132,
9018,1000,80,67,147,
9019,1057,85,59,144,
9020,1033,80,56,136,
9021,1069,68,59,127,
9022,1022,65,51,116,
9023,1029,84,63,147,
9024,1016,70,71,141,
9025,1044,73,60,133,
9026,1050,66,54,120,
9027,1005,80,57,137,
9028,1003,87,55,142,
9029,953,59,54,113,
9030,999,75,57,132,
9031,979,65,47,112,
9032,1018,70,48,118,
9033,978,80,47,127,
9034,971,74,62,136,
9035,1100,72,60,132,
9036,1018,77,52,129,
9037,1022,59,56,115,
9038,1065,74,50,124,
9039,1034,74,61,135,
9040,1053,89,72,161,
9041,999,62,63,125,
9042,1023,67,55,122,
9043,1018,73,63,136,
9044,1040,88,62,150,
9045,1057,59,63,122,
9046,987,78,46,124,
9047,1015,87,67,154,
9048,1027,76,63,139,
9049,1029,74,55,129,
9050,1016,79,61,140,
9051,1027,72,52,124,
9052,1057,76,66,142,
9053,1005,64,48,112,
9054,986,93,63,156,
9055,993,70,58,128,
9056,988,81,52,133,
9057,1035,73,60,133,
9058,1049,85,56,141,
9059,1046,87,57,144,
9060,995,75,56,131,
9061,1011,72,73,145,
9062,982,70,59,129,
9063,1031,93,46,139,
9064,1050,69,67,136,
9065,1043,77,52,129,
9066,996,82,43,125,
9067,950,64,45,109,
9068,1052,87,63,150,
9069,975,69,52,121,
9070,1015,72,57,129,
9071,1035,83,58,141,
9072,987,71,65,136,
9073,1092,84,71,155,
9074,1020,77,75,152,
9075,985,70,39,109,
9076,1062,86,58,144,
9077,1041,92,50,142,
9078,1042,70,57,127,
9079,1009,69,62,131,
9080,1143,82,61,143,
9081,973,81,42,123,
9082,1027,80,67,147,
9083,1062,80,56,136,
9084,1055,80,65,145,
9085,1027,72,54,126,
9086,1024,81,55,136,
9087,1048,75,60,135,
9088,1020,66,57,123,
9089,969,78,67,145,
9090,1038,85,55,140,
9091,1082,75,58,133,
9092,1037,82,62,144,
9093,973,85,56,141,
9094,1071,64,65,129,
9095,1013,61,55,116,
9096,1002,68,58,126,
9097,1002,68,57,125,
9098,1041,86,52,138,
9099,1068,75,54,129,
9100,1000,85,59,144,
9101,994,76,58,134,
9102,987,63,62,125,
9103,951,67,65,132,
9104,993,77,59,136,
9105,986,73,60,133,
9106,988,92,55,147,
9107,1025,76,48,124,
9108,1052,75,67,142,
9109,1030,62,54,116,
9110,977,67,50,117,
9111,1028,73,58,131,
9112,955,76,48,124,
9113,999,80,35,115,
9114,1034,70,70,140,
9115,1000,71,58,129,
9116,1026,94,55,149,
9117,1014,62,56,118,
9118,1046,54,60,114,
9119,950,75,57,132,
9120,1014,76,58,134,
9121,1057,80,63,143,
9122,1030,77,54,131,
9123,1057,87,46,133,
9124,1010,65,50,115,
9125,1080,79,67,146,
9126,1053,69,61,130,
9127,1026,80,56,136,
9128,970,81,61,142,
9129,1032,70,54,124,
9130,1054,75,62,137,
9131,1027,84,60,144,
9132,1011,77,62,139,
9133,1042,75,65,140,
9134,972,72,47,119,
9135,1037,71,64,135,
9136,1074,77,54,131,
9137,981,73,58,131,
9138,1056,87,63,150,
9139,996,73,59,132,
9140,1018,51,80,131,
9141,1018,64,73,137,
9142,1026,76,69,145,
9143,1009,78,52,130,
9144,1019,78,51,129,
9145,976,73,57,130,
9146,1023,67,56,123,
9147,989,69,60,129,
9148,1067,71,78,149,
9149,1021,84,46,130,
9150,1101,80,71,151,
9151,986,68,56,124,
9152,1028,87,75,162,
9153,1001,85,63,148,
9154,1000,73,56,129,
9155,1019,75,54,129,
9156,1073,83,52,135,
9157,1062,71,49,120,
9158,1002,71,63,134,
9159,1080,76,53,129,
9160,1020,75,64,139,
9161,1048,75,56,131,
9162,1017,67,63,130,
9163,1074,67,57,124,
9164,988,71,62,133,
9165,1012,60,50,110,
9166,1028,67,73,140,
9167,1036,84,64,148,
9168,1050,73,51,124,
9169,1021,78,55,133,
9170,996,69,69,138,
9171,1043,77,49,126,
9172,1040,73,45,118,
9173,988,66,55,121,
9174,999,71,55,126,
9175,1043,74,55,129,
9176,990,63,47,110,
9177,1006,69,57,126,
9178,1007,73,54,127,
9179,994,80,42,122,
9180,1033,74,65,139,
9181,1072,85,50,135,
9182,1049,69,64,133,
9183,1007,81,58,139,
9184,966,61,54,115,
9185,1039,80,73,153,
9186,1018,74,55,129,
9187,1027,71,71,142,
9188,1082,95,59,154,
9189,1011,72,57,129,
9190,1031,81,72,153,
9191,984,76,63,139,
9192,986,77,55,132,
9193,976,72,46,118,
9194,1037,93,42,135,
9195,1027,74,44,118,
9196,1056,59,61,120,
9197,1028,83,55,138,
9198,1009,72,64,136,
9199,974,76,70,146,
9200,1055,71,63,134,
9201,986,80,68,148,
9202,1054,75,68,143,
9203,1053,84,69,153,
9204,1055,87,53,140,
9205,1017,64,62,126,
9206,955,69,54,123,
9207,938,68,42,110,
9208,955,65,52,117,
9209,1036,69,59,128,
9210,1007,75,53,128,
9211,1067,74,51,125,
9212,1042,67,68,135,
9213,1067,87,55,142,
9214,1039,75,65,140,
9215,1065,88,64,152,
9216,1015,63,62,125,
9217,961,74,59,133,
9218,1011,73,48,121,
9219,993,73,45,118,
9220,1038,60,48,108,
9221,976,74,47,121,
9222,992,78,64,142,
9223,991,72,48,120,
9224,1006,90,69,159,
9225,1070,86,63,149,
9226,1022,70,58,128,
9227,1036,95,54,149,
9228,1060,72,70,142,
9229,1013,65,52,117,
9230,979,54,70,124,
9231,1069,83,74,157,
9232,1020,70,59,129,
9233,1010,65,59,124,
9234,975,70,52,122,
9235,943,71,54,125,
9236,983,77,54,131,
9237,1027,65,61,126,
9238,1025,81,61,142,
9239,1032,68,76,144,
9240,1020,60,52,112,
9241,1012,61,54,115,
9242,983,75,40,115,
9243,1028,73,77,150,
9244,995,74,55,129,
9245,1009,74,64,138,
9246,1040,66,58,124,
9247,1001,86,51,137,
9248,1035,83,56,139,
9249,978,80,48,128,
9250,1037,80,65,145,
9251,1005,74,47,121,
9252,1030,79,66,145,
9253,1052,71,62,133,
9254,1049,82,61,143,
9255,1003,67,47,114,
9256,1070,73,61,134,
9257,1064,85,61,146,
9258,962,74,54,128,
9259,1027,73,58,131,
9260,1064,82,70,152,
9261,1054,75,61,136,
9262,1042,72,58,130,
9263,1018,68,61,129,
9264,1083,81,69,150,
9265,1010,81,58,139,
9266,1039,72,56,128,
9267,1042,83,66,149,
9268,1055,80,45,125,
9269,999,67,46,113,
9270,998,68,48,116,
9271,1030,70,56,126,
9272,1023,77,69,146,
9273,1035,73,48,121,
9274,1013,81,61,142,
9275,1004,64,67,131,
9276,989,82,52,134,
9277,1060,85,55,140,
9278,1012,68,59,127,
9279,1020,81,67,148,
9280,982,69,57,126,
9281,957,73,58,131,
9282,1009,59,61,120,
9283,1002,85,62,147,
9284,988,68,55,123,
9285,1011,76,51,127,
9286,1016,84,54,138,
9287,1026,69,67,136,
9288,1030,65,66,131,
9289,1019,65,61,126,
9290,1029,88,62,150,
9291,995,72,48,120,
9292,1000,64,57,121,
9293,985,61,52,113,
9294,1016,82,72,154,
9295,1050,77,57,134,
9296,1070,77,77,154,
9297,1015,86,74,160,
9298,1013,76,62,138,
9299,1054,81,51,132,
9300,1003,67,55,122,
9301,994,60,56,116,
9302,1044,85,64,149,
9303,1015,57,62,119,
9304,992,63,53,116,
9305,1005,65,59,124,
9306,1030,76,62,138,
9307,1027,81,64,145,
9308,1067,76,62,138,
9309,1058,79,60,139,
9310,1062,73,65,138,
9311,1029,69,69,138,
9312,1001,76,53,129,
9313,1013,68,57,125,
9314,1047,85,59,144,
9315,971,76,56,132,
9316,996,79,58,137,
9317,1019,79,53,132,
9318,992,76,57,133,
9319,1010,69,52,121,
9320,1077,65,50,115,
9321,1032,73,57,130,
9322,968,72,55,127,
9323,1034,87,56,143,
9324,1062,81,73,154,
9325,1026,74,62,136,
9326,1041,74,71,145,
9327,1015,77,61,138,
9328,1051,79,71,150,
9329,1000,85,73,158,
9330,1061,69,75,144,
9331,1048,77,68,145,
9332,1030,70,48,118,
9333,1020,87,46,133,
9334,1047,81,60,141,
9335,1067,66,57,123,
9336,1013,78,64,142,
9337,1071,88,69,157,
9338,1034,93,55,148,
9339,1010,69,69,138,
9340,964,72,54,126,
9341,1028,71,54,125,
9342,1072,63,45,108,
9343,996,62,62,124,
9344,1010,75,68,143,
9345,949,67,54,121,
9346,1009,74,58,132,
9347,994,77,62,139,
9348,1020,69,63,132,
9349,1008,69,68,137,
9350,988,82,54,136,
9351,987,72,56,128,
9352,1073,64,59,123,
9353,1079,76,61,137,
9354,1016,72,55,127,
9355,1013,85,60,145,
9356,1022,86,58,144,
9357,977,79,52,131,
9358,1043,73,60,133,
9359,1006,81,50,131,
9360,1108,86,73,159,
9361,1006,83,66,149,
9362,978,74,55,129,
9363,1010,95,58,153,
9364,944,84,52,136,
9365,976,73,71,144,
9366,998,72,54,126,
9367,963,66,56,122,
9368,1039,74,77,151,
9369,951,69,43,112,
9370,954,76,59,135,
9371,1045,68,52,120,
9372,1009,66,69,135,
9373,975,85,44,129,
9374,1056,70,62,132,
9375,1043,70,70,140,
9376,1013,68,58,126,
9377,943,74,50,124,
9378,1016,65,53,118,
9379,1069,82,55,137,
9380,960,58,46,104,
9381,1053,92,53,145,
9382,1008,71,52,123,
9383,1005,79,54,133,
9384,996,71,64,135,
9385,987,84,63,147,
9386,1062,68,55,123,
9387,938,75,52,127,
9388,1037,76,60,136,
9389,979,81,66,147,
9390,1049,58,72,130,
9391,997,78,63,141,
9392,994,72,54,126,
9393,1030,69,69,138,
9394,1056,71,52,123,
9395,982,64,53,117,
9396,1044,59,52,111,
9397,1057,67,60,127,
9398,981,61,58,119,
9399,1013,68,46,114,
9400,999,75,65,140,
9401,1013,70,59,129,
9402,947,56,49,105,
9403,1075,81,62,143,
9404,992,65,54,119,
9405,979,66,53,119,
9406,937,58,55,113,
9407,1011,72,48,120,
9408,990,77,55,132,
9409,981,78,64,142,
9410,998,74,60,134,
9411,1065,84,54,138,
9412,1057,72,61,133,
9413,1062,63,74,137,
9414,1030,74,65,139,
9415,994,52,55,107,
9416,1010,74,42,116,
9417,1055,74,57,131,
9418,949,56,65,121,
9419,979,64,54,118,
9420,1016,75,43,118,
9421,992,75,52,127,
9422,1014,84,58,142,
9423,1049,75,59,134,
9424,1015,78,65,143,
9425,1091,78,64,142,
9426,1025,70,68,138,
9427,968,80,53,133,
9428,1033,74,75,149,
9429,1034,78,64,142,
9430,1008,85,58,143,
9431,1095,72,81,153,
9432,1040,68,61,129,
9433,1091,66,58,124,
9434,982,74,57,131,
9435,996,66,62,128,
9436,1055,82,57,139,
9437,1039,61,65,126,
9438,1001,71,44,115,
9439,1041,53,53,106,
9440,1003,63,65,128,
9441,980,60,37,97,
9442,971,77,60,137,
9443,966,78,46,124,
9444,988,62,54,116,
9445,983,85,57,142,
9446,982,60,46,106,
9447,1062,92,61,153,
9448,1039,76,49,125,
9449,1061,82,50,132,
9450,1021,83,67,150,
9451,1074,86,51,137,
9452,965,64,47,111,
9453,1037,74,49,123,
9454,1019,68,53,121,
9455,997,80,51,131,
9456,1012,77,59,136,
9457,1057,85,75,160,
9458,1005,69,57,126,
9459,989,79,76,155,
9460,1080,81,57,138,
9461,1021,83,60,143,
9462,975,65,57,122,
9463,1010,68,68,136,
9464,998,76,56,132,
9465,1052,72,64,136,
9466,1016,81,52,133,
9467,1044,78,52,130,
9468,998,52,50,102,
9469,1009,69,64,133,
9470,1013,78,59,137,
9471,1012,65,63,128,
9472,989,76,58,134,
9473,1012,74,60,134,
9474,1085,89,52,141,
9475,1022,95,67,162,
9476,1027,73,41,114,
9477,1014,82,61,143,
9478,929,66,60,126,
9479,1009,77,51,128,
9480,987,67,62,129,
9481,997,82,44,126,
9482,1044,79,58,137,
9483,1008,74,50,124,
9484,1044,77,61,138,
9485,1057,92,58,150,
9486,1048,85,58,143,
9487,1057,83,66,149,
9488,967,64,52,116,
9489,1043,74,71,145,
9490,977,78,55,133,
9491,1029,79,64,143,
9492,1052,78,69,147,
9493,972,90,58,148,
9494,1032,85,53,138,
9495,977,77,54,131,
9496,992,70,62,132,
9497,1081,80,57,137,
9498,1055,77,52,129,
9499,1077,78,68,146,
9500,1038,84,59,143,
9501,985,82,50,132,
9502,1016,70,68,138,
9503,994,66,54,120,
9504,995,75,57,132,
9505,1001,72,60,132,
9506,1036,84,64,148,
9507,975,70,50,120,
9508,1005,79,56,135,
9509,987,64,61,125,
9510,1048,91,60,151,
9511,1083,88,57,145,
9512,1066,74,73,147,
9513,1059,64,73,137,
9514,1030,82,60,142,
9515,1035,81,52,133,
9516,1014,73,84,157,
9517,1007,68,62,130,
9518,1066,67,71,138,
9519,1099,82,70,152,
9520,1024,77,58,135,
9521,1028,81,51,132,
9522,976,66,67,133,
9523,1037,86,62,148,
9524,985,61,47,108,
9525,1066,77,62,139,
9526,1045,98,61,159,
9527,1067,80,54,134,
9528,1008,77,59,136,
9529,999,75,50,125,
9530,1058,79,64,143,
9531,1010,72,61,133,
9532,1114,91,73,164,
9533,1036,72,45,117,
9534,1033,70,56,126,
9535,995,77,49,126,
9536,1005,84,48,132,
9537,1066,87,58,145,
9538,1039,92,58,150,
9539,1035,62,49,111,
9540,1044,66,46,112,
9541,1068,79,44,123,
9542,1027,64,57,121,
9543,998,63,59,122,
9544,1020,72,59,131,
9545,1044,62,55,117,
9546,1001,83,54,137,
9547,980,79,49,128,
9548,967,73,55,128,
9549,967,80,44,124,
9550,1088,72,79,151,
9551,1053,74,64,138,
9552,1052,86,51,137,
9553,1013,75,53,128,
9554,967,85,59,144,
9555,1031,78,56,134,
9556,1037,72,64,136,
9557,1038,77,61,138,
9558,1016,93,56,149,
9559,1015,75,41,116,
9560,1023,77,52,129,
9561,1043,80,62,142,
9562,1111,66,59,125,
9563,1045,88,54,142,
9564,1049,75,65,140,
9565,1052,73,57,130,
9566,1045,89,56,145,
9567,991,89,50,139,
9568,938,73,58,131,
9569,985,62,55,117,
9570,999,66,72,138,
9571,992,82,58,140,
9572,1022,84,51,135,
9573,1031,70,66,136,
9574,1079,100,65,165,
9575,1050,75,55,130,
9576,934,71,55,126,
9577,1048,68,60,128,
9578,965,77,60,137,
9579,1047,82,67,149,
9580,1007,75,61,136,
9581,1021,66,70,136,
9582,1008,80,58,138,
9583,986,57,61,118,
9584,1012,71,60,131,
9585,951,74,72,146,
9586,1062,62,63,125,
9587,1022,79,64,143,
9588,1052,74,51,125,
9589,1068,75,40,115,
9590,992,66,71,137,
9591,1015,69,48,117,
9592,990,65,52,117,
9593,1040,61,68,129,
9594,1044,71,47,118,
9595,1000,81,53,134,
9596,1044,89,55,144,
9597,1002,73,51,124,
9598,1035,69,61,130,
9599,1039,70,62,132,
9600,1033,75,67,142,
9601,988,70,57,127,
9602,1084,85,55,140,
9603,1049,62,53,115,
9604,1067,79,54,133,
9605,1002,81,49,130,
9606,984,80,59,139,
9607,1020,62,47,109,
9608,1045,102,50,152,
9609,985,65,62,127,
9610,983,74,53,127,
9611,1014,73,73,146,
9612,964,66,50,116,
9613,1027,79,40,119,
9614,1051,70,57,127,
9615,993,69,63,132,
9616,978,65,56,121,
9617,1074,91,49,140,
9618,1019,71,44,115,
9619,964,64,71,135,
9620,1046,68,58,126,
9621,1013,64,62,126,
9622,1074,81,61,142,
9623,1081,88,62,150,
9624,990,84,59,143,
9625,938,75,54,129,
9626,1058,85,56,141,
9627,1018,77,65,142,
9628,979,91,49,140,
9629,991,76,55,131,
9630,954,54,55,109,
9631,1068,93,69,162,
9632,1021,79,60,139,
9633,1015,74,52,126,
9634,1051,64,61,125,
9635,1046,84,59,143,
9636,1036,82,63,145,
9637,1068,67,68,135,
9638,1005,75,65,140,
9639,950,84,52,136,
9640,1066,77,57,134,
9641,923,57,55,112,
9642,1030,72,69,141,
9643,1007,65,62,127,
9644,1013,60,68,128,
9645,1038,71,58,129,
9646,1054,90,72,162,
9647,1046,84,54,138,
9648,1010,76,56,132,
9649,1071,84,65,149,
9650,1028,83,71,154,
9651,1027,69,67,136,
9652,1009,83,71,154,
9653,992,76,60,136,
9654,967,59,58,117,
9655,1014,76,52,128,
9656,1029,66,61,127,
9657,1040,83,64,147,
9658,1035,90,62,152,
9659,1040,71,65,136,
9660,1029,90,53,143,
9661,1054,70,58,128,
9662,1047,73,34,107,
9663,1012,74,59,133,
9664,988,77,54,131,
9665,1049,57,62,119,
9666,991,76,57,133,
9667,998,78,46,124,
9668,1042,86,62,148,
9669,1037,61,55,116,
9670,1038,68,65,133,
9671,1046,73,61,134,
9672,994,86,59,145,
9673,1075,89,56,145,
9674,1032,70,51,121,
9675,1055,78,57,135,
9676,1003,72,38,110,
9677,1006,81,56,137,
9678,967,72,49,121,
9679,1028,73,48,121,
9680,911,59,36,95,
9681,1058,82,85,167,
9682,1015,65,62,127,
9683,1021,63,52,115,
9684,986,78,47,125,
9685,1031,87,56,143,
9686,1005,97,46,143,
9687,995,81,66,147,
9688,960,60,61,121,
9689,1025,71,44,115,
9690,1051,77,56,133,
9691,1051,72,54,126,
9692,1033,69,63,132,
9693,991,83,56,139,
9694,1051,70,56,126,
9695,1002,71,55,126,
9696,1072,82,66,148,
9697,963,70,48,118,
9698,1026,69,72,141,
9699,1022,91,49,140,
9700,1065,66,71,137,
9701,971,59,63,122,
9702,998,60,52,112,
9703,948,79,50,129,
9704,992,73,55,128,
9705,1047,79,69,148,
9706,1013,75,64,139,
9707,984,81,66,147,
9708,982,70,52,122,
9709,999,77,60,137,
9710,969,82,56,138,
9711,1019,76,53,129,
9712,1001,67,68,135,
9713,1020,70,59,129,
9714,1025,72,52,124,
9715,1103,71,48,119,
9716,1019,76,52,128,
9717,1028,78,60,138,
9718,966,76,61,137,
9719,1036,74,63,137,
9720,1008,76,57,133,
9721,1023,79,55,134,
9722,1036,72,62,134,
9723,971,75,52,127,
9724,967,73,59,132,
9725,1029,79,64,143,
9726,1064,83,69,152,
9727,1044,81,50,131,
9728,1048,77,55,132,
9729,1045,70,58,128,
9730,1044,64,68,132,
9731,942,62,68,130,
9732,1009,64,65,129,
9733,979,78,49,127,
9734,1013,72,50,122,
9735,1045,82,62,144,
9736,1023,81,69,150,
9737,954,65,47,112,
9738,988,69,56,125,
9739,967,65,45,110,
9740,1090,68,61,129,
9741,1008,71,45,116,
9742,1031,78,59,137,
9743,1001,64,56,120,
9744,1010,73,63,136,
9745,981,73,56,129,
9746,1051,81,57,138,
9747,958,71,59,130,
9748,1003,71,64,135,
9749,956,69,69,138,
9750,1014,88,53,141,
9751,1039,73,51,124,
9752,1014,73,60,133,
9753,1032,81,68,149,
9754,1046,57,61,118,
9755,993,69,61,130,
9756,1069,74,76,150,
9757,974,62,62,124,
9758,1013,69,57,126,
9759,965,64,48,112,
9760,974,77,55,132,
9761,1031,78,51,129,
9762,967,65,67,132,
9763,1021,74,63,137,
9764,1065,70,57,127,
9765,1028,73,61,134,
9766,979,60,54,114,
9767,1063,76,53,129,
9768,941,77,57,134,
9769,1008,73,68,141,
9770,1004,58,47,105,
9771,1012,66,63,129,
9772,1034,63,62,125,
9773,962,68,51,119,
9774,1023,67,49,116,
9775,1033,78,62,140,
9776,1023,69,61,130,
9777,991,80,54,134,
9778,1045,76,64,140,
9779,1043,75,61,136,
9780,1012,84,55,139,
9781,1126,79,47,126,
9782,1006,71,49,120,
9783,1003,71,55,126,
9784,1019,72,58,130,
9785,957,64,49,113,
9786,1003,74,55,129,
9787,1014,76,50,126,
9788,985,76,60,136,
9789,970,70,61,131,
9790,1033,75,53,128,
9791,1021,91,62,153,
9792,1007,71,67,138,
9793,1039,80,74,154,
9794,1037,83,60,143,
9795,991,75,51,126,
9796,1013,76,53,129,
9797,1015,78,55,133,
9798,1038,71,67,138,
9799,955,58,47,105,
9800,1032,75,70,145,
9801,1012,79,53,132,
9802,994,67,61,128,
9803,1017,73,52,125,
9804,1006,78,54,132,
9805,1036,93,58,151,
9806,1048,85,65,150,
9807,1065,72,56,128,
9808,1004,81,68,149,
9809,994,58,56,114,
9810,1072,69,59,128,
9811,1025,62,45,107,
9812,1003,81,64,145,
9813,1001,66,57,123,
9814,1027,69,61,130,
9815,985,77,54,131,
9816,1038,68,49,117,
9817,1050,73,48,121,
9818,997,72,59,131,
9819,1006,73,69,142,
9820,968,72,47,119,
9821,973,70,62,132,
9822,1022,70,58,128,
9823,995,62,52,114,
9824,1058,75,65,140,
9825,990,81,55,136,
9826,1000,90,45,135,
9827,1046,68,58,126,
9828,997,67,53,120,
9829,1025,74,55,129,
9830,996,75,43,118,
9831,965,62,60,122,
9832,973,64,56,120,
9833,1016,70,58,128,
9834,1004,63,59,122,
9835,1043,76,59,135,
9836,1003,86,51,137,
9837,1030,77,55,132,
9838,1018,79,60,139,
9839,952,68,59,127,
9840,1016,63,70,133,
9841,1004,84,59,143,
9842,1036,86,57,143,
9843,1025,73,53,126,
9844,1083,79,73,152,
9845,994,70,56,126,
9846,949,55,41,96,
9847,1017,74,56,130,
9848,972,64,55,119,
9849,1052,73,50,123,
9850,1071,81,74,155,
9851,945,71,41,112,
9852,995,63,51,114,
9853,1014,66,59,125,
9854,1018,74,50,124,
9855,1023,86,47,133,
9856,1035,78,52,130,
9857,1023,76,70,146,
9858,1017,65,62,127,
9859,1012,82,76,158,
9860,977,83,62,145,
9861,959,86,52,138,
9862,1072,92,72,164,
9863,995,66,44,110,
9864,1015,78,45,123,
9865,1068,74,67,141,
9866,1032,75,58,133,
9867,1026,68,61,129,
9868,1042,64,55,119,
9869,1026,71,60,131,
9870,1043,81,64,145,
9871,1028,76,61,137,
9872,974,68,60,128,
9873,1031,78,56,134,
9874,1018,85,51,136,
9875,1054,78,57,135,
9876,1037,82,53,135,
9877,1052,74,50,124,
9878,1046,71,60,131,
9879,1033,64,65,129,
9880,975,78,50,128,
9881,1033,63,67,130,
9882,1004,62,52,114,
9883,1019,71,39,110,
9884,1012,76,63,139,
9885,1044,86,54,140,
9886,1017,58,52,110,
9887,993,73,74,147,
9888,1055,77,56,133,
9889,1040,68,62,130,
9890,982,69,57,126,
9891,1023,62,55,117,
9892,1042,74,44,118,
9893,1008,57,66,123,
9894,1049,74,69,143,
9895,968,68,56,124,
9896,1012,72,50,122,
9897,1042,68,67,135,
9898,1062,62,63,125,
9899,967,62,53,115,
9900,991,58,52,110,
9901,1039,66,51,117,
9902,1002,66,59,125,
9903,1079,82,61,143,
9904,1088,90,63,153,
9905,1022,76,58,134,
9906,1029,71,54,125,
9907,1021,60,52,112,
9908,1049,65,67,132,
9909,1046,84,61,145,
9910,1058,85,62,147,
9911,1092,75,54,129,
9912,1017,75,57,132,
9913,1011,82,62,144,
9914,995,66,52,118,
9915,924,69,54,123,
9916,1036,79,70,149,
9917,977,72,52,124,
9918,980,70,43,113,
9919,1005,51,50,101,
9920,962,81,45,126,
9921,967,72,64,136,
9922,1025,64,57,121,
9923,1012,69,64,133,
9924,948,80,54,134,
9925,1031,64,57,121,
9926,1003,74,59,133,
9927,1014,77,60,137,
9928,1016,63,46,109,
9929,1062,72,57,129,
9930,990,74,48,122,
9931,1019,75,49,124,
9932,1032,67,59,126,
9933,987,75,37,112,
9934,1066,62,68,130,
9935,1039,66,50,116,
9936,1070,99,59,158,
9937,1037,71,55,126,
9938,1006,63,55,118,
9939,995,65,65,130,
9940,1001,68,52,120,
9941,1019,78,60,138,
9942,1012,80,52,132,
9943,1058,69,52,121,
9944,991,83,53,136,
9945,1052,63,63,126,
9946,1038,73,51,124,
9947,1036,74,56,130,
9948,1064,72,67,139,
9949,1061,90,53,143,
9950,1042,74,65,139,
9951,1030,69,67,136,
9952,1040,75,56,131,
9953,986,73,53,126,
9954,1016,73,55,128,
9955,1015,64,60,124,
9956,1009,75,38,113,
9957,1029,80,52,132,
9958,1051,70,58,128,
9959,1021,68,70,138,
9960,1017,65,58,123,
9961,949,82,55,137,
9962,1022,72,54,126,
9963,1037,80,54,134,
9964,965,68,62,130,
9965,1039,78,57,135,
9966,1019,55,63,118,
9967,1016,72,68,140,
9968,1026,84,58,142,
9969,1015,79,67,146,
9970,1084,94,71,165,
9971,1022,73,57,130,
9972,1048,66,54,120,
9973,1059,85,57,142,
9974,1050,73,55,128,
9975,1048,80,61,141,
9976,963,60,55,115,
9977,987,76,60,136,
9978,1031,63,81,144,
9979,971,70,57,127,
9980,1001,77,51,128,
9981,1022,75,60,135,
9982,1076,85,70,155,
9983,1053,68,52,120,
9984,990,69,63,132,
9985,997,77,46,123,
9986,1036,95,56,151,
9987,1071,64,70,134,
9988,1013,67,52,119,
9989,1080,68,53,121,
9990,1008,84,57,141,
9991,1021,78,57,135,
9992,1024,69,64,133,
9993,958,70,63,133,
9994,974,56,46,102,
9995,1065,83,42,125,
9996,1031,76,53,129,
9997,1007,80,60,140,
9998,1087,67,60,127,
9999,994,76,59,135,
