eventID,numPhotons,numReachedDown,numReachedUp,numPE,
0,1995,160,104,264,
1,2003,146,138,284,
2,1969,128,95,223,
3,2015,138,134,272,
4,2102,135,124,259,
5,1940,142,101,243,
6,2026,162,106,268,
7,1993,130,121,251,
8,1976,144,122,266,
9,1958,124,89,213,
10,2001,138,134,272,
11,1986,148,90,238,
12,2047,151,123,274,
13,1957,125,112,237,
14,2002,146,122,268,
15,1919,149,114,263,
16,2022,143,144,287,
17,1915,145,99,244,
18,1933,126,96,222,
19,2016,136,103,239,
20,1966,147,113,260,
21,2009,155,125,280,
22,1921,141,99,240,
23,1989,150,125,275,
24,1884,138,111,249,
25,1879,153,111,264,
26,1964,141,103,244,
27,1929,166,110,276,
28,2021,142,109,251,
29,2068,145,108,253,
30,2024,134,128,262,
31,2009,145,130,275,
32,1995,153,111,264,
33,2022,149,112,261,
34,2005,147,128,275,
35,2010,142,119,261,
36,2039,136,131,267,
37,1939,124,104,228,
38,1990,143,115,258,
39,1970,121,120,241,
40,1918,140,96,236,
41,2022,149,127,276,
42,1999,135,111,246,
43,2020,141,115,256,
44,1965,142,116,258,
45,1977,153,107,260,
46,1928,137,115,252,
47,1958,151,120,271,
48,1882,116,87,203,
49,1995,126,118,244,
50,1988,169,96,265,
51,2009,153,114,267,
52,1970,152,108,260,
53,1990,161,98,259,
54,1976,142,110,252,
55,1977,133,117,250,
56,1930,138,113,251,
57,1956,139,116,255,
58,1949,134,117,251,
59,2031,134,113,247,
60,1938,126,99,225,
61,1962,136,99,235,
62,1964,141,124,265,
63,2011,126,117,243,
64,2053,131,96,227,
65,2029,141,117,258,
66,1985,148,110,258,
67,1920,146,119,265,
68,1999,132,111,243,
69,1981,118,106,224,
70,1932,147,119,266,
71,1998,147,116,263,
72,1996,138,100,238,
73,1929,152,99,251,
74,1999,155,118,273,
75,1973,168,95,263,
76,1949,153,116,269,
77,1908,150,114,264,
78,1895,137,126,263,
80,1923,120,121,241,
81,2018,153,127,280,
82,1959,135,123,258,
83,1961,140,110,250,
84,1999,151,131,282,
85,1937,147,101,248,
86,1987,142,119,261,
87,2001,159,99,258,
88,2007,142,114,256,
89,2024,150,111,261,
90,1980,135,125,260,
91,1928,150,108,258,
92,1945,140,109,249,
93,1966,137,112,249,
94,1942,124,106,230,
95,1973,141,103,244,
96,1981,127,130,257,
97,1923,134,112,246,
98,1977,130,114,244,
99,1943,162,128,290,
100,2047,156,106,262,
101,1940,126,118,244,
102,2021,142,129,271,
103,1924,141,108,249,
104,1970,127,110,237,
105,1994,149,107,256,
106,1995,152,128,280,
107,1983,137,118,255,
108,1944,178,107,285,
109,1918,138,115,253,
110,1932,136,120,256,
111,1939,152,92,244,
112,1968,125,126,251,
113,1876,127,89,216,
114,1979,139,113,252,
115,1934,128,104,232,
116,1982,179,118,297,
117,1994,161,92,253,
118,1971,137,112,249,
119,1983,148,106,254,
120,2016,154,104,258,
121,1971,135,111,246,
122,2035,120,129,249,
123,1929,126,114,240,
124,2001,148,122,270,
125,1918,154,120,274,
126,2033,146,122,268,
127,1986,134,104,238,
128,1990,124,101,225,
129,1977,172,98,270,
130,2034,141,132,273,
131,1901,149,111,260,
132,1985,133,111,244,
133,2038,143,122,265,
134,1930,138,124,262,
135,1943,158,97,255,
136,1964,135,112,247,
137,1929,141,106,247,
138,1927,131,123,254,
139,1970,135,127,262,
140,1910,143,102,245,
141,1978,134,113,247,
142,1867,119,90,209,
143,1979,151,102,253,
144,1878,138,105,243,
145,2059,141,107,248,
146,2021,155,111,266,
147,1974,155,120,275,
148,1953,157,127,284,
149,1975,130,109,239,
150,1937,128,104,232,
151,1906,158,109,267,
152,2014,152,106,258,
153,1998,134,95,229,
154,2062,152,110,262,
155,1908,166,97,263,
156,1909,131,90,221,
157,2023,160,116,276,
158,1900,131,106,237,
159,1903,152,107,259,
160,1980,137,112,249,
161,1951,154,111,265,
162,1935,131,109,240,
163,1948,123,123,246,
164,1921,131,122,253,
165,1995,131,107,238,
166,1988,144,102,246,
167,1929,133,113,246,
168,2000,165,122,287,
169,1918,147,116,263,
170,1899,144,109,253,
171,2008,160,111,271,
172,2028,139,113,252,
173,1907,120,105,225,
174,2018,146,106,252,
175,1946,117,108,225,
176,1961,123,100,223,
177,1910,142,105,247,
178,2036,137,95,232,
179,1976,127,118,245,
180,1876,142,95,237,
181,1944,128,103,231,
182,1931,121,129,250,
183,2022,130,109,239,
184,2026,149,114,263,
185,1986,157,128,285,
186,1968,147,119,266,
187,1847,134,95,229,
188,1946,126,103,229,
189,1940,143,133,276,
190,1999,138,109,247,
191,1947,130,118,248,
192,1973,150,116,266,
193,1932,154,102,256,
194,1982,143,101,244,
195,2029,169,127,296,
196,1969,124,112,236,
197,1971,137,138,275,
198,1990,155,112,267,
199,1988,146,122,268,
200,1976,166,110,276,
201,1983,133,100,233,
202,1898,111,123,234,
203,2001,141,96,237,
204,2040,135,141,276,
205,1967,146,118,264,
206,2004,140,125,265,
207,1994,171,88,259,
208,1975,133,114,247,
209,1905,134,88,222,
210,1919,150,128,278,
211,1938,166,104,270,
212,1983,140,120,260,
213,1937,128,93,221,
214,1988,147,134,281,
215,1925,136,114,250,
216,1959,156,103,259,
217,1871,134,93,227,
218,1940,128,110,238,
219,2010,154,120,274,
220,1919,143,114,257,
221,1927,157,97,254,
222,2021,158,118,276,
223,1915,143,114,257,
224,1919,135,122,257,
225,1974,148,116,264,
226,1930,124,102,226,
227,1955,142,106,248,
228,1873,111,117,228,
229,1969,139,109,248,
230,1985,134,103,237,
231,1941,150,99,249,
232,1819,132,93,225,
233,1962,146,124,270,
234,1864,118,103,221,
235,1991,132,99,231,
236,2011,132,108,240,
237,1934,138,91,229,
238,1953,147,116,263,
239,2012,138,107,245,
240,1983,143,118,261,
241,2006,146,96,242,
242,2014,124,109,233,
243,1899,129,94,223,
244,2030,158,129,287,
245,1966,147,112,259,
246,1938,148,116,264,
247,1945,129,119,248,
248,1933,112,110,222,
249,1961,160,130,290,
250,1965,140,139,279,
251,1911,129,110,239,
252,2010,133,114,247,
253,1970,153,104,257,
254,2019,152,107,259,
255,1995,155,116,271,
256,2078,141,105,246,
257,1910,143,97,240,
258,1890,159,90,249,
259,1891,127,92,219,
260,1993,156,127,283,
261,1953,137,99,236,
262,1941,138,104,242,
263,1989,150,138,288,
264,1976,130,124,254,
265,1952,139,119,258,
266,1903,139,127,266,
267,1886,132,109,241,
268,2034,144,123,267,
269,1945,147,99,246,
270,1973,146,102,248,
271,2023,138,116,254,
272,1933,130,119,249,
273,1867,134,107,241,
274,1929,124,91,215,
275,1935,129,123,252,
276,1937,152,104,256,
277,1856,129,117,246,
278,1954,133,102,235,
279,1981,161,113,274,
280,1962,132,106,238,
281,2052,149,100,249,
282,2029,141,111,252,
283,1969,122,110,232,
284,1968,148,125,273,
285,1995,170,101,271,
286,2051,152,106,258,
287,1963,129,123,252,
288,1944,141,87,228,
289,2016,158,121,279,
290,1959,163,120,283,
291,1974,142,117,259,
292,1999,130,107,237,
293,2022,150,133,283,
294,1975,135,117,252,
295,1980,139,106,245,
296,1991,172,99,271,
297,1968,152,107,259,
298,1978,162,115,277,
299,1986,145,109,254,
300,1961,140,113,253,
301,1946,145,112,257,
302,2012,137,129,266,
303,1949,143,99,242,
304,1930,139,114,253,
305,1965,156,111,267,
306,2003,134,108,242,
307,1949,134,104,238,
308,2107,135,109,244,
309,1870,139,98,237,
310,1970,135,124,259,
311,1951,146,90,236,
312,1982,144,120,264,
313,1981,132,95,227,
314,1997,149,119,268,
315,2063,155,131,286,
316,1905,152,102,254,
317,2011,161,103,264,
318,1884,129,119,248,
319,1930,155,118,273,
320,1981,137,123,260,
321,1948,145,110,255,
322,1915,142,101,243,
323,1895,141,122,263,
324,1985,136,120,256,
325,2003,136,108,244,
326,1935,150,112,262,
327,2030,149,112,261,
328,2012,146,105,251,
329,2033,123,128,251,
330,1933,163,117,280,
331,1929,145,115,260,
332,1993,171,103,274,
333,1876,119,101,220,
334,2000,130,110,240,
335,1949,124,98,222,
336,1897,135,136,271,
337,2074,138,144,282,
338,1892,131,117,248,
339,1975,155,121,276,
340,2008,155,116,271,
341,2031,154,123,277,
342,1982,136,127,263,
343,1926,135,127,262,
344,1952,144,105,249,
345,1908,129,120,249,
346,1942,150,130,280,
347,1934,121,107,228,
348,2019,138,104,242,
349,1973,157,115,272,
350,2001,153,124,277,
351,2050,146,133,279,
352,1996,139,98,237,
353,1976,137,106,243,
354,2074,149,109,258,
355,1965,145,125,270,
356,1944,141,131,272,
357,1988,146,117,263,
358,1947,144,103,247,
359,1872,127,107,234,
360,1873,139,104,243,
361,1921,134,109,243,
362,1953,159,131,290,
363,1961,139,103,242,
364,1901,134,122,256,
365,1901,131,113,244,
366,1962,154,105,259,
367,2008,141,102,243,
368,1876,142,99,241,
369,1978,117,121,238,
370,2001,155,100,255,
371,1925,148,97,245,
372,1907,135,92,227,
373,1955,144,114,258,
374,1906,128,102,230,
375,1998,162,106,268,
376,1995,146,127,273,
377,1903,153,122,275,
378,2053,143,129,272,
379,1918,151,100,251,
380,2023,139,117,256,
381,1962,140,97,237,
382,1950,138,108,246,
383,2013,169,119,288,
384,2000,143,112,255,
385,1893,148,108,256,
386,1947,134,113,247,
387,1979,128,135,263,
388,2015,152,126,278,
389,1935,122,99,221,
390,1986,158,113,271,
391,2020,140,113,253,
392,1974,147,120,267,
394,1933,161,104,265,
395,1976,147,113,260,
396,1996,144,114,258,
397,1880,138,103,241,
398,1936,118,123,241,
399,1917,135,100,235,
400,1956,137,122,259,
401,1903,143,97,240,
402,2038,152,121,273,
403,1947,164,113,277,
404,2036,158,110,268,
405,2048,151,117,268,
406,1939,123,105,228,
407,1963,138,113,251,
408,1975,153,100,253,
409,1978,157,105,262,
410,1967,133,126,259,
411,1940,156,123,279,
412,1956,159,133,292,
413,1852,161,103,264,
414,1943,156,104,260,
415,2015,129,110,239,
416,1907,136,106,242,
417,1980,126,109,235,
418,1973,142,126,268,
419,1920,139,121,260,
420,2019,152,118,270,
421,1911,149,117,266,
422,1923,143,105,248,
423,1938,135,121,256,
424,1939,151,135,286,
425,1895,132,107,239,
426,1936,141,106,247,
427,2049,157,104,261,
428,1880,137,109,246,
429,1990,148,100,248,
430,1995,152,105,257,
431,1984,137,128,265,
432,1999,132,123,255,
433,1997,161,110,271,
434,1963,136,130,266,
435,1924,145,121,266,
436,2033,154,115,269,
437,2017,141,119,260,
438,1933,150,107,257,
439,1905,120,108,228,
440,1953,167,120,287,
441,1937,123,124,247,
442,2014,147,106,253,
443,1969,156,105,261,
444,2036,167,112,279,
445,1980,134,114,248,
446,1919,115,109,224,
447,1839,131,101,232,
448,1966,136,108,244,
449,2014,164,105,269,
450,1952,121,117,238,
451,1984,161,106,267,
452,1912,141,111,252,
453,1990,154,97,251,
454,1937,140,116,256,
455,1972,142,123,265,
456,1959,145,107,252,
457,1916,124,111,235,
458,2001,132,116,248,
459,1928,139,109,248,
460,1969,151,98,249,
461,1926,143,109,252,
462,1960,148,88,236,
463,1977,165,114,279,
464,1920,140,115,255,
465,1908,120,120,240,
466,1985,144,111,255,
467,1889,137,125,262,
468,1983,134,104,238,
469,1947,125,128,253,
470,1858,134,121,255,
471,1892,133,100,233,
472,1928,135,116,251,
473,2063,144,124,268,
474,1999,127,111,238,
475,1876,134,105,239,
476,1939,141,124,265,
477,2001,152,117,269,
478,1935,128,102,230,
479,1961,118,99,217,
480,1975,138,128,266,
481,2005,142,103,245,
482,1952,155,93,248,
483,2009,148,109,257,
484,1878,141,122,263,
485,1947,139,85,224,
486,1935,141,111,252,
487,1919,140,96,236,
488,2010,128,105,233,
489,2006,149,108,257,
490,1992,147,115,262,
491,2031,152,104,256,
492,1946,147,114,261,
493,2000,150,108,258,
494,2017,132,130,262,
495,2013,151,102,253,
496,2041,169,123,292,
497,1987,151,122,273,
498,1936,131,103,234,
499,2070,151,106,257,
500,1920,136,131,267,
501,2001,138,106,244,
502,2009,172,102,274,
503,1957,132,109,241,
504,1957,135,118,253,
505,1980,116,105,221,
506,1935,139,89,228,
507,1993,143,102,245,
508,1977,152,106,258,
509,2019,167,105,272,
510,2029,142,125,267,
511,1984,143,99,242,
512,1973,145,117,262,
513,1887,159,95,254,
514,1937,127,122,249,
515,1913,121,115,236,
516,2047,133,134,267,
517,1947,145,100,245,
518,1902,143,109,252,
519,1916,150,99,249,
520,1967,132,106,238,
521,2006,142,107,249,
522,1969,133,117,250,
523,1863,120,100,220,
524,2092,145,126,271,
525,1975,128,119,247,
526,1960,147,105,252,
527,2065,139,111,250,
528,1925,157,110,267,
529,1944,150,125,275,
530,1985,136,125,261,
531,2004,123,104,227,
532,2020,159,109,268,
533,1975,125,127,252,
534,1940,138,112,250,
535,2001,163,108,271,
536,2047,135,131,266,
538,1964,128,131,259,
539,2024,138,124,262,
540,1905,130,118,248,
541,2032,152,121,273,
542,1982,169,108,277,
543,1988,142,104,246,
544,2034,135,116,251,
545,2029,135,131,266,
546,1972,140,109,249,
547,1936,133,116,249,
548,1955,136,117,253,
549,2003,131,127,258,
550,1978,159,113,272,
551,1929,142,117,259,
552,2037,167,127,294,
553,1946,142,112,254,
554,1955,168,118,286,
555,1974,134,121,255,
556,2004,144,116,260,
557,1961,163,138,301,
558,1949,127,119,246,
559,1991,143,118,261,
560,1972,166,113,279,
561,1933,128,118,246,
562,1944,166,94,260,
563,2042,138,128,266,
564,1900,121,112,233,
565,2061,169,112,281,
566,1911,138,105,243,
567,1955,155,111,266,
568,2040,185,111,296,
569,1943,153,106,259,
570,1977,144,113,257,
571,1982,134,104,238,
572,1967,137,101,238,
573,1879,146,109,255,
574,1867,115,119,234,
575,2049,158,115,273,
576,1984,109,123,232,
577,1917,143,107,250,
578,1948,132,118,250,
579,1931,148,128,276,
580,1992,147,124,271,
581,1961,141,107,248,
582,2021,131,123,254,
583,1963,147,117,264,
584,1994,153,130,283,
585,2007,168,117,285,
586,1998,137,112,249,
587,1886,142,103,245,
588,1969,136,126,262,
589,2036,169,134,303,
590,1899,143,106,249,
591,1865,146,105,251,
592,1942,142,108,250,
593,1932,165,108,273,
594,1875,135,101,236,
595,1981,171,103,274,
596,1963,142,105,247,
597,2036,156,109,265,
598,1922,139,121,260,
599,2045,148,110,258,
600,1932,126,119,245,
601,1892,109,116,225,
602,1946,162,121,283,
603,1926,130,120,250,
604,1983,130,100,230,
605,1994,158,117,275,
606,2010,157,102,259,
607,1883,114,104,218,
608,2019,152,105,257,
609,2039,159,128,287,
610,1979,145,110,255,
611,1874,133,110,243,
612,2021,147,117,264,
613,1898,135,117,252,
614,1948,118,113,231,
615,1998,139,122,261,
616,2001,158,109,267,
617,1881,136,104,240,
618,1990,154,97,251,
619,1966,142,101,243,
620,1985,142,124,266,
621,2017,136,134,270,
622,1950,153,121,274,
623,1888,145,110,255,
624,2015,159,123,282,
625,1911,136,116,252,
626,1955,155,103,258,
627,1943,145,125,270,
628,1903,134,116,250,
629,1989,124,105,229,
630,1892,154,94,248,
631,1899,121,103,224,
632,2024,143,116,259,
633,2009,156,116,272,
634,1931,144,111,255,
635,2005,153,109,262,
636,1825,132,113,245,
637,1917,142,120,262,
638,1926,142,107,249,
639,1966,147,112,259,
640,1983,156,107,263,
641,1918,118,125,243,
642,2023,156,104,260,
643,2007,150,109,259,
644,1961,120,119,239,
645,1922,135,110,245,
646,2059,138,133,271,
647,1976,128,110,238,
648,1913,162,104,266,
649,1939,158,128,286,
650,2037,152,111,263,
651,1902,126,135,261,
652,2032,122,111,233,
653,2004,145,123,268,
654,1911,130,108,238,
655,1936,143,91,234,
656,2006,165,111,276,
657,1943,126,119,245,
658,1949,159,122,281,
659,1965,148,102,250,
660,2033,184,105,289,
661,1934,139,129,268,
662,1955,166,104,270,
663,1926,155,89,244,
664,1957,148,128,276,
665,1938,143,107,250,
666,1990,143,113,256,
667,1958,144,105,249,
668,1845,126,90,216,
669,2016,147,116,263,
670,1914,136,111,247,
671,1996,162,137,299,
672,1900,156,121,277,
673,1923,142,85,227,
674,1942,147,121,268,
675,1980,157,111,268,
676,1906,141,100,241,
677,1940,115,114,229,
678,1968,130,122,252,
679,1973,154,119,273,
680,1937,148,106,254,
681,2034,135,97,232,
682,2021,148,107,255,
683,1944,144,126,270,
684,1916,119,115,234,
685,2008,152,94,246,
686,1943,147,106,253,
687,1971,154,110,264,
688,1932,147,104,251,
689,1940,142,111,253,
690,1978,131,111,242,
691,1877,154,105,259,
692,1982,149,115,264,
693,1916,157,117,274,
694,1999,154,101,255,
695,1951,143,119,262,
696,2025,137,116,253,
697,1934,156,120,276,
698,1937,114,117,231,
699,1952,130,102,232,
700,1929,155,103,258,
701,1924,151,87,238,
702,2016,144,125,269,
703,2046,159,121,280,
704,1986,135,120,255,
705,1964,135,109,244,
706,1953,116,114,230,
707,1982,138,108,246,
708,1979,160,93,253,
709,1969,153,110,263,
710,2009,126,113,239,
711,1920,160,115,275,
712,1910,139,106,245,
713,1940,130,105,235,
714,2047,138,110,248,
715,1995,148,139,287,
716,1827,129,106,235,
717,1966,136,117,253,
718,1933,133,103,236,
719,2014,142,104,246,
720,1942,131,103,234,
721,2021,139,120,259,
722,1986,168,123,291,
723,1922,144,113,257,
724,1886,145,97,242,
725,1978,136,88,224,
726,1953,142,100,242,
727,1920,134,109,243,
728,1914,160,115,275,
729,1974,150,104,254,
730,1954,136,106,242,
731,2004,145,109,254,
732,2071,135,110,245,
733,1986,132,104,236,
734,2046,148,124,272,
735,2016,162,143,305,
736,1994,144,126,270,
737,1952,119,118,237,
738,2026,142,126,268,
739,1951,137,113,250,
740,1943,121,91,212,
741,1937,141,116,257,
742,1928,150,122,272,
743,1979,122,108,230,
744,1890,136,103,239,
745,1951,166,117,283,
746,1917,150,100,250,
747,1998,127,103,230,
748,1915,144,113,257,
749,1915,136,123,259,
750,2011,134,137,271,
751,1987,155,137,292,
752,1964,147,118,265,
753,2030,126,106,232,
754,1914,141,118,259,
755,2098,141,116,257,
756,1962,140,107,247,
757,2008,150,122,272,
758,1954,132,106,238,
759,1999,161,120,281,
760,1944,140,113,253,
761,1942,131,107,238,
762,1980,153,132,285,
763,1990,157,87,244,
764,1957,143,118,261,
765,1932,151,105,256,
766,1942,157,126,283,
767,2007,149,111,260,
768,1984,141,112,253,
769,1955,152,92,244,
770,1888,140,116,256,
771,1969,155,106,261,
772,2003,142,113,255,
773,1936,129,108,237,
774,1994,145,117,262,
775,1906,150,124,274,
776,1978,140,138,278,
777,2002,156,113,269,
778,1953,122,123,245,
779,1914,142,125,267,
780,1953,139,122,261,
781,1895,126,100,226,
782,2007,172,118,290,
783,1898,125,111,236,
784,1949,163,94,257,
785,1899,119,89,208,
786,2080,150,126,276,
787,1943,137,122,259,
788,1960,140,103,243,
789,1987,154,112,266,
790,1992,157,125,282,
791,1998,141,111,252,
792,1925,141,111,252,
793,1951,146,116,262,
794,1959,139,119,258,
795,1890,135,129,264,
796,1997,146,96,242,
797,1987,149,98,247,
798,1998,151,129,280,
799,1990,158,124,282,
800,1947,140,105,245,
801,1969,151,106,257,
802,1933,145,109,254,
803,1938,153,101,254,
804,1972,152,117,269,
805,1970,148,121,269,
806,1944,127,112,239,
807,1957,130,118,248,
808,1990,144,133,277,
809,1996,159,103,262,
810,1885,117,105,222,
811,1998,151,108,259,
812,1947,149,115,264,
813,2021,157,125,282,
814,2015,165,102,267,
815,1857,149,100,249,
816,1937,153,118,271,
817,1941,135,100,235,
818,2021,147,107,254,
819,1904,147,106,253,
820,1983,149,106,255,
821,2009,156,116,272,
822,1947,147,109,256,
823,1940,147,113,260,
824,1982,125,111,236,
825,1905,141,113,254,
826,2051,152,124,276,
827,2002,132,130,262,
828,1972,142,101,243,
829,2029,159,113,272,
830,1987,139,110,249,
831,1976,120,96,216,
832,1971,131,136,267,
833,2024,154,110,264,
834,1927,136,122,258,
835,1976,141,119,260,
836,1931,157,116,273,
837,1969,133,124,257,
838,1930,129,112,241,
839,2001,137,115,252,
840,1950,136,120,256,
841,1980,149,123,272,
842,1959,136,110,246,
843,1898,141,124,265,
844,1981,156,122,278,
845,1887,130,104,234,
846,1962,147,95,242,
847,1955,146,112,258,
848,1932,119,109,228,
849,1962,148,113,261,
850,1836,142,97,239,
851,2016,147,115,262,
852,1888,130,118,248,
853,1887,132,101,233,
854,1917,112,119,231,
855,1906,153,125,278,
856,2060,153,117,270,
857,1935,138,97,235,
858,2097,151,119,270,
859,2017,159,112,271,
860,1944,153,114,267,
861,2010,127,110,237,
862,1945,127,126,253,
863,1962,162,112,274,
864,2010,137,115,252,
865,1925,118,115,233,
866,1956,153,105,258,
867,1925,165,126,291,
868,1999,155,110,265,
869,1939,116,113,229,
870,1993,129,110,239,
871,2028,127,113,240,
872,1994,168,93,261,
873,1950,150,112,262,
874,2007,135,112,247,
875,1978,153,121,274,
876,2027,146,133,279,
877,1941,145,102,247,
878,1997,137,96,233,
879,1926,147,103,250,
880,2060,177,121,298,
881,1903,151,99,250,
882,1949,141,113,254,
883,1896,144,107,251,
884,1912,146,122,268,
885,1999,136,116,252,
886,1947,152,107,259,
887,1901,140,100,240,
888,1965,162,116,278,
889,2004,172,111,283,
890,1959,148,112,260,
891,1876,154,104,258,
892,1941,117,112,229,
893,1950,134,119,253,
894,2046,151,116,267,
895,1946,140,109,249,
896,1967,151,123,274,
897,2038,146,103,249,
898,1971,141,114,255,
899,1969,153,128,281,
900,2016,130,119,249,
901,1912,125,95,220,
902,1954,147,122,269,
903,2057,151,120,271,
904,1929,140,106,246,
905,1914,145,125,270,
906,1995,143,105,248,
907,2005,140,110,250,
908,2049,153,126,279,
909,1976,144,120,264,
910,2062,161,106,267,
911,1974,134,128,262,
912,2051,161,122,283,
913,1953,150,123,273,
914,2055,161,103,264,
915,1897,143,110,253,
916,1966,131,116,247,
917,2012,129,106,235,
918,1972,142,115,257,
919,1975,145,126,271,
920,1980,121,132,253,
921,1952,150,140,290,
922,1949,132,95,227,
923,1974,155,145,300,
924,1994,137,113,250,
925,1944,128,110,238,
926,1983,134,104,238,
927,1929,139,127,266,
928,1937,128,94,222,
929,1953,144,104,248,
930,1972,136,120,256,
931,1883,145,119,264,
932,1855,145,108,253,
933,1941,147,109,256,
934,2011,141,120,261,
935,1923,157,104,261,
936,1928,134,106,240,
937,1880,134,114,248,
938,1952,148,113,261,
939,1920,129,111,240,
940,2024,151,109,260,
941,2051,146,118,264,
942,1920,129,112,241,
943,1951,119,91,210,
944,2030,137,127,264,
945,1997,162,100,262,
946,1920,149,116,265,
947,1927,136,110,246,
948,2038,165,109,274,
949,2064,143,114,257,
950,1919,146,116,262,
951,1983,130,120,250,
952,2021,147,103,250,
953,1945,123,113,236,
954,1894,154,94,248,
955,2003,149,129,278,
956,1981,128,109,237,
957,1921,130,107,237,
958,1996,165,105,270,
959,2040,135,109,244,
960,1903,148,115,263,
961,1942,134,108,242,
962,1829,130,106,236,
963,2011,146,122,268,
964,1900,137,106,243,
965,1877,151,125,276,
966,2019,157,105,262,
967,1967,144,107,251,
968,1929,156,99,255,
969,1944,133,128,261,
970,2017,157,109,266,
971,1929,155,114,269,
972,1922,138,86,224,
973,1957,156,121,277,
974,1995,138,125,263,
975,1956,163,116,279,
976,2017,144,118,262,
977,2022,146,128,274,
978,1897,140,110,250,
979,1948,139,127,266,
980,1948,151,112,263,
981,2007,159,101,260,
982,1974,157,121,278,
983,1934,151,124,275,
984,1940,133,115,248,
985,2005,133,107,240,
986,1984,157,115,272,
987,1969,153,109,262,
988,1933,133,101,234,
989,1970,140,128,268,
990,1972,152,112,264,
991,2001,154,110,264,
992,1889,146,113,259,
993,1954,120,98,218,
994,1947,139,107,246,
995,1987,148,90,238,
996,1964,137,117,254,
997,1954,160,123,283,
998,1993,154,110,264,
999,1964,139,90,229,
1000,1945,138,130,268,
1001,1951,135,124,259,
1002,1962,158,113,271,
1003,1916,168,113,281,
1004,1964,140,127,267,
1005,2004,134,107,241,
1006,1923,148,100,248,
1007,2042,140,115,255,
1008,1993,157,123,280,
1009,1955,148,110,258,
1010,1933,148,96,244,
1011,1957,134,114,248,
1012,1895,128,107,235,
1013,1969,141,115,256,
1014,1982,152,129,281,
1015,1999,163,115,278,
1016,1998,143,116,259,
1017,1934,132,91,223,
1018,1886,131,115,246,
1019,1921,136,98,234,
1020,1997,159,123,282,
1021,1949,128,114,242,
1022,1984,134,110,244,
1023,1960,149,101,250,
1024,1990,148,117,265,
1025,2038,132,123,255,
1026,1997,135,104,239,
1027,1941,141,90,231,
1028,1990,146,128,274,
1029,1979,118,112,230,
1030,1951,157,117,274,
1031,1932,133,102,235,
1032,2043,172,107,279,
1033,1958,139,103,242,
1034,1971,130,123,253,
1035,1904,154,115,269,
1036,1930,119,108,227,
1037,1958,137,113,250,
1038,1937,131,121,252,
1039,1923,132,105,237,
1040,2012,149,103,252,
1041,1918,154,108,262,
1042,1955,130,104,234,
1043,1903,126,124,250,
1044,1955,150,105,255,
1045,1904,143,123,266,
1046,1978,139,117,256,
1047,2020,146,110,256,
1048,1985,113,128,241,
1049,2027,136,129,265,
1050,2016,136,116,252,
1051,1929,122,119,241,
1052,1909,163,92,255,
1053,2030,143,125,268,
1054,1947,140,116,256,
1055,1997,144,103,247,
1056,1989,146,125,271,
1057,1896,146,127,273,
1058,2027,151,127,278,
1059,1979,143,119,262,
1060,1962,137,113,250,
1061,1912,144,101,245,
1062,2022,129,134,263,
1063,1960,148,125,273,
1064,2006,147,132,279,
1065,2002,167,105,272,
1066,1963,155,112,267,
1067,1943,148,113,261,
1068,1945,152,99,251,
1069,2015,136,121,257,
1070,1910,156,112,268,
1071,1915,132,106,238,
1072,1984,160,112,272,
1073,1936,136,119,255,
1074,2005,145,104,249,
1075,1977,166,105,271,
1076,2015,120,111,231,
1077,1889,151,125,276,
1078,1957,131,109,240,
1079,2018,148,124,272,
1080,1962,157,126,283,
1081,1929,157,107,264,
1082,1925,132,120,252,
1083,2007,175,106,281,
1084,1869,115,121,236,
1085,1866,143,94,237,
1086,1943,127,108,235,
1087,1909,114,145,259,
1088,1963,154,102,256,
1089,2017,145,121,266,
1090,1934,130,132,262,
1091,1940,136,122,258,
1092,1917,148,112,260,
1093,1997,134,109,243,
1094,1970,156,90,246,
1095,1980,144,114,258,
1096,1918,137,119,256,
1097,1862,152,104,256,
1098,1909,150,96,246,
1099,1945,147,101,248,
1100,2012,135,121,256,
1101,1983,148,97,245,
1102,2015,135,108,243,
1103,1968,160,104,264,
1104,1981,143,113,256,
1105,2033,151,112,263,
1106,1994,132,118,250,
1107,1997,141,99,240,
1108,1952,130,114,244,
1109,2021,138,144,282,
1110,1956,158,120,278,
1111,1960,136,107,243,
1112,1936,154,108,262,
1113,1992,144,115,259,
1114,2009,155,104,259,
1115,2020,151,113,264,
1116,1943,132,135,267,
1117,1892,139,102,241,
1118,1932,162,113,275,
1119,1946,141,106,247,
1120,1941,141,117,258,
1121,1991,165,114,279,
1122,1969,124,116,240,
1123,2016,145,103,248,
1124,1944,155,111,266,
1125,2010,151,141,292,
1126,1908,122,106,228,
1127,2026,134,125,259,
1128,1908,120,108,228,
1129,1957,138,115,253,
1130,2048,129,124,253,
1131,2069,136,116,252,
1132,2001,155,130,285,
1133,1943,127,121,248,
1134,1948,123,133,256,
1135,1941,162,120,282,
1136,1947,143,131,274,
1137,2021,143,99,242,
1138,1958,143,95,238,
1139,1922,149,102,251,
1140,1930,146,120,266,
1141,1956,130,120,250,
1142,2007,138,120,258,
1143,1963,149,132,281,
1144,1837,126,102,228,
1145,1911,125,127,252,
1146,1923,134,121,255,
1147,2027,159,120,279,
1148,1971,146,109,255,
1149,1923,130,103,233,
1150,1963,138,108,246,
1151,1923,152,97,249,
1152,1941,150,85,235,
1153,2016,135,111,246,
1154,1971,156,106,262,
1155,1998,147,125,272,
1156,1900,131,120,251,
1157,1954,147,102,249,
1158,2019,144,122,266,
1159,1946,136,127,263,
1160,2007,170,112,282,
1161,1903,141,113,254,
1162,2043,119,107,226,
1163,2055,157,121,278,
1164,2022,143,123,266,
1165,1963,149,109,258,
1166,1968,124,119,243,
1167,1993,125,111,236,
1168,1992,157,110,267,
1169,1982,176,100,276,
1170,1908,158,115,273,
1171,1987,135,113,248,
1172,1900,148,109,257,
1173,2027,146,126,272,
1174,2055,150,118,268,
1175,1977,162,104,266,
1176,1908,161,97,258,
1177,2037,145,127,272,
1178,1956,130,115,245,
1179,1970,137,115,252,
1180,1946,161,119,280,
1181,1995,143,121,264,
1182,1991,122,128,250,
1183,1927,156,83,239,
1184,1917,149,111,260,
1185,2015,157,111,268,
1186,1941,136,109,245,
1187,1967,146,119,265,
1188,1980,150,99,249,
1189,2005,140,115,255,
1190,2055,145,127,272,
1191,1903,140,105,245,
1192,1956,143,84,227,
1193,2019,148,114,262,
1194,2004,154,114,268,
1195,2002,145,110,255,
1196,1899,147,112,259,
1197,1966,139,109,248,
1198,1988,122,117,239,
1199,1949,137,114,251,
1200,1919,148,96,244,
1201,1970,131,109,240,
1202,1985,151,114,265,
1203,2053,153,118,271,
1204,1941,122,126,248,
1205,1937,158,107,265,
1206,1905,149,111,260,
1207,1868,135,119,254,
1208,1960,146,114,260,
1209,1971,130,124,254,
1210,1968,117,105,222,
1211,2038,158,121,279,
1212,1911,133,107,240,
1213,1949,151,99,250,
1214,1995,141,136,277,
1215,1986,147,117,264,
1216,2026,143,113,256,
1217,1922,131,112,243,
1218,1891,141,118,259,
1219,1959,131,109,240,
1220,1978,147,120,267,
1221,2057,173,112,285,
1222,1977,140,96,236,
1223,2073,142,115,257,
1224,1962,133,118,251,
1225,1941,120,99,219,
1226,2045,152,104,256,
1227,2022,149,108,257,
1228,1964,156,106,262,
1229,1994,141,118,259,
1230,2045,133,107,240,
1231,1925,153,100,253,
1232,1957,161,102,263,
1233,2049,144,112,256,
1234,1937,156,111,267,
1235,1985,125,115,240,
1236,2031,126,121,247,
1237,1966,146,124,270,
1238,1923,146,110,256,
1239,1990,147,111,258,
1240,1995,147,110,257,
1241,2051,151,101,252,
1242,1897,145,107,252,
1243,2011,165,123,288,
1244,1951,128,114,242,
1245,1925,149,88,237,
1246,1993,151,97,248,
1247,1960,142,127,269,
1248,2001,138,117,255,
1249,1871,135,121,256,
1250,1955,133,79,212,
1251,2002,141,119,260,
1252,1946,131,107,238,
1253,1920,134,114,248,
1254,1939,153,121,274,
1255,1947,156,111,267,
1256,1932,143,96,239,
1257,1951,140,113,253,
1258,1861,137,111,248,
1259,1943,147,127,274,
1260,1923,113,118,231,
1261,1887,138,109,247,
1262,1955,128,112,240,
1263,1926,133,120,253,
1264,1903,145,115,260,
1265,1977,141,102,243,
1266,1937,146,123,269,
1267,1998,144,118,262,
1268,1931,155,93,248,
1269,1958,144,122,266,
1270,1994,145,112,257,
1271,1946,133,99,232,
1272,1954,141,102,243,
1273,1931,180,126,306,
1274,1970,146,108,254,
1275,2051,147,113,260,
1276,1961,140,105,245,
1277,1988,128,123,251,
1278,1864,128,97,225,
1279,1992,148,130,278,
1280,2011,127,121,248,
1281,1900,149,109,258,
1282,1932,138,108,246,
1283,2028,149,126,275,
1284,1968,143,126,269,
1285,1931,163,118,281,
1286,1960,145,106,251,
1287,1946,140,111,251,
1288,1912,137,114,251,
1289,1966,138,118,256,
1290,2057,157,103,260,
1291,2072,155,126,281,
1292,2062,145,116,261,
1293,1935,136,104,240,
1294,2027,156,112,268,
1295,1914,145,96,241,
1296,1946,140,137,277,
1297,1947,151,121,272,
1298,1996,170,115,285,
1299,1898,130,102,232,
1300,1903,139,140,279,
1301,1942,140,112,252,
1302,1969,140,125,265,
1303,1995,151,128,279,
1304,1928,136,115,251,
1305,1892,127,112,239,
1306,1987,146,114,260,
1307,1976,137,98,235,
1308,1953,161,109,270,
1309,1963,119,114,233,
1310,1879,126,116,242,
1311,1932,142,117,259,
1312,1933,145,101,246,
1313,1966,129,109,238,
1314,2018,131,116,247,
1315,1929,149,122,271,
1316,1951,130,106,236,
1317,1976,169,112,281,
1318,1968,143,94,237,
1319,1945,144,113,257,
1320,1898,143,89,232,
1321,1864,138,101,239,
1322,2022,167,113,280,
1323,2035,134,118,252,
1324,1967,111,115,226,
1325,2052,130,109,239,
1326,2056,146,95,241,
1327,1911,157,112,269,
1328,1934,137,96,233,
1329,1978,132,97,229,
1330,1962,134,112,246,
1331,1988,147,113,260,
1332,1972,111,109,220,
1333,1939,138,110,248,
1334,1961,135,103,238,
1335,1982,140,108,248,
1336,1877,137,118,255,
1337,1936,161,92,253,
1338,1997,144,106,250,
1339,1916,117,122,239,
1340,1967,145,123,268,
1341,1962,161,94,255,
1342,1942,140,102,242,
1343,1969,142,95,237,
1344,1947,131,136,267,
1345,1937,140,110,250,
1346,1972,140,100,240,
1347,1930,135,107,242,
1348,1961,147,120,267,
1349,2024,174,119,293,
1350,1946,130,99,229,
1351,1991,153,114,267,
1352,1944,142,96,238,
1353,1909,145,121,266,
1354,1950,124,131,255,
1355,1996,154,135,289,
1356,1907,149,106,255,
1357,1920,135,104,239,
1358,2004,140,109,249,
1359,1990,156,122,278,
1360,1939,127,122,249,
1361,1962,148,92,240,
1362,2040,139,137,276,
1363,1880,123,87,210,
1364,2025,158,98,256,
1365,1910,130,108,238,
1366,1963,148,115,263,
1367,1932,132,123,255,
1368,1970,128,95,223,
1369,2041,139,108,247,
1370,1988,143,103,246,
1371,1871,133,92,225,
1372,1908,149,105,254,
1373,1982,154,103,257,
1374,1914,141,111,252,
1375,1936,136,102,238,
1376,1888,150,96,246,
1377,1977,147,134,281,
1378,1916,131,115,246,
1379,1956,130,123,253,
1380,1965,155,100,255,
1381,1928,134,117,251,
1382,2006,161,122,283,
1383,1914,135,87,222,
1384,2005,161,118,279,
1385,1953,135,101,236,
1386,1920,141,128,269,
1387,1957,133,130,263,
1388,1992,140,123,263,
1389,1901,137,112,249,
1390,1979,114,105,219,
1391,1996,138,116,254,
1392,1980,134,131,265,
1393,1844,131,106,237,
1394,1890,123,111,234,
1395,1936,133,118,251,
1396,1957,149,100,249,
1397,1958,148,112,260,
1398,1957,111,109,220,
1399,1906,132,113,245,
1400,1985,124,117,241,
1401,1982,124,114,238,
1402,1982,155,122,277,
1403,1973,146,108,254,
1404,1904,139,107,246,
1405,1932,148,111,259,
1406,1977,152,124,276,
1407,1955,134,100,234,
1408,1917,132,101,233,
1409,1954,164,101,265,
1410,1993,135,122,257,
1411,1954,147,118,265,
1412,1994,128,105,233,
1413,1957,145,109,254,
1414,1923,132,112,244,
1415,1937,145,110,255,
1416,1944,146,125,271,
1417,1937,149,110,259,
1418,1932,146,103,249,
1419,1941,147,115,262,
1420,1977,141,107,248,
1421,2012,157,102,259,
1422,2038,151,115,266,
1423,1984,121,122,243,
1424,1918,125,95,220,
1425,1976,130,123,253,
1426,2048,144,100,244,
1427,1999,127,101,228,
1428,1988,157,99,256,
1429,1905,131,107,238,
1430,1952,146,118,264,
1431,1965,148,126,274,
1432,1952,149,103,252,
1433,1990,154,93,247,
1434,1909,130,113,243,
1435,1941,145,114,259,
1436,2050,148,131,279,
1437,2002,143,114,257,
1438,1958,159,116,275,
1439,1942,152,122,274,
1440,2084,154,118,272,
1441,1950,139,133,272,
1442,2090,160,104,264,
1443,2067,140,121,261,
1444,2032,150,100,250,
1445,1985,135,124,259,
1446,2015,158,112,270,
1447,1966,147,102,249,
1448,1979,140,113,253,
1449,1976,142,111,253,
1450,2009,150,119,269,
1451,1969,149,102,251,
1452,2025,147,114,261,
1453,1968,143,119,262,
1454,1913,136,92,228,
1455,2041,134,120,254,
1456,1933,130,120,250,
1457,1981,149,104,253,
1458,1961,142,117,259,
1459,2081,167,109,276,
1460,1892,122,108,230,
1461,1986,135,107,242,
1462,2007,149,108,257,
1463,2042,148,112,260,
1464,1942,149,109,258,
1465,1896,124,108,232,
1466,2054,173,112,285,
1467,1953,141,116,257,
1468,2002,146,104,250,
1469,1926,141,132,273,
1470,1934,151,117,268,
1471,1971,135,116,251,
1472,1910,142,129,271,
1473,1986,154,101,255,
1474,1964,124,136,260,
1475,1926,148,105,253,
1476,1975,140,126,266,
1477,2019,148,104,252,
1478,1982,146,123,269,
1479,1911,153,120,273,
1480,2059,144,109,253,
1481,1896,150,115,265,
1482,1993,161,115,276,
1483,1924,130,112,242,
1484,1939,123,113,236,
1485,2001,135,139,274,
1486,2010,162,96,258,
1487,1963,136,111,247,
1488,1933,125,93,218,
1489,1903,139,113,252,
1490,1930,144,126,270,
1491,2017,145,105,250,
1492,2007,129,115,244,
1493,1910,145,108,253,
1494,1883,158,107,265,
1495,1963,131,119,250,
1496,1961,153,95,248,
1497,1970,145,111,256,
1498,2025,144,132,276,
1499,2031,154,123,277,
1500,2011,151,113,264,
1501,1911,152,97,249,
1502,1920,129,125,254,
1503,2039,146,128,274,
1504,1939,152,115,267,
1505,2028,140,114,254,
1506,1993,143,116,259,
1507,1890,155,101,256,
1508,1972,137,123,260,
1509,1999,164,114,278,
1510,1971,150,107,257,
1511,2006,147,110,257,
1512,1953,137,112,249,
1513,1956,133,120,253,
1514,1897,141,111,252,
1515,1972,148,98,246,
1516,2012,135,123,258,
1517,1863,127,107,234,
1518,1943,120,129,249,
1519,1933,132,123,255,
1520,1925,140,94,234,
1521,1962,170,103,273,
1522,1965,140,111,251,
1523,2014,144,88,232,
1524,1966,140,105,245,
1525,2000,136,123,259,
1526,1956,162,109,271,
1527,1829,149,121,270,
1528,2081,144,100,244,
1529,2028,151,113,264,
1530,1995,165,108,273,
1531,1976,141,116,257,
1532,2009,148,108,256,
1533,1986,130,120,250,
1534,2041,158,118,276,
1535,2035,152,114,266,
1536,2033,142,121,263,
1537,2026,153,130,283,
1538,1979,145,113,258,
1539,1931,132,113,245,
1540,1920,145,113,258,
1541,1911,147,124,271,
1542,1951,156,125,281,
1543,2009,142,97,239,
1544,1946,136,112,248,
1545,1929,160,95,255,
1546,2016,150,137,287,
1547,1963,141,82,223,
1548,1997,138,100,238,
1549,1983,155,121,276,
1550,1956,139,86,225,
1551,2024,151,142,293,
1552,1969,139,107,246,
1553,2034,141,120,261,
1554,1905,149,99,248,
1555,2017,135,124,259,
1556,1963,135,110,245,
1557,2041,150,116,266,
1558,2000,137,130,267,
1559,2023,153,110,263,
1560,1945,130,121,251,
1561,1921,123,111,234,
1562,1909,133,113,246,
1563,1964,140,104,244,
1564,1943,140,94,234,
1565,1943,156,116,272,
1566,1958,134,107,241,
1567,2011,134,123,257,
1568,1903,144,113,257,
1569,1883,148,116,264,
1570,1826,120,101,221,
1571,1961,134,110,244,
1572,2014,151,110,261,
1573,1923,124,127,251,
1574,1965,136,107,243,
1575,1938,131,105,236,
1576,1923,138,101,239,
1577,1975,133,104,237,
1578,1951,129,116,245,
1579,1955,144,117,261,
1580,1966,141,95,236,
1581,1916,127,108,235,
1582,2018,157,97,254,
1583,1990,160,114,274,
1584,1956,146,103,249,
1585,1921,143,125,268,
1586,2023,139,109,248,
1587,1974,148,110,258,
1588,1943,125,98,223,
1589,1976,123,126,249,
1590,1956,142,102,244,
1591,1949,157,108,265,
1592,1903,153,91,244,
1593,2010,146,96,242,
1594,2004,154,108,262,
1595,1876,115,102,217,
1596,1904,133,95,228,
1597,2002,164,104,268,
1598,1905,141,114,255,
1599,1993,167,114,281,
1600,1929,143,96,239,
1601,1894,152,107,259,
1602,1975,138,106,244,
1603,1928,134,96,230,
1604,1979,133,112,245,
1605,1945,129,111,240,
1606,1905,136,135,271,
1607,1998,143,116,259,
1608,1892,146,105,251,
1609,2001,146,101,247,
1610,1930,148,103,251,
1611,1899,163,86,249,
1612,1973,163,124,287,
1613,1941,158,117,275,
1614,2003,135,110,245,
1615,1987,155,119,274,
1616,1911,149,114,263,
1617,2064,148,133,281,
1618,1916,140,97,237,
1619,1973,141,105,246,
1620,1920,128,97,225,
1621,1962,123,123,246,
1622,1983,146,101,247,
1623,1874,132,107,239,
1624,1924,146,103,249,
1625,1933,141,111,252,
1626,1923,129,107,236,
1627,1941,139,108,247,
1628,1968,141,116,257,
1629,1962,146,103,249,
1630,1943,146,122,268,
1631,1915,129,109,238,
1632,1938,147,125,272,
1633,1991,133,98,231,
1634,2013,165,100,265,
1635,1940,137,122,259,
1636,1947,139,115,254,
1637,1917,126,119,245,
1638,1967,136,112,248,
1639,1956,151,115,266,
1640,1977,154,110,264,
1641,1913,148,119,267,
1642,1948,134,107,241,
1643,1926,133,114,247,
1644,2037,130,123,253,
1645,2026,152,104,256,
1646,2002,144,122,266,
1647,1937,140,110,250,
1648,1974,149,110,259,
1649,2039,142,119,261,
1650,1988,161,106,267,
1651,2018,151,112,263,
1652,1892,155,118,273,
1653,1993,183,120,303,
1654,1983,158,102,260,
1655,1947,149,104,253,
1656,2044,140,113,253,
1657,1980,147,121,268,
1658,1982,152,118,270,
1659,1964,135,102,237,
1660,1987,132,112,244,
1661,1993,158,132,290,
1662,1895,130,107,237,
1663,2042,172,115,287,
1664,2021,154,126,280,
1665,1967,130,110,240,
1666,1993,117,118,235,
1667,1932,136,112,248,
1668,1888,145,110,255,
1669,2013,128,109,237,
1670,1940,142,101,243,
1671,1887,140,102,242,
1672,1878,126,114,240,
1673,1947,141,105,246,
1674,2000,146,117,263,
1675,1997,131,123,254,
1676,2036,154,129,283,
1677,1918,118,133,251,
1678,1972,141,113,254,
1679,2021,153,114,267,
1680,1980,170,125,295,
1681,1941,158,93,251,
1682,1970,151,110,261,
1683,1856,132,114,246,
1684,2024,144,113,257,
1685,1995,144,109,253,
1686,2070,140,109,249,
1687,2007,143,104,247,
1688,1950,150,120,270,
1689,1911,141,123,264,
1690,2028,157,122,279,
1691,1940,143,106,249,
1692,2018,165,125,290,
1693,2006,138,114,252,
1694,1859,134,119,253,
1695,1989,156,117,273,
1696,2017,153,109,262,
1697,1972,125,123,248,
1698,1966,127,102,229,
1699,1994,167,98,265,
1700,1951,132,117,249,
1701,1992,143,113,256,
1702,1990,151,106,257,
1703,1902,155,101,256,
1704,1992,162,107,269,
1705,1926,133,116,249,
1706,1932,128,103,231,
1707,1895,138,106,244,
1708,1957,139,112,251,
1709,2031,147,117,264,
1710,1907,135,94,229,
1711,1953,145,93,238,
1712,1902,142,102,244,
1713,1993,144,99,243,
1714,1920,154,112,266,
1715,1979,129,107,236,
1716,2034,140,112,252,
1717,2031,137,123,260,
1718,1961,138,111,249,
1719,1999,164,119,283,
1720,1916,141,109,250,
1721,1985,138,105,243,
1722,1952,138,128,266,
1723,2010,134,117,251,
1724,1881,150,112,262,
1725,1896,142,95,237,
1726,1991,132,124,256,
1727,1908,115,114,229,
1728,1935,153,119,272,
1729,1969,155,103,258,
1730,1951,135,110,245,
1731,1898,135,102,237,
1732,1995,126,116,242,
1733,1915,128,126,254,
1734,1986,138,112,250,
1735,2049,161,100,261,
1736,2025,129,100,229,
1737,1931,138,108,246,
1738,1970,133,93,226,
1739,2020,141,121,262,
1740,2044,143,117,260,
1741,1991,147,109,256,
1742,2020,152,135,287,
1743,2001,157,117,274,
1744,1992,164,125,289,
1745,1937,130,116,246,
1746,1976,139,121,260,
1747,1944,163,99,262,
1748,1925,142,105,247,
1749,2020,145,92,237,
1750,1959,133,111,244,
1751,1904,121,118,239,
1752,2024,142,119,261,
1753,1990,144,117,261,
1754,1982,145,121,266,
1755,1985,139,115,254,
1756,2044,146,91,237,
1757,1978,155,109,264,
1758,1931,126,113,239,
1759,1910,151,98,249,
1760,2064,160,129,289,
1761,1998,144,128,272,
1762,1981,137,118,255,
1763,1886,139,95,234,
1764,1917,140,96,236,
1765,1920,124,107,231,
1766,1952,137,115,252,
1767,1893,130,103,233,
1768,1890,148,117,265,
1769,1971,137,107,244,
1770,2001,148,119,267,
1771,1959,164,120,284,
1772,1986,153,122,275,
1773,1939,146,103,249,
1774,1907,134,112,246,
1775,2001,153,100,253,
1776,1974,130,121,251,
1777,1981,141,88,229,
1778,2007,144,99,243,
1779,1987,140,103,243,
1780,1981,133,108,241,
1781,1936,129,113,242,
1782,1975,133,91,224,
1783,2045,150,126,276,
1784,2027,146,114,260,
1785,1931,143,85,228,
1786,1888,136,131,267,
1787,2054,158,114,272,
1788,1959,153,124,277,
1789,2020,142,108,250,
1790,1857,120,115,235,
1791,1934,130,116,246,
1792,1983,129,107,236,
1793,1889,159,100,259,
1794,1939,135,104,239,
1795,1951,131,110,241,
1796,1990,156,96,252,
1797,1957,151,112,263,
1798,1887,129,110,239,
1799,1964,147,118,265,
1800,2014,156,104,260,
1801,1958,142,114,256,
1802,1928,138,116,254,
1803,2002,137,112,249,
1804,1947,141,120,261,
1805,1932,119,110,229,
1806,1981,159,111,270,
1807,1923,123,108,231,
1808,1973,136,106,242,
1809,2017,139,105,244,
1810,1924,139,115,254,
1811,1957,127,117,244,
1812,2081,167,94,261,
1813,1877,139,106,245,
1814,1918,124,122,246,
1815,1961,151,113,264,
1816,2012,160,113,273,
1817,1848,140,122,262,
1818,1935,154,119,273,
1819,1981,144,124,268,
1820,2009,132,121,253,
1821,1939,174,125,299,
1822,2002,132,104,236,
1823,1954,162,103,265,
1824,2025,154,126,280,
1825,1882,151,121,272,
1826,1895,155,105,260,
1827,1914,130,103,233,
1828,1934,136,112,248,
1829,1913,142,112,254,
1830,2050,170,111,281,
1831,1869,141,101,242,
1832,1872,115,121,236,
1833,1940,143,127,270,
1834,1930,137,103,240,
1835,1979,130,117,247,
1836,1979,160,115,275,
1837,1812,152,99,251,
1838,1926,155,117,272,
1839,1963,152,91,243,
1840,1821,146,113,259,
1841,1945,148,125,273,
1842,1966,129,121,250,
1843,1967,136,126,262,
1844,1904,151,94,245,
1845,1940,158,128,286,
1846,1970,143,135,278,
1847,2007,127,123,250,
1848,2016,136,137,273,
1849,1969,157,120,277,
1850,1963,146,89,235,
1851,1987,165,118,283,
1852,1865,119,117,236,
1853,1969,140,131,271,
1854,2010,164,112,276,
1855,2027,178,100,278,
1856,1921,141,93,234,
1857,2019,131,124,255,
1858,1966,153,117,270,
1859,1959,123,115,238,
1860,1962,143,114,257,
1861,1999,146,102,248,
1862,2016,157,127,284,
1863,1955,140,114,254,
1864,1976,136,116,252,
1865,1974,133,100,233,
1866,1955,152,100,252,
1867,1968,133,97,230,
1868,1981,133,129,262,
1869,1987,145,141,286,
1870,1985,147,111,258,
1871,2018,159,140,299,
1872,1942,147,107,254,
1873,1901,150,108,258,
1874,2039,138,105,243,
1875,1921,111,103,214,
1876,1976,142,106,248,
1877,1935,145,115,260,
1878,2012,157,100,257,
1879,2072,176,120,296,
1880,1918,162,115,277,
1881,1915,132,99,231,
1882,1955,126,108,234,
1883,2001,149,115,264,
1884,2047,146,123,269,
1885,1996,145,125,270,
1886,1950,137,98,235,
1887,1923,150,119,269,
1888,1977,153,113,266,
1889,2006,158,126,284,
1890,1938,145,90,235,
1891,1896,117,94,211,
1892,60,5,4,9,
1893,1933,141,96,237,
1894,1942,150,98,248,
1895,1919,132,90,222,
1896,2035,136,126,262,
1897,1941,133,108,241,
1898,2054,155,115,270,
1899,1992,169,132,301,
1900,2047,142,130,272,
1901,2028,140,120,260,
1902,1863,132,97,229,
1903,1988,126,114,240,
1904,1936,133,113,246,
1905,1980,137,114,251,
1906,1968,143,109,252,
1907,1966,130,114,244,
1908,2005,134,109,243,
1909,2021,158,117,275,
1910,1942,134,119,253,
1911,1914,142,101,243,
1912,1961,166,102,268,
1913,2008,148,115,263,
1914,1939,142,108,250,
1915,1963,139,118,257,
1916,1993,146,101,247,
1917,2002,140,115,255,
1918,1971,154,108,262,
1919,1987,160,107,267,
1920,1960,137,111,248,
1921,1961,137,104,241,
1922,2042,156,102,258,
1923,1905,124,110,234,
1924,1967,150,112,262,
1925,1967,150,112,262,
1926,1970,133,109,242,
1927,1975,148,122,270,
1928,1916,134,108,242,
1929,1923,139,98,237,
1930,1970,142,99,241,
1931,1908,131,99,230,
1932,1980,139,109,248,
1933,1926,134,121,255,
1934,1945,135,98,233,
1935,1973,146,100,246,
1936,2005,137,116,253,
1937,1893,164,106,270,
1938,2033,147,107,254,
1939,2023,144,119,263,
1940,1995,140,113,253,
1941,1996,168,117,285,
1942,1890,121,110,231,
1943,1990,146,104,250,
1944,1954,148,128,276,
1945,2011,132,128,260,
1946,1956,124,103,227,
1947,2021,139,128,267,
1948,1947,148,115,263,
1949,1930,145,115,260,
1950,1940,157,118,275,
1951,1927,141,108,249,
1952,2004,158,94,252,
1953,1934,134,97,231,
1954,1988,124,118,242,
1955,1967,130,121,251,
1956,1939,151,117,268,
1957,2006,154,104,258,
1958,1931,139,117,256,
1959,1947,156,118,274,
1960,1913,111,118,229,
1961,1975,128,113,241,
1962,1997,132,106,238,
1963,1955,152,117,269,
1964,2042,146,107,253,
1965,1932,147,126,273,
1966,2047,147,112,259,
1967,1930,142,111,253,
1968,1857,127,115,242,
1969,1914,148,122,270,
1970,2032,145,125,270,
1971,2026,170,114,284,
1972,1974,135,101,236,
1973,2047,155,120,275,
1974,2077,160,89,249,
1975,1965,170,107,277,
1976,1953,136,114,250,
1977,1965,152,112,264,
1978,2026,172,125,297,
1979,1940,141,99,240,
1980,2046,141,115,256,
1981,1931,146,106,252,
1982,2002,135,111,246,
1983,2050,145,134,279,
1984,2023,151,113,264,
1985,1959,150,107,257,
1986,1972,141,96,237,
1987,1975,130,141,271,
1988,2016,130,97,227,
1989,1986,147,123,270,
1990,1982,147,119,266,
1991,1982,138,110,248,
1992,1900,162,106,268,
1993,1978,139,128,267,
1994,1963,149,112,261,
1995,2035,149,119,268,
1996,1892,154,124,278,
1997,1922,132,107,239,
1998,2020,127,129,256,
1999,1982,141,110,251,
2000,1939,148,123,271,
2001,2025,144,136,280,
2002,1958,130,114,244,
2003,1908,119,128,247,
2004,1998,149,107,256,
2005,1909,124,102,226,
2006,1974,121,128,249,
2007,1944,152,116,268,
2008,1972,124,127,251,
2009,1980,144,118,262,
2010,1931,150,107,257,
2011,1981,131,98,229,
2012,2018,152,114,266,
2013,2069,160,126,286,
2014,1967,160,112,272,
2015,1972,140,134,274,
2016,1992,133,119,252,
2017,1919,137,110,247,
2018,1984,135,119,254,
2019,2077,160,120,280,
2020,1973,141,118,259,
2021,1991,170,119,289,
2022,1890,123,109,232,
2023,1990,124,119,243,
2024,1981,141,119,260,
2025,1958,129,112,241,
2026,1914,138,123,261,
2027,1974,155,106,261,
2028,1920,151,101,252,
2029,1907,144,121,265,
2030,1909,147,98,245,
2031,1968,145,107,252,
2032,1931,129,122,251,
2033,1953,165,102,267,
2034,1951,146,102,248,
2035,1975,131,125,256,
2036,1938,136,96,232,
2037,2020,127,133,260,
2038,2006,148,118,266,
2039,1979,140,125,265,
2040,1962,150,128,278,
2041,1926,134,112,246,
2042,1932,141,106,247,
2043,2036,143,104,247,
2044,1976,121,124,245,
2045,2022,143,109,252,
2046,1943,131,131,262,
2047,2004,147,123,270,
2048,2060,146,93,239,
2049,1949,157,104,261,
2050,2044,131,131,262,
2051,1946,125,131,256,
2052,1909,140,108,248,
2053,1978,134,115,249,
2054,1934,138,119,257,
2055,1906,138,108,246,
2056,1937,160,101,261,
2057,1956,144,113,257,
2058,1970,131,118,249,
2059,2015,152,140,292,
2060,1899,136,97,233,
2061,2019,141,117,258,
2062,2037,154,118,272,
2063,1932,140,98,238,
2064,1839,138,129,267,
2065,1979,146,107,253,
2066,2067,149,136,285,
2067,1988,144,117,261,
2068,1922,144,125,269,
2069,1920,131,112,243,
2070,2000,139,126,265,
2071,1984,163,108,271,
2072,1876,135,127,262,
2073,1979,156,108,264,
2074,1899,121,113,234,
2075,1958,149,101,250,
2076,1990,146,113,259,
2077,2062,122,122,244,
2078,1905,129,82,211,
2079,2003,160,120,280,
2080,2043,153,101,254,
2081,1992,144,122,266,
2082,1991,149,113,262,
2083,2012,152,106,258,
2084,1935,138,100,238,
2085,1962,148,108,256,
2086,1995,150,100,250,
2087,1980,166,101,267,
2088,1961,145,111,256,
2089,1907,125,104,229,
2090,1930,134,122,256,
2091,1991,160,107,267,
2092,1915,145,97,242,
2093,2002,120,104,224,
2094,1957,133,128,261,
2095,2038,146,108,254,
2096,1952,146,108,254,
2097,2011,146,105,251,
2098,2031,136,108,244,
2099,1943,160,117,277,
2100,1994,141,115,256,
2101,1843,133,97,230,
2102,1990,158,131,289,
2103,1973,153,106,259,
2104,2017,134,113,247,
2105,1924,143,116,259,
2106,1955,143,94,237,
2107,2004,158,114,272,
2108,1910,128,104,232,
2109,2013,135,110,245,
2110,1985,156,102,258,
2111,2008,140,115,255,
2112,1910,150,99,249,
2113,1922,127,106,233,
2114,1917,150,106,256,
2115,1958,164,116,280,
2116,1962,144,108,252,
2117,1964,143,119,262,
2118,1961,137,102,239,
2119,2006,129,122,251,
2120,2021,153,105,258,
2121,1907,130,125,255,
2122,2028,162,122,284,
2123,1957,139,109,248,
2124,1947,133,115,248,
2125,1966,157,110,267,
2126,2024,134,111,245,
2127,1926,146,123,269,
2128,2027,157,104,261,
2129,1933,136,115,251,
2130,1980,137,112,249,
2131,2046,154,97,251,
2132,1999,147,117,264,
2133,1967,157,107,264,
2134,2035,145,124,269,
2135,1947,146,107,253,
2136,1911,142,108,250,
2137,2048,147,93,240,
2138,1935,143,125,268,
2139,1898,148,94,242,
2140,1996,146,104,250,
2141,1959,126,118,244,
2142,1940,142,112,254,
2143,1998,142,117,259,
2144,1929,121,123,244,
2145,1922,156,103,259,
2146,1949,146,108,254,
2147,1959,147,112,259,
2148,1962,157,125,282,
2149,1993,122,121,243,
2150,2035,153,109,262,
2151,2035,170,106,276,
2152,1954,129,87,216,
2153,2035,127,117,244,
2154,1980,145,108,253,
2155,1900,134,111,245,
2156,1959,123,109,232,
2157,1945,125,98,223,
2158,1945,145,108,253,
2159,1868,144,112,256,
2160,1940,157,112,269,
2161,1925,145,114,259,
2162,2061,156,118,274,
2163,1904,142,103,245,
2164,1954,141,104,245,
2165,2084,150,116,266,
2166,1944,123,123,246,
2167,1969,149,101,250,
2168,2014,152,134,286,
2169,1990,152,111,263,
2170,1995,145,110,255,
2171,1975,150,111,261,
2172,1937,153,113,266,
2173,1920,162,103,265,
2174,1997,144,101,245,
2175,1938,130,102,232,
2176,2031,131,117,248,
2177,1952,122,104,226,
2178,1865,146,96,242,
2179,1926,123,107,230,
2180,2021,150,116,266,
2181,1970,157,98,255,
2182,1942,154,110,264,
2183,2025,154,105,259,
2184,2057,162,113,275,
2185,1852,148,123,271,
2186,1993,126,110,236,
2187,1995,159,108,267,
2188,2013,139,118,257,
2189,1918,126,86,212,
2190,2004,130,105,235,
2191,2032,155,125,280,
2192,1987,137,117,254,
2193,2020,150,132,282,
2194,2007,151,106,257,
2195,1926,135,118,253,
2196,1957,143,110,253,
2197,1952,165,102,267,
2198,1924,134,122,256,
2199,1955,154,112,266,
2200,1992,143,105,248,
2201,1921,130,100,230,
2202,1982,142,121,263,
2203,1961,153,111,264,
2204,1938,134,118,252,
2205,2016,145,106,251,
2206,1946,146,134,280,
2207,2048,166,93,259,
2208,1954,141,123,264,
2209,2013,151,118,269,
2210,1874,109,99,208,
2211,1964,154,118,272,
2212,1968,135,101,236,
2213,1871,140,105,245,
2214,1920,134,107,241,
2215,1927,153,114,267,
2216,1917,139,108,247,
2217,1961,142,107,249,
2218,1919,151,88,239,
2219,1951,135,108,243,
2220,1975,140,126,266,
2221,2026,130,123,253,
2222,2031,145,110,255,
2223,1916,140,94,234,
2224,2040,139,115,254,
2225,2018,142,104,246,
2226,1949,131,114,245,
2227,1827,122,97,219,
2228,1970,165,103,268,
2229,1998,131,93,224,
2230,1934,149,112,261,
2231,1979,144,98,242,
2232,1979,148,108,256,
2233,2032,163,109,272,
2234,1896,135,128,263,
2235,2055,140,105,245,
2236,1965,151,102,253,
2237,1997,130,128,258,
2238,1949,142,132,274,
2239,2010,130,102,232,
2240,1966,165,102,267,
2241,1992,152,107,259,
2242,1942,165,100,265,
2243,1944,137,118,255,
2244,1966,129,105,234,
2245,2005,160,125,285,
2246,1986,144,133,277,
2247,1884,141,98,239,
2248,1953,132,94,226,
2249,2057,154,127,281,
2250,1986,155,118,273,
2251,2013,151,114,265,
2252,1956,145,115,260,
2253,1944,159,100,259,
2254,1944,130,113,243,
2255,2032,133,128,261,
2256,1955,141,108,249,
2257,2020,142,118,260,
2258,2028,139,101,240,
2259,1993,116,109,225,
2260,1933,144,103,247,
2261,1963,144,122,266,
2262,1997,146,125,271,
2263,1861,123,107,230,
2264,2021,133,102,235,
2265,1947,146,94,240,
2266,1959,142,112,254,
2267,1902,125,97,222,
2268,2035,148,129,277,
2269,2000,164,110,274,
2270,1989,149,121,270,
2271,1943,128,117,245,
2272,1966,149,107,256,
2273,2008,136,108,244,
2274,2107,148,121,269,
2275,2019,153,114,267,
2276,1985,131,109,240,
2277,1885,145,103,248,
2278,1988,140,120,260,
2279,1844,133,104,237,
2280,1975,129,124,253,
2281,2025,153,101,254,
2282,1961,141,120,261,
2283,1942,147,114,261,
2284,1915,123,116,239,
2285,1959,142,91,233,
2286,1922,174,100,274,
2287,1982,153,116,269,
2288,1919,140,117,257,
2289,2001,166,121,287,
2290,1872,140,103,243,
2291,2025,148,105,253,
2292,1987,147,95,242,
2293,1970,131,116,247,
2294,1931,131,114,245,
2295,2090,181,126,307,
2297,2028,141,125,266,
2298,1985,144,108,252,
2299,1942,153,103,256,
2300,1982,160,119,279,
2301,1988,119,110,229,
2302,2020,143,117,260,
2303,1968,159,113,272,
2304,1994,164,110,274,
2305,2077,145,136,281,
2306,1911,110,122,232,
2307,1956,160,92,252,
2308,1992,147,112,259,
2309,1966,152,124,276,
2310,1977,132,109,241,
2311,1982,160,117,277,
2312,1914,144,102,246,
2313,1918,146,122,268,
2314,1996,139,120,259,
2315,1929,148,105,253,
2316,2003,135,121,256,
2317,1962,133,108,241,
2318,1972,143,114,257,
2319,2082,137,106,243,
2320,1953,121,105,226,
2321,1995,150,102,252,
2322,1990,143,105,248,
2323,1999,161,128,289,
2324,1911,136,136,272,
2325,2009,146,124,270,
2326,1943,148,106,254,
2327,1982,152,98,250,
2328,1929,150,101,251,
2329,2050,141,126,267,
2330,1916,146,137,283,
2331,1950,122,112,234,
2332,1863,141,119,260,
2333,1990,140,117,257,
2334,1951,122,128,250,
2335,1930,134,82,216,
2336,2054,147,126,273,
2337,1931,140,99,239,
2338,1955,150,113,263,
2339,1990,134,100,234,
2340,2041,140,112,252,
2341,1944,146,110,256,
2342,1997,150,106,256,
2343,1949,139,100,239,
2344,1904,152,88,240,
2345,1982,144,123,267,
2346,1990,146,114,260,
2347,1912,156,115,271,
2348,1922,144,108,252,
2349,2004,126,126,252,
2350,2022,156,123,279,
2351,1961,148,113,261,
2352,2022,146,120,266,
2353,1914,130,99,229,
2354,1897,139,99,238,
2355,1989,148,100,248,
2356,2038,164,117,281,
2357,2048,145,122,267,
2358,1957,131,105,236,
2359,1924,142,113,255,
2360,2106,141,107,248,
2361,1946,153,108,261,
2362,1992,142,111,253,
2363,1981,119,126,245,
2364,1935,142,119,261,
2365,1963,153,116,269,
2366,1997,137,122,259,
2367,1992,145,129,274,
2368,1947,125,87,212,
2369,1999,148,122,270,
2370,1985,137,114,251,
2371,1927,133,116,249,
2372,1929,139,108,247,
2373,1989,120,117,237,
2374,1980,145,114,259,
2375,2008,141,116,257,
2376,1953,146,105,251,
2377,1950,150,122,272,
2378,1923,134,114,248,
2379,1963,139,112,251,
2380,2014,153,114,267,
2381,1938,128,119,247,
2382,1923,144,100,244,
2383,2029,152,111,263,
2384,1974,143,127,270,
2385,2012,124,118,242,
2386,2026,151,118,269,
2387,2010,127,115,242,
2388,1924,152,119,271,
2389,1956,143,115,258,
2390,1951,126,109,235,
2391,1971,149,98,247,
2392,1960,128,111,239,
2393,1967,156,119,275,
2394,1983,147,119,266,
2395,2070,144,125,269,
2396,2023,139,109,248,
2397,1869,158,113,271,
2398,2143,164,120,284,
2399,1991,150,106,256,
2400,1926,146,124,270,
2401,1847,126,106,232,
2402,1935,148,121,269,
2403,1981,141,98,239,
2404,1933,153,141,294,
2405,1908,176,107,283,
2406,1985,150,115,265,
2407,1903,130,100,230,
2408,1949,140,124,264,
2409,1995,143,106,249,
2410,1980,142,88,230,
2411,1975,146,101,247,
2412,2031,149,115,264,
2413,1904,134,128,262,
2414,1915,147,126,273,
2415,1928,133,120,253,
2416,1989,140,137,277,
2417,1986,137,115,252,
2418,1967,127,94,221,
2419,1969,152,97,249,
2420,1974,169,110,279,
2421,1947,138,107,245,
2422,1942,125,118,243,
2423,1944,144,115,259,
2424,1963,154,115,269,
2425,1955,133,104,237,
2426,2011,159,121,280,
2427,1908,145,115,260,
2428,1908,153,93,246,
2429,1989,136,106,242,
2430,1974,153,125,278,
2431,1922,152,105,257,
2432,1921,149,114,263,
2433,1933,136,102,238,
2434,2041,137,120,257,
2435,1940,132,96,228,
2436,1958,145,111,256,
2437,1964,154,105,259,
2438,2025,167,104,271,
2439,1995,172,111,283,
2440,2018,142,112,254,
2441,1957,127,108,235,
2442,1978,153,118,271,
2443,1912,143,112,255,
2444,1881,129,100,229,
2445,1858,133,103,236,
2446,1965,137,125,262,
2447,1947,144,118,262,
2448,2011,145,135,280,
2449,1998,135,126,261,
2450,1983,127,118,245,
2451,1908,126,124,250,
2452,1988,156,93,249,
2453,2019,156,117,273,
2454,1913,142,121,263,
2455,2005,140,121,261,
2456,1970,153,100,253,
2457,1945,129,116,245,
2458,1925,124,124,248,
2459,1896,147,107,254,
2460,2032,137,125,262,
2461,1966,169,110,279,
2462,2014,147,125,272,
2463,1963,130,114,244,
2464,1964,150,109,259,
2465,1970,129,133,262,
2466,1997,164,109,273,
2467,2025,136,124,260,
2468,1961,128,115,243,
2469,1962,126,106,232,
2470,2041,150,116,266,
2471,1940,166,119,285,
2472,1905,135,102,237,
2473,1938,157,101,258,
2474,2009,137,103,240,
2475,1992,143,127,270,
2476,2032,143,111,254,
2477,2011,134,115,249,
2478,1874,132,97,229,
2479,2056,142,111,253,
2480,1998,152,110,262,
2481,1991,147,126,273,
2482,2024,111,115,226,
2483,1986,134,115,249,
2484,2007,131,114,245,
2485,1999,145,123,268,
2486,1919,134,98,232,
2487,1897,127,98,225,
2488,1938,129,113,242,
2489,1960,128,123,251,
2490,2025,143,101,244,
2491,1976,135,130,265,
2492,1999,169,100,269,
2493,2043,138,103,241,
2494,1901,141,100,241,
2495,1987,151,132,283,
2496,2019,161,129,290,
2497,1992,167,134,301,
2498,1957,125,124,249,
2499,1958,145,109,254,
2500,1886,171,129,300,
2501,2021,142,117,259,
2502,2022,142,117,259,
2503,1973,144,114,258,
2504,1863,135,106,241,
2505,1995,128,115,243,
2506,2051,162,122,284,
2507,1858,139,107,246,
2508,2069,150,107,257,
2509,1937,151,88,239,
2510,1932,138,105,243,
2511,2072,168,116,284,
2512,1906,145,99,244,
2513,2034,149,118,267,
2514,1952,147,106,253,
2515,1997,154,124,278,
2516,1932,139,110,249,
2517,1957,137,123,260,
2518,1962,153,119,272,
2519,1960,160,91,251,
2520,1931,143,103,246,
2521,1942,148,87,235,
2522,1991,146,146,292,
2523,1984,135,133,268,
2524,2040,148,106,254,
2525,1960,123,122,245,
2526,1928,150,112,262,
2527,1954,143,123,266,
2528,1895,153,107,260,
2529,2030,149,120,269,
2530,2034,145,118,263,
2531,1955,130,114,244,
2532,1976,142,109,251,
2533,2044,157,127,284,
2534,1948,158,92,250,
2535,1992,145,110,255,
2536,1973,138,110,248,
2537,1920,163,132,295,
2538,1893,135,114,249,
2539,2038,141,109,250,
2540,1956,136,79,215,
2541,2018,146,125,271,
2542,2074,128,118,246,
2543,1981,142,103,245,
2544,1972,157,109,266,
2545,2046,144,131,275,
2546,210,14,13,27,
2547,1970,136,100,236,
2548,1996,134,113,247,
2549,2108,147,115,262,
2550,1898,140,90,230,
2551,1958,130,115,245,
2552,1951,158,96,254,
2553,1981,160,93,253,
2554,2030,149,126,275,
2555,1974,159,110,269,
2556,1982,139,111,250,
2557,1942,149,107,256,
2558,1943,124,119,243,
2559,2044,153,117,270,
2560,1886,128,101,229,
2561,1919,148,103,251,
2562,1993,124,106,230,
2563,1944,139,119,258,
2564,1926,165,104,269,
2565,1951,143,118,261,
2566,2030,141,108,249,
2567,1976,142,111,253,
2568,1968,145,120,265,
2569,1957,140,127,267,
2570,1978,130,120,250,
2571,1979,145,117,262,
2572,1975,144,122,266,
2573,2009,161,112,273,
2574,2044,163,119,282,
2575,2031,157,100,257,
2576,1976,154,117,271,
2577,1946,138,114,252,
2578,2008,140,126,266,
2579,1979,129,110,239,
2580,1922,134,120,254,
2581,1960,135,97,232,
2582,2009,147,123,270,
2583,1918,150,126,276,
2584,1934,131,121,252,
2585,1901,158,98,256,
2586,1908,157,106,263,
2587,1916,148,111,259,
2588,2043,142,117,259,
2589,1961,142,108,250,
2590,1988,156,104,260,
2591,1952,135,120,255,
2592,1943,155,113,268,
2593,2027,172,118,290,
2594,1930,133,112,245,
2595,1844,139,100,239,
2596,1977,136,105,241,
2597,1952,152,100,252,
2598,2016,137,117,254,
2599,1986,157,126,283,
2600,1984,159,104,263,
2601,2006,143,114,257,
2602,1942,139,101,240,
2603,1906,137,138,275,
2604,1958,138,97,235,
2605,1968,147,107,254,
2606,2023,154,112,266,
2607,1956,157,125,282,
2608,1857,126,108,234,
2609,1888,137,99,236,
2610,2001,154,91,245,
2611,1875,130,124,254,
2612,2011,158,117,275,
2613,1985,153,106,259,
2614,1990,155,99,254,
2615,2001,157,105,262,
2616,1965,139,124,263,
2617,1949,143,101,244,
2618,1970,120,139,259,
2619,1925,136,129,265,
2620,1967,142,120,262,
2621,1902,126,99,225,
2622,1979,132,114,246,
2623,1850,122,106,228,
2624,2010,140,124,264,
2625,2026,158,98,256,
2626,1941,143,119,262,
2627,1956,139,108,247,
2628,1963,138,107,245,
2629,1991,152,109,261,
2630,1903,127,108,235,
2631,1937,137,125,262,
2632,2014,162,111,273,
2633,1990,158,116,274,
2634,2045,162,131,293,
2635,2005,154,120,274,
2636,1971,152,99,251,
2637,2015,156,112,268,
2638,2001,146,123,269,
2639,1948,147,116,263,
2640,1973,173,105,278,
2641,1929,139,113,252,
2642,1996,143,111,254,
2643,2009,158,112,270,
2644,2015,122,120,242,
2645,1811,116,103,219,
2646,1972,140,101,241,
2647,1987,148,123,271,
2648,1946,138,122,260,
2649,1963,144,117,261,
2650,1930,146,90,236,
2651,1892,114,117,231,
2652,1936,140,104,244,
2653,1851,126,92,218,
2654,1992,160,108,268,
2655,1953,131,125,256,
2656,1900,146,110,256,
2657,1920,126,122,248,
2658,2006,134,107,241,
2659,1980,130,114,244,
2660,1939,153,98,251,
2661,2022,146,130,276,
2662,1928,143,115,258,
2663,1973,144,109,253,
2664,1997,148,99,247,
2665,1982,134,92,226,
2666,2009,160,112,272,
2667,1904,123,126,249,
2668,1979,146,104,250,
2669,1944,152,101,253,
2670,1953,135,88,223,
2671,1963,153,107,260,
2672,1972,125,124,249,
2673,1934,130,119,249,
2674,1986,112,110,222,
2675,1991,138,133,271,
2676,2005,137,125,262,
2677,2003,162,114,276,
2678,2018,152,117,269,
2679,1922,141,106,247,
2680,1933,144,119,263,
2681,2015,144,108,252,
2682,2007,131,133,264,
2683,2061,160,110,270,
2684,1990,152,111,263,
2685,1914,150,114,264,
2686,1959,131,112,243,
2687,1959,137,125,262,
2688,1989,156,110,266,
2689,1954,161,109,270,
2690,1935,122,102,224,
2691,2019,139,125,264,
2692,1891,125,100,225,
2693,1901,133,121,254,
2694,2024,142,126,268,
2695,1966,156,122,278,
2696,2104,150,136,286,
2697,1903,130,108,238,
2698,1936,149,103,252,
2699,2026,153,134,287,
2700,1921,160,122,282,
2701,1951,126,107,233,
2702,2033,146,114,260,
2703,2036,153,112,265,
2704,1902,136,115,251,
2705,1939,122,124,246,
2706,1900,133,97,230,
2707,2012,148,127,275,
2708,1971,141,109,250,
2709,1990,124,111,235,
2710,2016,132,110,242,
2711,1968,149,98,247,
2712,1987,146,115,261,
2713,1905,142,113,255,
2714,2004,130,128,258,
2715,1989,128,133,261,
2716,1888,123,117,240,
2717,1952,147,111,258,
2718,1931,128,103,231,
2719,2025,145,131,276,
2720,2017,134,112,246,
2721,2016,163,130,293,
2722,1956,138,105,243,
2723,1961,133,121,254,
2724,1962,162,95,257,
2725,1973,146,126,272,
2726,2013,136,113,249,
2727,1916,144,111,255,
2728,1975,141,103,244,
2729,1962,127,121,248,
2730,1978,161,110,271,
2731,1953,160,106,266,
2732,2016,141,126,267,
2733,1971,141,99,240,
2734,2014,161,91,252,
2735,1887,142,106,248,
2736,1988,140,112,252,
2737,1992,125,97,222,
2738,1968,148,108,256,
2739,1982,144,113,257,
2740,1904,140,110,250,
2741,1995,145,120,265,
2742,1954,156,108,264,
2743,1969,134,107,241,
2744,1958,150,125,275,
2745,1967,137,98,235,
2746,1977,130,131,261,
2747,1970,155,124,279,
2748,1934,143,119,262,
2749,2070,147,112,259,
2750,2035,143,126,269,
2751,2015,164,98,262,
2752,2039,145,111,256,
2753,2040,159,111,270,
2754,1891,154,110,264,
2755,1948,147,108,255,
2756,1995,174,109,283,
2757,1970,163,102,265,
2758,1947,142,117,259,
2759,1922,135,99,234,
2760,1881,129,106,235,
2761,1949,156,118,274,
2762,1993,139,109,248,
2763,1979,147,110,257,
2764,1970,151,108,259,
2765,1975,150,118,268,
2766,1964,129,121,250,
2767,1966,153,102,255,
2768,1957,140,102,242,
2769,1958,139,106,245,
2770,1964,134,120,254,
2771,1940,129,106,235,
2772,1942,171,105,276,
2773,2017,143,119,262,
2774,2012,148,115,263,
2775,1924,137,100,237,
2776,1980,166,121,287,
2777,2012,148,125,273,
2778,2038,125,140,265,
2779,1983,141,109,250,
2780,1946,151,110,261,
2781,2003,131,110,241,
2782,1956,138,98,236,
2783,1979,135,107,242,
2784,1897,134,117,251,
2785,2042,141,112,253,
2786,1936,136,136,272,
2787,1997,131,102,233,
2788,1925,148,105,253,
2789,1932,133,119,252,
2790,1964,130,116,246,
2791,1848,128,98,226,
2792,1966,142,112,254,
2793,1961,151,120,271,
2794,1922,157,108,265,
2795,1922,122,114,236,
2796,1960,155,107,262,
2797,2015,142,130,272,
2798,1974,151,117,268,
2799,1954,133,105,238,
2800,2037,156,115,271,
2801,2028,140,124,264,
2802,1966,153,114,267,
2803,1992,147,102,249,
2804,2030,157,122,279,
2805,2037,138,134,272,
2806,1978,158,114,272,
2807,2065,148,113,261,
2808,1898,135,114,249,
2809,1969,146,106,252,
2810,1964,161,111,272,
2811,1885,121,109,230,
2812,2015,134,98,232,
2813,1893,149,108,257,
2814,1990,129,114,243,
2815,1919,134,110,244,
2816,2008,151,121,272,
2817,1924,135,115,250,
2818,1975,141,114,255,
2819,1887,138,107,245,
2820,2014,132,108,240,
2821,1996,139,129,268,
2822,1921,154,111,265,
2823,1984,161,114,275,
2824,1888,123,94,217,
2825,1971,144,124,268,
2826,1963,169,113,282,
2827,2010,138,103,241,
2828,2019,139,103,242,
2829,2092,145,129,274,
2830,1996,134,92,226,
2831,1986,142,96,238,
2832,1992,154,100,254,
2833,1894,141,107,248,
2834,1919,148,83,231,
2835,2007,158,113,271,
2836,1998,148,102,250,
2837,1926,152,105,257,
2838,1992,137,103,240,
2839,2019,137,130,267,
2840,2055,143,124,267,
2841,1975,156,111,267,
2842,1978,123,113,236,
2843,1963,143,119,262,
2844,2009,151,121,272,
2845,1926,137,115,252,
2846,2011,139,115,254,
2847,1915,128,110,238,
2848,1914,137,111,248,
2849,1984,144,103,247,
2850,1899,134,107,241,
2851,1856,143,110,253,
2852,1957,138,103,241,
2853,1933,136,115,251,
2854,1887,140,105,245,
2855,1985,142,127,269,
2856,1972,154,115,269,
2857,2049,165,119,284,
2858,1974,148,98,246,
2859,1986,135,104,239,
2860,1991,158,109,267,
2861,1887,153,104,257,
2862,1952,133,111,244,
2863,1936,140,107,247,
2864,1930,134,130,264,
2865,1931,141,105,246,
2866,1943,159,109,268,
2867,1915,134,113,247,
2868,1910,132,117,249,
2869,2040,139,123,262,
2870,1963,141,111,252,
2871,1906,135,117,252,
2872,1984,130,115,245,
2873,1910,123,120,243,
2874,2039,134,100,234,
2875,1992,141,112,253,
2876,1953,129,114,243,
2877,1980,145,93,238,
2878,1970,157,92,249,
2879,2012,143,116,259,
2880,1986,156,100,256,
2881,1967,131,117,248,
2882,1958,137,127,264,
2883,1994,147,116,263,
2884,1999,149,105,254,
2885,1988,140,127,267,
2886,1917,153,101,254,
2887,2072,135,102,237,
2888,1954,135,94,229,
2889,1978,148,114,262,
2890,1960,136,104,240,
2891,1921,155,99,254,
2892,1947,150,117,267,
2893,1947,129,126,255,
2894,2007,131,110,241,
2895,1981,128,117,245,
2896,1868,126,114,240,
2897,1951,156,102,258,
2898,1918,166,106,272,
2899,1837,151,84,235,
2900,1948,150,102,252,
2901,1957,152,105,257,
2902,1932,138,104,242,
2903,1958,151,121,272,
2904,1984,137,109,246,
2905,1984,138,130,268,
2906,1942,153,101,254,
2907,1999,128,115,243,
2908,2015,129,119,248,
2909,1907,135,117,252,
2910,2010,159,120,279,
2911,1992,149,116,265,
2912,1950,116,109,225,
2913,1964,140,89,229,
2914,1937,131,100,231,
2915,2034,155,101,256,
2916,1863,143,97,240,
2917,2019,155,114,269,
2918,1951,158,110,268,
2919,2033,144,114,258,
2920,1903,151,119,270,
2921,1945,145,111,256,
2922,1917,152,104,256,
2923,1959,150,114,264,
2924,1940,139,108,247,
2925,1994,145,110,255,
2926,1961,139,89,228,
2927,1948,134,115,249,
2928,1997,151,101,252,
2929,1943,129,131,260,
2930,1878,137,101,238,
2931,2008,158,112,270,
2932,1896,153,116,269,
2933,1992,140,109,249,
2934,1951,145,103,248,
2935,1963,130,121,251,
2936,1956,136,106,242,
2937,1852,148,109,257,
2938,2031,147,113,260,
2939,1965,147,95,242,
2940,1939,149,97,246,
2941,1904,127,96,223,
2942,1942,142,98,240,
2943,1952,145,106,251,
2944,1933,126,129,255,
2945,1920,150,116,266,
2946,1902,140,119,259,
2947,1921,163,103,266,
2948,1950,128,114,242,
2949,2011,146,116,262,
2950,1907,127,96,223,
2951,1953,148,114,262,
2952,1891,138,111,249,
2953,1926,143,100,243,
2954,1849,141,105,246,
2955,1937,140,108,248,
2956,1995,142,106,248,
2957,2015,142,122,264,
2958,1986,149,119,268,
2959,1974,152,124,276,
2960,2060,144,121,265,
2961,2031,145,126,271,
2962,1931,118,121,239,
2963,1995,144,118,262,
2964,2010,166,118,284,
2965,1922,153,113,266,
2966,1864,142,84,226,
2967,1980,164,109,273,
2968,2035,134,129,263,
2969,1948,134,121,255,
2970,1933,123,116,239,
2971,1894,130,108,238,
2972,1948,122,92,214,
2973,2000,152,109,261,
2974,1936,129,111,240,
2975,1938,120,96,216,
2976,1982,146,115,261,
2977,2002,147,109,256,
2978,1953,132,121,253,
2979,1899,133,106,239,
2980,2029,131,116,247,
2981,1973,160,119,279,
2982,2021,159,116,275,
2983,1988,162,125,287,
2984,1984,135,105,240,
2985,2003,153,115,268,
2986,1918,121,93,214,
2987,2022,134,115,249,
2988,1917,151,113,264,
2989,2059,156,92,248,
2990,1979,158,113,271,
2991,2021,161,121,282,
2992,1977,140,97,237,
2993,1998,132,122,254,
2994,2025,162,119,281,
2995,1909,124,113,237,
2996,2003,143,111,254,
2997,1935,128,96,224,
2998,1997,119,96,215,
2999,1960,147,93,240,
3000,1996,119,98,217,
3001,2045,149,122,271,
3002,1997,142,109,251,
3003,1964,139,117,256,
3004,2027,170,113,283,
3005,1964,137,118,255,
3006,1950,141,104,245,
3007,2006,129,97,226,
3008,1908,118,101,219,
3009,1936,131,101,232,
3010,2015,157,106,263,
3011,1953,114,94,208,
3012,1991,151,119,270,
3013,2034,132,113,245,
3014,1934,136,116,252,
3015,1972,146,110,256,
3016,1963,132,119,251,
3017,1942,148,106,254,
3018,1908,134,130,264,
3019,1903,124,115,239,
3020,1969,132,112,244,
3021,1971,113,130,243,
3022,1904,140,112,252,
3023,2026,140,109,249,
3024,2054,156,115,271,
3025,2000,150,110,260,
3026,1897,146,120,266,
3027,1961,138,116,254,
3028,1941,138,99,237,
3029,1976,147,89,236,
3030,1968,136,112,248,
3031,1915,161,99,260,
3032,1959,140,114,254,
3033,1989,130,120,250,
3034,2007,134,119,253,
3035,2035,157,96,253,
3036,1954,140,97,237,
3037,1944,147,101,248,
3038,1992,145,117,262,
3039,1967,137,98,235,
3040,1965,130,110,240,
3041,1940,138,117,255,
3042,1959,135,117,252,
3043,1969,141,119,260,
3044,1864,125,104,229,
3045,1979,132,135,267,
3046,2004,138,129,267,
3047,1852,122,122,244,
3048,1983,148,124,272,
3049,1971,124,109,233,
3050,2010,148,108,256,
3051,2012,145,117,262,
3052,1966,155,109,264,
3053,1949,135,102,237,
3054,1967,140,104,244,
3055,1969,143,97,240,
3056,1988,125,126,251,
3057,2014,163,120,283,
3058,2052,131,110,241,
3059,2014,159,120,279,
3060,1984,152,104,256,
3061,2061,157,114,271,
3062,1958,147,115,262,
3063,1981,137,121,258,
3064,1935,137,102,239,
3065,1901,117,134,251,
3066,2055,150,113,263,
3067,1967,155,128,283,
3068,1916,164,106,270,
3069,1991,151,116,267,
3070,1883,127,107,234,
3071,2027,154,116,270,
3072,1881,133,118,251,
3073,1923,117,102,219,
3074,1935,153,119,272,
3075,1970,135,134,269,
3076,2022,128,125,253,
3077,2019,142,121,263,
3078,1998,150,100,250,
3079,1966,144,111,255,
3080,1977,140,99,239,
3081,2054,139,107,246,
3082,2011,129,108,237,
3083,1893,136,122,258,
3084,2003,151,142,293,
3085,2028,149,109,258,
3086,2008,155,115,270,
3087,2000,155,120,275,
3088,1907,151,95,246,
3089,1885,147,111,258,
3090,1959,150,102,252,
3091,2034,151,113,264,
3092,1987,148,100,248,
3093,1905,146,104,250,
3094,1974,126,119,245,
3095,1988,134,108,242,
3096,1967,161,104,265,
3097,1931,137,117,254,
3098,1959,129,83,212,
3099,1912,137,120,257,
3100,1859,150,106,256,
3101,1970,144,112,256,
3102,1892,136,102,238,
3103,1895,152,94,246,
3104,1957,153,102,255,
3105,2005,140,101,241,
3106,2007,153,130,283,
3107,1954,149,105,254,
3108,1958,133,116,249,
3109,1970,152,109,261,
3110,1839,134,89,223,
3111,1930,139,122,261,
3112,1926,135,107,242,
3113,2037,156,121,277,
3114,1916,141,122,263,
3115,1997,163,105,268,
3116,1921,147,112,259,
3117,1963,142,98,240,
3118,1878,116,120,236,
3119,2006,159,134,293,
3120,2003,122,119,241,
3121,1960,141,118,259,
3122,2000,146,106,252,
3123,1957,147,111,258,
3124,1853,136,101,237,
3125,1966,165,94,259,
3126,1977,140,128,268,
3127,1965,132,121,253,
3128,1924,136,105,241,
3129,2020,132,93,225,
3130,1940,136,115,251,
3131,1999,122,109,231,
3132,2004,151,123,274,
3133,2065,153,122,275,
3134,1992,145,114,259,
3135,1894,129,103,232,
3136,2002,146,108,254,
3137,1888,129,96,225,
3138,1933,127,116,243,
3139,1999,142,131,273,
3140,2037,143,109,252,
3141,1883,132,90,222,
3142,1977,151,124,275,
3143,1949,131,107,238,
3144,2008,132,108,240,
3145,2015,143,121,264,
3146,1953,154,91,245,
3147,1927,136,101,237,
3148,2009,141,118,259,
3149,2005,153,128,281,
3150,1911,122,117,239,
3151,2044,152,115,267,
3152,2001,153,119,272,
3153,2005,133,96,229,
3154,2001,143,129,272,
3155,1931,136,117,253,
3156,1932,155,99,254,
3157,1950,122,121,243,
3158,2001,128,123,251,
3159,2011,170,105,275,
3160,1933,122,114,236,
3161,1913,140,107,247,
3162,2044,155,130,285,
3163,2024,157,105,262,
3164,1946,146,132,278,
3165,1983,136,117,253,
3166,1964,134,104,238,
3167,2000,153,130,283,
3168,1927,138,120,258,
3169,2021,159,133,292,
3170,1987,142,124,266,
3171,1847,144,102,246,
3172,1912,127,110,237,
3173,1975,130,100,230,
3174,1998,146,119,265,
3175,2025,127,100,227,
3176,1985,123,119,242,
3177,1890,147,105,252,
3178,1897,165,105,270,
3179,1978,144,124,268,
3180,2079,164,121,285,
3181,1907,138,109,247,
3182,2057,152,118,270,
3183,1957,135,107,242,
3184,2030,131,99,230,
3185,1985,140,148,288,
3186,1953,141,119,260,
3187,1986,139,136,275,
3188,1967,160,104,264,
3189,1977,124,126,250,
3190,2044,168,112,280,
3191,2006,141,115,256,
3192,1969,151,106,257,
3193,1989,162,116,278,
3194,2030,151,125,276,
3195,1962,150,122,272,
3196,1914,120,117,237,
3197,1868,112,106,218,
3198,2014,149,106,255,
3199,1981,154,111,265,
3200,1965,150,105,255,
3201,1938,164,94,258,
3202,2018,150,115,265,
3203,1909,142,113,255,
3204,2036,143,118,261,
3205,1915,123,110,233,
3206,1976,149,130,279,
3207,1937,152,117,269,
3208,2016,136,114,250,
3209,2022,156,124,280,
3210,1985,131,105,236,
3211,1975,142,110,252,
3212,2034,174,104,278,
3213,2024,151,116,267,
3214,2053,167,92,259,
3215,1998,142,115,257,
3216,1907,132,105,237,
3217,1963,145,101,246,
3218,1923,150,126,276,
3219,1887,137,98,235,
3220,1947,126,99,225,
3221,2005,148,115,263,
3222,2032,132,120,252,
3223,2000,142,116,258,
3224,1925,148,123,271,
3225,2018,161,114,275,
3226,1977,135,106,241,
3227,1912,141,105,246,
3228,2010,130,98,228,
3229,2034,150,108,258,
3230,2053,128,126,254,
3231,1999,146,116,262,
3232,1948,123,105,228,
3233,2005,138,108,246,
3234,1891,152,110,262,
3235,1973,146,110,256,
3236,1994,139,119,258,
3237,2003,157,108,265,
3238,2025,162,113,275,
3239,1997,148,98,246,
3240,2061,159,117,276,
3241,1939,136,103,239,
3242,2010,156,113,269,
3243,1956,142,124,266,
3244,1867,137,117,254,
3245,1984,129,110,239,
3246,1998,147,108,255,
3247,1924,147,100,247,
3248,1988,146,115,261,
3249,1971,147,108,255,
3250,1932,137,118,255,
3251,1992,118,124,242,
3252,2038,144,151,295,
3253,1994,167,95,262,
3254,1991,148,112,260,
3255,2011,140,107,247,
3256,2028,137,107,244,
3257,1965,165,106,271,
3258,2013,140,98,238,
3259,1871,121,96,217,
3260,1963,137,106,243,
3261,1948,136,108,244,
3262,1963,124,122,246,
3263,2003,130,117,247,
3264,1977,143,106,249,
3265,1998,147,118,265,
3266,1966,128,108,236,
3267,1969,154,109,263,
3268,1937,138,134,272,
3269,2004,148,116,264,
3270,2009,154,113,267,
3271,1962,129,128,257,
3272,1990,132,112,244,
3273,2026,166,133,299,
3274,1964,166,98,264,
3275,1984,127,111,238,
3276,2038,140,118,258,
3277,2002,148,101,249,
3278,1862,159,104,263,
3279,1894,120,108,228,
3280,1955,154,97,251,
3281,1948,137,100,237,
3282,1983,143,101,244,
3283,1955,150,124,274,
3284,2004,143,101,244,
3285,1906,120,118,238,
3286,1942,148,102,250,
3287,1954,144,105,249,
3288,1939,148,96,244,
3289,1998,146,121,267,
3290,2035,137,124,261,
3291,1946,152,90,242,
3292,1979,131,109,240,
3293,1988,181,102,283,
3294,1968,124,109,233,
3295,1911,133,114,247,
3296,1947,147,121,268,
3297,1974,160,111,271,
3298,1876,125,87,212,
3299,2024,152,115,267,
3300,1963,161,109,270,
3301,1905,135,99,234,
3302,1931,149,113,262,
3303,1932,110,102,212,
3304,1914,140,110,250,
3305,1924,127,109,236,
3306,1953,126,115,241,
3307,1978,135,128,263,
3308,1964,151,124,275,
3309,1984,173,101,274,
3310,1924,137,113,250,
3311,2039,134,105,239,
3312,1945,130,127,257,
3313,1911,149,90,239,
3314,1894,134,121,255,
3315,1956,155,118,273,
3316,1931,159,121,280,
3317,1954,142,102,244,
3318,2011,146,115,261,
3319,1956,135,118,253,
3320,1997,143,115,258,
3321,1966,136,142,278,
3322,1947,147,113,260,
3323,1947,127,115,242,
3324,1971,138,104,242,
3325,1996,172,107,279,
3326,2024,141,111,252,
3327,1894,153,106,259,
3328,1911,133,118,251,
3329,1975,148,107,255,
3330,1944,140,118,258,
3331,1977,138,104,242,
3332,1964,162,113,275,
3333,1983,137,103,240,
3334,2042,148,108,256,
3335,1925,133,103,236,
3336,1969,154,110,264,
3337,2048,148,118,266,
3338,2011,151,108,259,
3339,1914,107,125,232,
3340,1902,152,104,256,
3341,1966,157,100,257,
3342,1968,141,131,272,
3343,1952,119,104,223,
3344,2007,157,122,279,
3345,1958,136,117,253,
3346,1955,122,108,230,
3347,1959,137,92,229,
3348,1984,154,114,268,
3349,1980,122,114,236,
3350,1941,150,125,275,
3351,1943,134,105,239,
3352,2030,138,124,262,
3353,1999,135,109,244,
3354,2022,138,120,258,
3355,2001,132,112,244,
3356,1919,136,92,228,
3357,2098,142,118,260,
3358,1941,128,113,241,
3359,1930,142,127,269,
3360,1998,137,126,263,
3361,1934,145,103,248,
3362,2002,123,120,243,
3363,1950,128,108,236,
3364,1998,141,114,255,
3365,1945,141,122,263,
3366,1916,137,103,240,
3367,1935,133,108,241,
3368,1956,138,123,261,
3369,2007,147,111,258,
3370,1962,150,108,258,
3371,2005,139,113,252,
3372,1993,139,106,245,
3373,2022,152,107,259,
3374,2045,160,103,263,
3375,1974,135,111,246,
3376,2009,167,94,261,
3377,1894,152,95,247,
3378,1919,125,105,230,
3379,1955,141,125,266,
3380,1963,140,98,238,
3381,2039,166,125,291,
3382,2010,152,111,263,
3383,1938,149,97,246,
3384,1961,139,101,240,
3385,1921,131,138,269,
3386,1937,139,90,229,
3387,1982,141,99,240,
3388,2028,157,109,266,
3389,1932,135,106,241,
3390,1985,148,114,262,
3391,1991,145,119,264,
3392,1932,133,103,236,
3393,2046,164,104,268,
3394,2020,123,129,252,
3395,1972,153,110,263,
3396,1966,137,110,247,
3397,1931,150,101,251,
3398,1858,142,106,248,
3399,2002,126,111,237,
3400,2026,144,106,250,
3401,1835,134,100,234,
3402,1995,141,117,258,
3403,1989,136,118,254,
3404,1918,132,128,260,
3405,2040,154,99,253,
3406,2002,160,110,270,
3407,1995,153,94,247,
3408,1969,148,117,265,
3409,1953,141,96,237,
3410,1889,136,135,271,
3411,2018,167,131,298,
3412,2033,159,114,273,
3413,1998,145,110,255,
3414,1920,148,113,261,
3415,1965,155,109,264,
3416,1980,122,107,229,
3417,1958,135,123,258,
3418,1984,133,104,237,
3419,1958,134,109,243,
3420,1960,127,107,234,
3421,2002,126,128,254,
3422,2000,163,117,280,
3423,1875,133,107,240,
3424,2065,126,117,243,
3425,1942,131,126,257,
3426,2039,139,126,265,
3427,1938,130,118,248,
3428,1903,124,110,234,
3429,1939,133,112,245,
3430,1961,158,95,253,
3431,1977,149,115,264,
3432,1892,130,102,232,
3433,1918,139,119,258,
3434,2106,157,114,271,
3435,1971,143,103,246,
3436,1898,123,115,238,
3437,1974,139,86,225,
3438,1932,121,109,230,
3439,1938,147,95,242,
3440,2050,130,122,252,
3441,1965,130,106,236,
3442,1985,148,95,243,
3443,1943,140,111,251,
3444,1983,138,100,238,
3445,1981,129,108,237,
3446,2001,135,128,263,
3447,1972,137,127,264,
3448,2008,150,119,269,
3449,1927,135,99,234,
3450,1896,130,121,251,
3451,1905,125,103,228,
3452,2022,167,112,279,
3453,1923,148,106,254,
3454,1912,138,85,223,
3455,1985,133,113,246,
3456,1974,152,111,263,
3457,1901,144,116,260,
3458,1939,134,92,226,
3459,1908,147,113,260,
3460,1971,141,109,250,
3461,1989,167,125,292,
3462,1973,140,95,235,
3463,2023,141,116,257,
3464,1987,126,124,250,
3465,2023,136,134,270,
3466,1935,157,103,260,
3467,1917,142,127,269,
3468,1982,167,115,282,
3469,1994,140,109,249,
3470,2021,160,125,285,
3471,1988,135,102,237,
3472,1972,129,120,249,
3473,1948,153,99,252,
3474,2004,119,113,232,
3475,1957,172,107,279,
3476,2018,156,108,264,
3477,1925,132,109,241,
3478,2048,150,100,250,
3479,2009,168,124,292,
3480,1980,133,116,249,
3481,1956,136,118,254,
3482,1978,163,108,271,
3483,1969,131,97,228,
3484,1987,155,108,263,
3485,1974,132,111,243,
3486,2019,145,112,257,
3487,1942,140,118,258,
3488,1967,141,110,251,
3489,1936,141,130,271,
3490,1970,155,98,253,
3491,1995,151,115,266,
3492,1971,173,122,295,
3493,1943,127,113,240,
3494,1962,131,111,242,
3495,1984,147,95,242,
3496,1923,112,110,222,
3497,1902,112,125,237,
3498,1964,142,117,259,
3499,1933,158,95,253,
3500,1975,143,116,259,
3501,1915,144,117,261,
3502,1933,140,111,251,
3503,1896,131,105,236,
3504,1885,131,108,239,
3505,1975,121,114,235,
3506,1912,132,106,238,
3507,1890,127,124,251,
3508,1914,146,108,254,
3509,1945,164,119,283,
3510,2031,153,126,279,
3511,1814,137,99,236,
3512,1980,133,119,252,
3513,1918,159,118,277,
3514,1966,145,101,246,
3515,1998,156,127,283,
3516,1980,152,97,249,
3517,1974,152,94,246,
3518,1973,140,125,265,
3519,1987,150,113,263,
3520,1905,137,123,260,
3521,1987,132,139,271,
3522,1909,139,110,249,
3523,2000,140,120,260,
3524,1963,130,104,234,
3525,2018,138,95,233,
3526,2005,153,136,289,
3527,1994,140,117,257,
3528,1882,156,111,267,
3529,1979,141,122,263,
3530,1958,155,115,270,
3531,1953,129,96,225,
3532,1929,139,119,258,
3533,2042,147,123,270,
3534,1943,150,106,256,
3535,1979,148,124,272,
3536,1937,147,104,251,
3537,1949,144,107,251,
3538,2014,152,125,277,
3539,1965,157,103,260,
3540,1990,128,123,251,
3541,1919,135,104,239,
3542,2015,160,115,275,
3543,2008,146,102,248,
3544,1944,131,99,230,
3545,2021,154,102,256,
3546,1938,146,125,271,
3547,1927,146,90,236,
3548,1831,106,104,210,
3549,1930,130,120,250,
3550,1936,151,109,260,
3551,1919,132,92,224,
3552,1753,123,112,235,
3553,1915,144,100,244,
3554,1886,142,106,248,
3555,2019,158,117,275,
3556,1904,133,106,239,
3557,1935,136,123,259,
3558,1925,143,115,258,
3559,1991,134,103,237,
3560,1979,124,107,231,
3561,1995,143,109,252,
3562,1959,137,110,247,
3563,1899,161,119,280,
3564,1988,142,126,268,
3565,2060,164,109,273,
3566,1891,131,112,243,
3567,2027,154,123,277,
3568,1958,148,120,268,
3569,1981,145,128,273,
3570,2010,144,93,237,
3571,1956,165,115,280,
3572,1857,132,110,242,
3573,1981,143,108,251,
3574,1881,137,107,244,
3575,1988,136,97,233,
3576,2034,150,116,266,
3577,1950,142,95,237,
3578,1992,159,93,252,
3579,1951,152,120,272,
3580,1866,138,105,243,
3581,2079,149,117,266,
3582,1918,128,91,219,
3583,1984,149,121,270,
3584,1985,167,112,279,
3585,1932,161,115,276,
3586,1965,153,88,241,
3587,1995,131,126,257,
3588,1982,169,112,281,
3589,2025,149,114,263,
3590,1920,141,112,253,
3591,1952,144,129,273,
3592,1986,125,106,231,
3593,1952,115,107,222,
3594,1984,163,119,282,
3595,2035,168,114,282,
3596,1980,147,100,247,
3597,1940,144,128,272,
3598,1850,149,119,268,
3599,2058,150,123,273,
3600,1998,152,105,257,
3601,1877,122,103,225,
3602,2038,181,110,291,
3603,1994,133,108,241,
3604,2047,143,126,269,
3605,1949,142,111,253,
3606,1958,139,124,263,
3607,1980,137,118,255,
3608,1983,139,122,261,
3609,2084,128,131,259,
3610,1972,122,131,253,
3611,1956,116,99,215,
3612,2076,160,112,272,
3613,1945,136,116,252,
3614,1952,144,109,253,
3615,1947,144,115,259,
3616,1922,142,88,230,
3617,1930,154,109,263,
3618,1957,147,103,250,
3619,1987,123,111,234,
3620,2022,148,115,263,
3621,2031,163,133,296,
3622,1906,122,98,220,
3623,2000,160,118,278,
3624,1928,127,108,235,
3625,1972,152,114,266,
3626,1891,127,111,238,
3627,1865,154,104,258,
3628,1937,136,111,247,
3629,1926,140,122,262,
3630,1894,128,92,220,
3631,1956,152,110,262,
3632,1987,154,100,254,
3633,1998,146,104,250,
3634,1998,153,111,264,
3635,2001,142,119,261,
3636,1988,152,101,253,
3637,2000,191,129,320,
3638,2037,146,122,268,
3639,1936,131,91,222,
3640,1946,135,109,244,
3641,1995,133,115,248,
3642,2006,142,116,258,
3643,1893,143,111,254,
3644,1856,122,103,225,
3645,2024,156,120,276,
3646,1968,159,119,278,
3647,1922,146,115,261,
3648,1894,140,108,248,
3649,1931,147,110,257,
3650,1957,153,120,273,
3651,1915,153,113,266,
3652,1997,137,122,259,
3653,2032,152,106,258,
3654,1965,139,100,239,
3655,1952,148,98,246,
3656,1907,156,116,272,
3657,2016,149,115,264,
3658,2011,123,108,231,
3659,1927,142,98,240,
3660,1960,163,107,270,
3661,2018,141,114,255,
3662,2102,143,116,259,
3663,1929,147,119,266,
3664,1975,136,138,274,
3665,1983,153,133,286,
3666,1994,125,100,225,
3667,1946,145,109,254,
3668,1907,137,100,237,
3669,1931,157,117,274,
3670,1969,161,87,248,
3671,1989,138,98,236,
3672,1988,161,131,292,
3673,1992,171,105,276,
3674,1893,135,114,249,
3675,1945,158,105,263,
3676,1957,135,101,236,
3677,1947,140,103,243,
3678,1969,133,104,237,
3679,1960,149,102,251,
3680,1973,137,136,273,
3681,2046,147,116,263,
3682,2016,154,103,257,
3683,1970,134,123,257,
3684,1962,157,101,258,
3685,1981,147,121,268,
3686,1976,145,115,260,
3687,1998,150,126,276,
3688,1933,125,110,235,
3689,1970,141,97,238,
3690,1954,138,108,246,
3691,1947,146,111,257,
3692,1927,145,105,250,
3693,1982,155,120,275,
3694,1921,136,93,229,
3695,1964,167,101,268,
3696,1957,137,121,258,
3697,1961,136,100,236,
3698,1943,136,116,252,
3699,1934,163,107,270,
3700,1958,132,130,262,
3701,1949,121,108,229,
3702,2000,130,96,226,
3703,2021,159,111,270,
3704,1958,146,142,288,
3705,1970,148,100,248,
3706,2040,147,121,268,
3707,2003,139,112,251,
3708,1995,157,124,281,
3709,2015,127,131,258,
3710,1932,132,124,256,
3711,2006,128,120,248,
3712,1963,137,119,256,
3713,1993,128,119,247,
3714,2034,153,117,270,
3715,1943,159,109,268,
3716,1989,157,113,270,
3717,1989,157,111,268,
3718,1937,131,98,229,
3719,1986,135,130,265,
3720,1996,141,107,248,
3721,2003,151,99,250,
3722,1976,156,101,257,
3723,1873,143,125,268,
3724,1954,154,104,258,
3725,2000,139,115,254,
3726,2041,149,120,269,
3727,1945,143,110,253,
3728,2111,171,114,285,
3729,1947,128,112,240,
3730,1865,155,95,250,
3731,1887,146,120,266,
3732,1928,139,119,258,
3733,2000,144,121,265,
3734,1953,137,105,242,
3735,1984,141,117,258,
3736,1922,155,91,246,
3737,1940,147,117,264,
3738,2010,146,122,268,
3739,1946,143,104,247,
3740,1927,130,115,245,
3741,1932,135,107,242,
3742,1958,145,109,254,
3743,2022,168,112,280,
3744,1982,137,123,260,
3745,2043,128,130,258,
3746,2003,169,102,271,
3747,2003,143,106,249,
3748,2063,157,116,273,
3749,1889,147,100,247,
3750,2003,155,123,278,
3751,1969,148,114,262,
3752,2005,150,107,257,
3753,1926,127,96,223,
3754,1951,137,111,248,
3755,1971,141,123,264,
3756,1914,118,100,218,
3757,1945,140,114,254,
3758,1975,141,98,239,
3759,2001,148,103,251,
3760,1991,176,111,287,
3761,2013,135,96,231,
3762,1980,150,106,256,
3763,1919,141,108,249,
3764,1930,153,97,250,
3765,2050,145,123,268,
3766,1939,122,113,235,
3767,1894,125,90,215,
3768,1919,167,122,289,
3769,2042,149,132,281,
3770,2019,163,111,274,
3771,2026,152,115,267,
3772,1969,132,119,251,
3773,2092,142,113,255,
3774,1989,164,116,280,
3775,1997,175,126,301,
3776,1950,126,115,241,
3777,1942,141,112,253,
3778,1948,151,106,257,
3779,2038,147,110,257,
3780,1968,141,99,240,
3781,1926,123,96,219,
3782,2010,157,106,263,
3783,2069,155,120,275,
3784,2052,137,87,224,
3785,1945,137,111,248,
3786,1985,138,126,264,
3787,1939,149,96,245,
3788,1920,134,106,240,
3789,2025,154,113,267,
3790,1867,130,108,238,
3791,1953,132,94,226,
3792,1899,134,107,241,
3793,1974,126,95,221,
3794,1958,153,108,261,
3795,1960,141,104,245,
3796,1906,145,105,250,
3797,1911,132,108,240,
3798,2014,151,125,276,
3799,1944,142,113,255,
3800,1939,130,122,252,
3801,1897,138,101,239,
3802,2000,147,110,257,
3803,1976,163,121,284,
3804,1972,164,100,264,
3805,1923,122,124,246,
3806,1972,138,95,233,
3807,2007,163,129,292,
3808,1992,144,112,256,
3809,1974,158,126,284,
3810,1938,131,112,243,
3811,2016,156,109,265,
3812,1970,152,99,251,
3813,1957,132,97,229,
3814,1961,157,113,270,
3815,1932,116,114,230,
3816,1993,130,108,238,
3817,1932,125,112,237,
3818,2053,151,135,286,
3819,1958,120,121,241,
3820,1955,158,104,262,
3821,1893,134,114,248,
3822,1975,148,104,252,
3823,2024,166,98,264,
3824,2001,142,128,270,
3825,2022,143,112,255,
3826,2016,140,117,257,
3827,1895,148,116,264,
3828,1945,152,117,269,
3829,2007,153,128,281,
3830,1937,139,118,257,
3831,2015,155,130,285,
3832,1870,138,94,232,
3833,1892,153,100,253,
3834,1981,142,121,263,
3835,1988,151,122,273,
3836,1904,131,112,243,
3837,1977,131,96,227,
3838,1951,145,109,254,
3839,1945,114,102,216,
3840,1978,154,123,277,
3841,2065,146,109,255,
3842,1981,128,108,236,
3843,1971,151,109,260,
3844,1934,131,106,237,
3845,1920,146,110,256,
3846,1894,133,107,240,
3847,2113,152,111,263,
3848,1984,149,87,236,
3849,1917,155,107,262,
3850,2059,138,111,249,
3851,1968,145,115,260,
3852,2008,157,114,271,
3853,1996,152,129,281,
3854,1930,143,118,261,
3855,1943,150,116,266,
3856,2072,136,112,248,
3857,2006,144,113,257,
3858,2083,136,133,269,
3859,2026,147,116,263,
3860,1974,149,113,262,
3861,2025,153,112,265,
3862,1950,119,106,225,
3863,2002,139,95,234,
3864,1999,121,102,223,
3865,1948,148,114,262,
3866,2053,141,149,290,
3867,1928,140,119,259,
3868,1944,127,122,249,
3869,1983,144,112,256,
3870,1949,142,117,259,
3871,1993,135,106,241,
3872,2032,164,108,272,
3873,1928,154,104,258,
3874,1926,131,113,244,
3875,2025,153,120,273,
3876,1936,152,130,282,
3877,1982,161,116,277,
3878,1885,128,96,224,
3879,1967,138,92,230,
3880,1873,146,120,266,
3881,1921,156,96,252,
3882,1974,148,110,258,
3883,1965,124,119,243,
3884,1970,139,117,256,
3885,1956,144,107,251,
3886,2003,127,128,255,
3887,1995,150,117,267,
3888,1915,175,107,282,
3889,1989,138,114,252,
3890,2012,151,115,266,
3891,1942,125,115,240,
3892,1880,154,117,271,
3893,1959,129,127,256,
3894,1963,138,111,249,
3895,2051,134,106,240,
3896,1950,133,103,236,
3897,1971,141,139,280,
3898,1915,132,96,228,
3899,1916,149,118,267,
3900,1994,136,117,253,
3901,1954,128,107,235,
3902,1973,139,107,246,
3903,1872,108,100,208,
3904,2030,144,121,265,
3905,1975,148,99,247,
3906,1995,135,113,248,
3907,1992,145,118,263,
3908,2000,154,96,250,
3909,2026,151,96,247,
3910,1928,136,108,244,
3911,1950,149,99,248,
3912,1953,136,101,237,
3913,1938,147,104,251,
3914,1959,149,99,248,
3915,2042,161,123,284,
3916,1966,137,110,247,
3917,1937,162,115,277,
3918,2065,172,118,290,
3919,1889,148,129,277,
3920,1994,139,117,256,
3921,1951,133,123,256,
3922,1962,153,125,278,
3923,1967,129,79,208,
3924,1924,144,100,244,
3925,2022,143,102,245,
3926,1909,142,115,257,
3927,1954,154,134,288,
3928,1867,135,122,257,
3929,1951,140,132,272,
3930,1944,157,114,271,
3931,1985,141,123,264,
3932,1970,144,123,267,
3933,1917,124,99,223,
3934,2000,134,106,240,
3935,1977,136,99,235,
3936,1953,133,105,238,
3937,2016,148,116,264,
3938,1938,152,107,259,
3939,1924,117,110,227,
3940,1916,133,113,246,
3941,1972,160,125,285,
3942,1967,143,115,258,
3943,2010,159,116,275,
3944,1915,144,110,254,
3945,1949,146,111,257,
3946,2000,141,115,256,
3947,2048,153,142,295,
3948,2037,166,95,261,
3949,1997,142,125,267,
3950,1929,163,104,267,
3951,2006,130,113,243,
3952,1973,146,104,250,
3953,1990,121,108,229,
3954,2046,137,116,253,
3955,1984,164,95,259,
3956,1998,151,118,269,
3957,1940,153,108,261,
3958,2042,148,131,279,
3959,1927,154,107,261,
3960,1998,144,103,247,
3961,1910,137,137,274,
3962,1973,147,114,261,
3963,1888,127,135,262,
3964,1896,121,106,227,
3965,1919,147,116,263,
3966,1907,147,114,261,
3967,1870,138,106,244,
3968,1942,145,100,245,
3969,2007,156,109,265,
3970,1964,165,84,249,
3971,1976,132,117,249,
3972,1932,151,105,256,
3973,1972,129,106,235,
3974,1970,146,109,255,
3975,1937,130,91,221,
3976,1997,146,116,262,
3977,1897,137,96,233,
3978,1993,118,126,244,
3979,1975,135,99,234,
3980,1916,129,124,253,
3981,1974,147,112,259,
3982,1907,147,118,265,
3983,1889,149,98,247,
3984,1958,144,114,258,
3985,1987,133,114,247,
3986,2004,133,116,249,
3987,1962,150,122,272,
3988,2039,133,113,246,
3989,1972,130,101,231,
3990,1985,160,128,288,
3991,2035,168,127,295,
3992,1946,141,120,261,
3993,1995,152,100,252,
3994,1953,140,115,255,
3995,2046,148,102,250,
3996,1970,139,113,252,
3997,1952,138,133,271,
3998,1978,138,111,249,
3999,1937,132,120,252,
4000,2073,152,121,273,
4001,2017,139,113,252,
4002,1948,140,122,262,
4003,1981,158,121,279,
4004,1966,145,120,265,
4005,2009,152,117,269,
4006,1997,156,116,272,
4007,2022,141,101,242,
4008,1945,151,123,274,
4009,1985,139,105,244,
4010,1935,146,99,245,
4011,2017,158,107,265,
4012,2016,128,111,239,
4013,1888,133,99,232,
4014,1942,135,120,255,
4015,2047,143,121,264,
4016,2086,137,122,259,
4017,2056,138,125,263,
4018,1925,134,93,227,
4019,2002,149,104,253,
4020,1942,122,139,261,
4021,2051,144,116,260,
4022,2013,157,112,269,
4023,1912,150,105,255,
4024,1959,163,98,261,
4025,1992,142,112,254,
4026,1912,142,112,254,
4027,1963,131,118,249,
4028,1978,129,99,228,
4029,1958,131,104,235,
4030,2036,162,122,284,
4031,2011,141,116,257,
4032,1949,155,97,252,
4033,1987,151,118,269,
4034,2042,157,102,259,
4035,1971,150,119,269,
4036,1862,118,101,219,
4037,1991,166,111,277,
4038,1997,155,126,281,
4039,1988,156,80,236,
4040,1998,144,104,248,
4041,1898,152,101,253,
4042,1995,161,126,287,
4043,1911,154,122,276,
4044,1999,152,109,261,
4045,2020,166,125,291,
4046,1990,159,99,258,
4047,1953,139,130,269,
4048,2005,127,122,249,
4049,2004,137,121,258,
4050,1900,157,107,264,
4051,1989,142,134,276,
4052,1913,146,115,261,
4053,1938,127,110,237,
4054,2041,143,107,250,
4055,1981,145,112,257,
4056,1909,146,97,243,
4057,2003,130,109,239,
4058,1942,149,125,274,
4059,1891,131,121,252,
4060,1965,152,108,260,
4061,1914,153,106,259,
4062,1996,141,96,237,
4063,1973,140,111,251,
4064,1987,144,135,279,
4065,1989,154,114,268,
4066,1984,152,102,254,
4067,1950,138,110,248,
4068,1959,141,111,252,
4069,2018,130,120,250,
4070,1969,155,116,271,
4071,2069,134,100,234,
4072,1987,139,104,243,
4073,1973,159,120,279,
4074,1937,140,106,246,
4075,1878,110,121,231,
4076,2033,152,113,265,
4077,2072,156,96,252,
4078,1937,128,119,247,
4079,1877,131,91,222,
4080,2010,148,93,241,
4081,1996,139,105,244,
4082,1978,155,97,252,
4083,1948,158,113,271,
4084,1968,148,116,264,
4085,2034,149,108,257,
4086,2009,164,102,266,
4087,1902,131,125,256,
4088,2034,149,110,259,
4089,1918,149,98,247,
4090,1859,148,109,257,
4091,1963,148,115,263,
4092,1918,154,105,259,
4093,1950,139,87,226,
4094,1889,119,117,236,
4095,2002,149,102,251,
4096,1995,108,114,222,
4097,2021,128,120,248,
4098,2084,172,122,294,
4099,2045,129,118,247,
4101,1997,148,122,270,
4102,1923,133,115,248,
4103,1967,124,102,226,
4104,1938,146,107,253,
4105,2007,138,124,262,
4106,1989,151,118,269,
4107,1844,140,102,242,
4108,1966,132,119,251,
4109,1965,144,113,257,
4110,1930,116,106,222,
4111,2015,127,128,255,
4112,1901,151,111,262,
4113,1917,152,102,254,
4114,1938,133,90,223,
4115,2008,156,127,283,
4116,1913,132,118,250,
4117,1878,144,110,254,
4118,1920,133,111,244,
4119,2067,148,121,269,
4120,1944,148,118,266,
4121,2008,135,134,269,
4122,1944,127,95,222,
4123,2047,140,118,258,
4124,2029,146,95,241,
4125,1983,132,110,242,
4126,1983,132,93,225,
4127,1981,129,94,223,
4128,1995,131,108,239,
4129,1987,141,119,260,
4130,2017,140,121,261,
4131,1917,134,111,245,
4132,1871,129,98,227,
4133,2026,159,121,280,
4134,2001,147,102,249,
4135,1975,132,98,230,
4136,1982,143,104,247,
4137,1984,146,109,255,
4138,1967,159,109,268,
4139,1942,128,101,229,
4140,1928,138,116,254,
4141,2007,155,110,265,
4142,1943,148,92,240,
4143,2018,135,119,254,
4144,1902,144,109,253,
4145,1880,147,109,256,
4146,1976,135,110,245,
4147,1983,155,117,272,
4148,1924,138,117,255,
4149,1964,120,118,238,
4150,1975,148,104,252,
4151,1985,136,98,234,
4152,1909,135,108,243,
4153,1976,134,104,238,
4154,2049,164,121,285,
4155,1908,130,116,246,
4156,1906,150,102,252,
4157,1977,153,105,258,
4158,1957,134,106,240,
4159,2006,132,127,259,
4160,2000,148,109,257,
4161,1944,133,105,238,
4162,1966,146,112,258,
4163,1927,147,101,248,
4164,1900,142,116,258,
4165,1906,150,119,269,
4166,1953,134,113,247,
4167,1905,123,102,225,
4168,1941,144,128,272,
4169,1978,156,109,265,
4170,1934,123,127,250,
4171,1941,147,77,224,
4172,2029,134,120,254,
4173,2014,144,104,248,
4174,2036,168,97,265,
4175,1962,129,118,247,
4176,1991,144,115,259,
4177,2019,136,133,269,
4178,1911,146,114,260,
4179,1922,126,111,237,
4180,2009,143,125,268,
4181,2082,142,118,260,
4182,1965,129,110,239,
4183,2059,153,105,258,
4184,1990,138,111,249,
4185,1990,149,122,271,
4186,1959,134,131,265,
4187,1994,144,128,272,
4188,1883,135,86,221,
4189,1877,115,111,226,
4190,1909,123,112,235,
4191,1972,156,102,258,
4192,1866,129,118,247,
4193,1951,139,120,259,
4194,1953,137,115,252,
4195,1994,148,104,252,
4196,1963,148,106,254,
4197,1885,134,128,262,
4198,1968,120,111,231,
4199,1966,138,128,266,
4200,1953,158,122,280,
4201,2020,145,115,260,
4202,2005,114,109,223,
4203,2053,165,115,280,
4204,1967,129,96,225,
4205,1998,144,122,266,
4206,1945,140,108,248,
4207,1971,131,104,235,
4208,1938,145,112,257,
4209,1961,140,121,261,
4210,1972,172,112,284,
4211,1915,150,107,257,
4212,1952,144,105,249,
4213,1898,134,123,257,
4214,1958,153,118,271,
4215,1949,128,124,252,
4216,1965,139,116,255,
4217,2034,151,119,270,
4218,2055,153,107,260,
4219,1939,149,89,238,
4220,1920,135,116,251,
4221,2000,144,108,252,
4222,1926,156,111,267,
4223,1901,144,109,253,
4224,1986,154,112,266,
4225,1942,134,121,255,
4226,1990,138,123,261,
4227,1992,170,107,277,
4228,1971,156,99,255,
4229,2017,158,114,272,
4230,1916,138,129,267,
4231,1954,155,118,273,
4232,1986,148,101,249,
4233,1948,139,120,259,
4234,1934,136,103,239,
4235,1966,161,110,271,
4236,1914,140,129,269,
4237,1955,156,110,266,
4238,1997,156,110,266,
4239,2008,149,110,259,
4240,1986,140,106,246,
4241,1948,148,129,277,
4242,1995,157,108,265,
4243,1927,141,131,272,
4244,2006,143,121,264,
4245,1996,144,107,251,
4246,1953,152,125,277,
4247,1961,134,114,248,
4248,2038,150,112,262,
4249,1975,135,128,263,
4250,2080,162,108,270,
4251,1944,142,115,257,
4252,1989,155,115,270,
4253,1897,151,96,247,
4254,1928,127,113,240,
4255,1946,160,116,276,
4256,1958,148,96,244,
4257,1966,122,101,223,
4258,1997,110,129,239,
4259,1972,133,102,235,
4260,1885,125,121,246,
4261,2010,132,121,253,
4262,1923,141,113,254,
4263,1887,145,121,266,
4264,1982,145,114,259,
4265,1981,127,115,242,
4266,1969,145,125,270,
4267,1979,172,122,294,
4268,1959,147,118,265,
4269,1951,142,105,247,
4270,1883,120,93,213,
4271,1979,130,123,253,
4272,1942,139,135,274,
4273,1937,156,123,279,
4274,1996,157,114,271,
4275,1983,149,110,259,
4276,1938,135,98,233,
4277,1862,142,102,244,
4278,1977,140,100,240,
4279,2026,130,133,263,
4280,2037,139,125,264,
4281,2029,146,111,257,
4282,2007,128,99,227,
4283,1993,151,96,247,
4284,2010,140,123,263,
4285,1946,131,102,233,
4286,1998,153,112,265,
4287,1928,145,96,241,
4288,1965,150,104,254,
4289,1929,153,99,252,
4290,1939,135,122,257,
4291,1865,153,94,247,
4292,2046,159,134,293,
4293,1926,135,98,233,
4294,1906,152,106,258,
4295,2043,163,103,266,
4296,1952,146,109,255,
4297,2003,173,113,286,
4298,1979,134,106,240,
4299,1924,188,85,273,
4300,1992,151,112,263,
4301,2009,160,113,273,
4302,2073,139,122,261,
4303,1988,132,116,248,
4304,1958,133,96,229,
4305,1966,145,107,252,
4306,1993,124,105,229,
4307,1918,156,109,265,
4308,1965,143,132,275,
4309,1995,136,112,248,
4310,1877,131,100,231,
4311,1937,121,105,226,
4312,1972,131,112,243,
4313,1922,144,107,251,
4314,1918,133,114,247,
4315,2027,149,98,247,
4316,1982,141,125,266,
4317,2086,143,107,250,
4318,1903,121,106,227,
4319,1966,136,123,259,
4320,1950,137,118,255,
4321,1920,152,113,265,
4322,1963,122,96,218,
4323,1905,145,94,239,
4324,2040,166,117,283,
4325,1961,156,121,277,
4326,1937,157,114,271,
4327,1909,159,98,257,
4328,2004,154,115,269,
4329,1996,128,120,248,
4330,1941,158,125,283,
4331,1912,173,101,274,
4332,1886,141,107,248,
4333,1965,131,113,244,
4334,1881,148,96,244,
4335,1977,139,123,262,
4336,1983,137,124,261,
4337,2007,154,113,267,
4338,1959,148,109,257,
4339,1954,146,120,266,
4340,2082,164,137,301,
4341,1969,159,114,273,
4342,1942,130,102,232,
4343,1945,135,109,244,
4344,1976,156,109,265,
4345,1912,143,128,271,
4346,2011,147,121,268,
4347,2003,144,107,251,
4348,1976,137,139,276,
4349,1918,160,107,267,
4350,2021,135,124,259,
4351,1966,154,108,262,
4352,1944,134,117,251,
4353,1965,142,115,257,
4354,1982,146,125,271,
4355,2013,146,130,276,
4356,1912,140,117,257,
4357,1947,155,113,268,
4358,1941,123,122,245,
4359,1997,152,109,261,
4360,1940,151,98,249,
4361,1891,161,109,270,
4362,1949,152,122,274,
4363,1896,132,102,234,
4364,1919,121,115,236,
4365,1879,121,109,230,
4366,1883,150,88,238,
4367,1986,156,105,261,
4368,1995,149,115,264,
4369,1950,121,101,222,
4370,1895,122,112,234,
4371,1866,151,105,256,
4372,1938,139,99,238,
4373,1956,160,119,279,
4374,2033,148,114,262,
4375,1902,123,126,249,
4376,1987,147,114,261,
4377,2038,127,120,247,
4378,1971,150,132,282,
4379,2014,131,111,242,
4380,1938,149,103,252,
4381,1938,143,118,261,
4382,2024,134,110,244,
4383,1962,140,130,270,
4384,1928,118,114,232,
4385,1983,147,123,270,
4386,1972,163,114,277,
4387,2052,134,120,254,
4388,1943,146,123,269,
4389,2037,142,121,263,
4390,1975,153,111,264,
4391,1941,139,121,260,
4392,1871,149,107,256,
4393,2015,160,121,281,
4394,1988,132,108,240,
4395,1999,144,120,264,
4396,2009,162,118,280,
4397,1966,127,116,243,
4398,1984,135,119,254,
4399,1945,152,115,267,
4400,1880,138,107,245,
4401,2054,161,133,294,
4402,2022,141,120,261,
4403,2011,163,137,300,
4404,1995,152,119,271,
4405,1925,132,110,242,
4406,1960,156,108,264,
4407,1955,150,108,258,
4408,2022,145,139,284,
4409,1977,147,100,247,
4410,1961,146,111,257,
4411,1961,136,104,240,
4412,1958,134,111,245,
4413,1960,149,99,248,
4414,1965,148,124,272,
4415,1953,141,117,258,
4416,1988,164,114,278,
4417,1954,140,105,245,
4418,1934,151,114,265,
4419,1944,133,91,224,
4420,1954,134,123,257,
4421,2026,151,123,274,
4422,1902,123,111,234,
4423,2038,155,128,283,
4424,1994,159,119,278,
4425,1953,135,116,251,
4426,1973,147,109,256,
4427,1920,121,114,235,
4428,1971,155,110,265,
4429,1925,130,112,242,
4430,1987,128,115,243,
4431,1986,159,95,254,
4432,1994,157,128,285,
4433,1907,128,88,216,
4434,2001,162,88,250,
4435,1844,130,91,221,
4436,1898,139,102,241,
4437,1994,151,125,276,
4438,1990,138,125,263,
4439,1892,142,130,272,
4440,1957,147,122,269,
4441,1994,148,108,256,
4442,2002,134,117,251,
4443,1935,144,98,242,
4444,1971,141,97,238,
4445,1906,143,108,251,
4446,2032,142,103,245,
4447,1926,135,112,247,
4448,1986,140,115,255,
4449,1924,133,90,223,
4450,1942,143,116,259,
4451,2005,141,110,251,
4452,1926,123,106,229,
4453,2002,149,122,271,
4454,1950,138,119,257,
4455,2031,166,104,270,
4456,1850,121,110,231,
4457,2003,130,102,232,
4458,2005,140,122,262,
4459,1987,168,125,293,
4460,1951,145,113,258,
4461,1919,148,95,243,
4462,1941,143,115,258,
4463,2013,142,113,255,
4464,1969,153,110,263,
4465,1970,136,122,258,
4466,1921,146,118,264,
4467,1998,147,113,260,
4468,1997,137,127,264,
4469,1979,150,111,261,
4470,1987,148,107,255,
4471,1897,135,111,246,
4472,1986,137,115,252,
4473,1903,162,93,255,
4474,2009,128,126,254,
4475,1975,147,94,241,
4476,1942,134,105,239,
4477,2075,156,132,288,
4478,1964,148,110,258,
4479,1945,131,103,234,
4480,1893,130,118,248,
4481,1910,124,103,227,
4482,2001,146,118,264,
4483,1993,143,113,256,
4484,1979,163,117,280,
4485,1964,159,122,281,
4486,1980,149,110,259,
4487,1953,127,106,233,
4488,1950,138,96,234,
4489,2032,133,101,234,
4490,2052,119,118,237,
4491,2026,128,117,245,
4492,1981,136,118,254,
4493,1884,136,115,251,
4494,2010,145,110,255,
4495,1906,160,118,278,
4496,1933,142,109,251,
4497,1968,150,110,260,
4498,2098,143,93,236,
4499,1924,146,104,250,
4500,1988,130,139,269,
4501,1960,139,102,241,
4502,1999,132,123,255,
4503,1981,137,120,257,
4504,2032,142,102,244,
4505,1905,143,125,268,
4506,1966,164,106,270,
4507,1970,141,112,253,
4508,1958,162,114,276,
4509,1959,144,113,257,
4510,1933,150,111,261,
4511,2014,157,110,267,
4512,1969,133,114,247,
4513,1976,142,111,253,
4514,1959,134,111,245,
4515,1888,149,121,270,
4516,1936,149,114,263,
4517,1956,132,126,258,
4518,1942,146,114,260,
4519,1999,152,110,262,
4520,2020,131,111,242,
4521,1995,173,100,273,
4522,2020,138,130,268,
4523,2028,142,117,259,
4524,1974,139,115,254,
4525,1981,161,117,278,
4526,1900,122,105,227,
4527,1960,141,95,236,
4528,1927,118,115,233,
4529,1941,135,106,241,
4530,1890,138,103,241,
4531,1942,146,98,244,
4532,1943,125,146,271,
4533,1878,155,90,245,
4534,2006,155,107,262,
4535,1928,139,107,246,
4536,2038,148,107,255,
4537,2054,180,93,273,
4538,1958,150,114,264,
4539,1958,129,100,229,
4540,1999,133,112,245,
4541,1960,150,120,270,
4542,1887,153,107,260,
4543,1977,149,103,252,
4544,1998,146,120,266,
4545,2019,146,98,244,
4546,1942,149,108,257,
4547,1952,150,100,250,
4548,1932,139,126,265,
4549,2037,146,108,254,
4550,1931,127,113,240,
4551,1935,135,108,243,
4552,2025,150,116,266,
4553,1958,132,105,237,
4554,1964,152,120,272,
4555,2001,141,110,251,
4556,1936,148,102,250,
4557,1950,142,110,252,
4558,1917,145,113,258,
4559,1916,150,94,244,
4560,2002,140,100,240,
4561,1934,126,114,240,
4562,1929,144,95,239,
4563,1956,148,118,266,
4564,2032,153,119,272,
4565,1977,165,114,279,
4566,1947,128,104,232,
4567,1989,175,121,296,
4568,1934,140,104,244,
4569,1925,116,99,215,
4570,2086,148,131,279,
4571,1985,143,111,254,
4572,1950,145,111,256,
4573,1909,138,105,243,
4574,1954,130,116,246,
4575,1923,159,104,263,
4576,1906,139,124,263,
4577,1993,161,124,285,
4578,2054,163,84,247,
4579,2028,148,139,287,
4580,1962,138,98,236,
4581,1921,152,110,262,
4582,1929,144,121,265,
4583,1963,149,113,262,
4584,1934,130,106,236,
4585,1937,157,125,282,
4586,1977,142,101,243,
4587,2010,155,127,282,
4588,1965,132,92,224,
4589,1928,144,114,258,
4590,1947,141,115,256,
4591,1930,134,107,241,
4592,2041,159,122,281,
4593,1968,144,123,267,
4594,1988,148,124,272,
4595,1922,140,116,256,
4596,2014,149,113,262,
4597,1972,142,116,258,
4598,2039,148,106,254,
4599,1946,140,113,253,
4600,1945,145,117,262,
4601,1933,136,97,233,
4602,1950,154,128,282,
4603,2066,130,110,240,
4604,1963,167,96,263,
4605,1903,138,99,237,
4606,1908,149,103,252,
4607,2006,140,110,250,
4608,2056,144,119,263,
4609,1920,152,112,264,
4610,1961,151,118,269,
4611,1924,133,106,239,
4612,1955,159,105,264,
4613,2018,139,116,255,
4614,2056,123,121,244,
4615,1996,149,114,263,
4616,1964,129,112,241,
4617,1997,154,104,258,
4618,1928,155,132,287,
4619,2005,170,109,279,
4620,1990,139,105,244,
4621,1953,157,118,275,
4622,1958,141,109,250,
4623,1989,143,111,254,
4624,2032,122,119,241,
4625,2055,152,114,266,
4626,1936,130,120,250,
4627,1881,139,124,263,
4628,1926,130,107,237,
4629,2027,167,121,288,
4630,2010,163,107,270,
4631,1956,157,116,273,
4632,1962,170,122,292,
4633,1968,137,110,247,
4634,2011,147,121,268,
4635,1949,141,100,241,
4636,2029,153,126,279,
4637,1905,133,105,238,
4638,2046,134,108,242,
4639,1941,143,133,276,
4640,1949,173,105,278,
4641,2036,151,112,263,
4642,1908,127,125,252,
4643,2013,120,119,239,
4644,1861,130,108,238,
4645,1898,142,100,242,
4646,1959,156,121,277,
4647,1970,147,117,264,
4648,1884,136,119,255,
4649,1949,147,133,280,
4650,2062,134,127,261,
4651,1889,120,103,223,
4652,1889,138,107,245,
4653,1856,138,104,242,
4654,1911,124,112,236,
4655,1973,150,90,240,
4656,2020,129,108,237,
4657,1990,133,107,240,
4658,1937,151,103,254,
4659,1929,136,102,238,
4660,1971,125,111,236,
4661,1980,149,100,249,
4662,1988,149,111,260,
4663,1816,134,106,240,
4664,2020,159,115,274,
4665,1992,152,97,249,
4666,1898,133,109,242,
4667,1956,129,117,246,
4668,2025,124,120,244,
4669,2030,146,125,271,
4670,1999,158,112,270,
4671,1919,154,92,246,
4672,1960,137,121,258,
4673,1901,124,115,239,
4674,1983,135,117,252,
4675,1956,154,110,264,
4676,2017,137,129,266,
4677,1962,149,102,251,
4678,1989,141,109,250,
4679,1968,157,109,266,
4680,1925,129,115,244,
4681,2011,150,110,260,
4682,1885,147,99,246,
4683,1982,145,117,262,
4684,1994,136,115,251,
4685,1948,143,102,245,
4686,1923,151,117,268,
4687,1929,152,99,251,
4688,1956,137,91,228,
4689,1926,151,129,280,
4690,1916,124,113,237,
4691,1982,141,96,237,
4692,1938,150,106,256,
4693,2012,169,119,288,
4694,1997,135,118,253,
4695,1997,145,92,237,
4696,1980,146,113,259,
4697,1918,128,110,238,
4698,1950,147,121,268,
4699,1887,133,120,253,
4700,2051,150,127,277,
4701,1995,134,123,257,
4702,2093,161,132,293,
4703,2053,150,129,279,
4704,2079,131,134,265,
4705,1852,130,115,245,
4706,2053,158,111,269,
4707,1956,155,122,277,
4708,1983,144,123,267,
4709,1946,149,120,269,
4710,1939,132,109,241,
4711,1910,133,104,237,
4712,1925,135,104,239,
4713,1918,133,99,232,
4714,1984,140,110,250,
4715,1970,164,115,279,
4716,1920,156,129,285,
4717,1973,140,121,261,
4718,2039,135,117,252,
4719,2029,167,107,274,
4720,1888,144,97,241,
4721,1912,138,112,250,
4722,1977,161,120,281,
4723,1976,144,107,251,
4724,1964,150,100,250,
4725,1999,165,117,282,
4726,1956,135,125,260,
4727,1999,162,113,275,
4728,1965,153,116,269,
4729,1924,162,103,265,
4730,1899,151,95,246,
4731,1994,141,132,273,
4732,1976,139,123,262,
4733,1911,150,117,267,
4734,1907,154,105,259,
4735,1904,124,110,234,
4736,1877,125,113,238,
4737,1996,148,99,247,
4738,1977,141,108,249,
4739,1957,153,113,266,
4740,1939,120,120,240,
4741,1997,132,101,233,
4742,1964,122,113,235,
4743,1978,149,118,267,
4744,2019,135,101,236,
4745,1979,143,121,264,
4746,1934,138,111,249,
4747,1944,138,111,249,
4748,1969,147,107,254,
4749,2008,130,154,284,
4750,1912,147,113,260,
4751,1984,155,100,255,
4752,1977,139,113,252,
4753,1885,134,110,244,
4754,1983,149,114,263,
4755,1964,143,111,254,
4756,1984,137,124,261,
4757,1938,142,126,268,
4758,1885,155,118,273,
4759,1955,146,109,255,
4760,1896,136,106,242,
4761,1961,140,116,256,
4762,1942,166,96,262,
4763,1990,144,105,249,
4764,1920,135,103,238,
4765,1941,133,116,249,
4766,2009,163,131,294,
4767,1970,142,108,250,
4768,1943,163,101,264,
4769,1899,132,109,241,
4770,1935,121,108,229,
4771,1973,153,106,259,
4772,1912,149,120,269,
4773,1960,150,113,263,
4774,1989,146,101,247,
4775,2027,150,127,277,
4776,1966,166,111,277,
4777,2027,164,101,265,
4778,2014,172,120,292,
4779,1961,134,107,241,
4780,1955,130,118,248,
4781,1944,156,106,262,
4782,1919,131,111,242,
4783,1980,140,97,237,
4784,1955,140,101,241,
4785,1952,153,107,260,
4786,1976,160,102,262,
4787,2037,136,115,251,
4788,1901,139,123,262,
4789,1945,122,108,230,
4790,1957,138,128,266,
4791,2021,163,110,273,
4792,2014,129,100,229,
4793,1902,144,110,254,
4794,1949,148,98,246,
4795,1924,128,121,249,
4796,2006,166,104,270,
4797,1874,143,101,244,
4798,1897,133,120,253,
4799,1839,129,115,244,
4800,1878,141,109,250,
4801,1991,131,137,268,
4802,2018,148,113,261,
4803,2040,158,97,255,
4804,1970,129,94,223,
4805,2014,159,95,254,
4806,1917,135,97,232,
4807,1886,130,114,244,
4808,1976,155,123,278,
4809,1949,154,100,254,
4810,1995,161,113,274,
4811,1961,157,107,264,
4812,1987,150,108,258,
4813,2045,177,114,291,
4814,2032,171,111,282,
4815,1953,153,114,267,
4816,1894,152,102,254,
4817,1968,138,99,237,
4818,1916,138,108,246,
4819,1970,163,110,273,
4820,1938,142,95,237,
4821,2040,158,107,265,
4822,1937,140,110,250,
4823,1950,139,85,224,
4824,1990,147,116,263,
4825,1994,128,130,258,
4826,1992,132,114,246,
4827,1868,121,105,226,
4828,1990,132,103,235,
4829,1953,148,118,266,
4830,2010,142,126,268,
4831,1937,136,86,222,
4832,1967,153,103,256,
4833,1872,143,125,268,
4834,1914,133,127,260,
4835,1912,146,122,268,
4836,1958,131,91,222,
4837,1925,124,102,226,
4838,1970,122,127,249,
4839,1927,171,111,282,
4840,1958,141,111,252,
4841,1964,143,115,258,
4842,1926,147,91,238,
4843,1982,142,115,257,
4844,1934,149,120,269,
4845,1949,131,119,250,
4846,1930,135,99,234,
4847,1912,146,95,241,
4848,1999,154,135,289,
4849,1995,179,104,283,
4850,1954,146,121,267,
4851,1931,136,110,246,
4852,1922,146,105,251,
4853,1964,141,103,244,
4854,1987,150,100,250,
4855,1904,148,124,272,
4856,1942,142,125,267,
4857,2040,139,133,272,
4858,1899,138,104,242,
4859,1947,140,114,254,
4860,1894,159,103,262,
4861,1927,124,117,241,
4862,1969,120,111,231,
4863,1894,131,116,247,
4864,1882,136,133,269,
4865,1954,150,108,258,
4866,1965,145,102,247,
4867,1991,149,121,270,
4868,1928,151,102,253,
4869,1978,124,139,263,
4870,1978,153,110,263,
4871,2010,142,134,276,
4872,2069,143,113,256,
4873,1952,137,130,267,
4874,1980,144,108,252,
4875,2067,146,101,247,
4876,1965,161,123,284,
4877,1988,135,111,246,
4878,1912,145,101,246,
4879,1894,149,107,256,
4880,1960,121,100,221,
4881,1985,155,98,253,
4882,1930,120,113,233,
4883,1930,139,97,236,
4884,1982,149,99,248,
4885,2012,125,118,243,
4886,1864,125,90,215,
4887,1929,138,118,256,
4888,1869,134,88,222,
4889,1988,168,115,283,
4890,1946,127,106,233,
4891,1874,116,101,217,
4892,1955,152,124,276,
4893,1942,137,111,248,
4894,1955,144,111,255,
4895,1992,149,106,255,
4896,1950,142,106,248,
4897,1970,141,88,229,
4898,1917,145,115,260,
4899,1956,159,123,282,
4900,1947,133,125,258,
4901,1948,158,120,278,
4902,2027,162,101,263,
4903,2032,153,119,272,
4904,1975,165,121,286,
4905,2028,141,121,262,
4906,1915,145,101,246,
4907,1956,157,110,267,
4908,1940,143,104,247,
4909,1948,140,111,251,
4910,1990,153,117,270,
4911,2034,134,90,224,
4912,1972,139,118,257,
4913,2065,155,120,275,
4914,1921,140,104,244,
4915,1993,126,104,230,
4916,2096,145,111,256,
4917,1971,136,117,253,
4918,1969,142,115,257,
4919,2039,153,119,272,
4920,1963,146,116,262,
4921,1926,133,98,231,
4922,1935,137,113,250,
4923,1939,130,94,224,
4924,1981,143,124,267,
4925,1926,151,105,256,
4926,1908,144,93,237,
4927,1992,164,107,271,
4928,2024,137,110,247,
4929,2023,142,105,247,
4930,2026,142,129,271,
4931,2016,154,120,274,
4932,1970,149,109,258,
4933,1985,152,123,275,
4934,2019,148,114,262,
4935,1919,143,111,254,
4936,2039,145,120,265,
4937,1960,136,122,258,
4938,1971,120,110,230,
4939,2007,157,108,265,
4940,1914,127,137,264,
4941,1990,152,111,263,
4942,1940,127,116,243,
4943,1994,143,104,247,
4944,2002,134,118,252,
4945,2022,140,114,254,
4946,1958,139,126,265,
4947,1902,141,131,272,
4948,2016,147,120,267,
4949,2008,139,120,259,
4950,1964,142,114,256,
4951,2004,145,142,287,
4952,1993,127,129,256,
4953,1962,125,108,233,
4954,2011,147,112,259,
4955,1916,150,116,266,
4956,1916,132,94,226,
4957,1914,133,123,256,
4958,1920,136,120,256,
4959,1957,146,124,270,
4960,2089,152,105,257,
4961,2063,145,113,258,
4962,2009,142,112,254,
4963,1880,114,106,220,
4964,1964,136,130,266,
4965,1997,149,116,265,
4966,1962,152,100,252,
4967,1949,151,114,265,
4968,2008,139,105,244,
4969,2020,166,121,287,
4970,1968,137,112,249,
4971,1880,144,95,239,
4972,1897,131,99,230,
4973,1946,163,120,283,
4974,1920,161,128,289,
4975,1977,151,123,274,
4976,1970,161,117,278,
4977,1963,132,109,241,
4978,1922,122,120,242,
4979,1931,143,112,255,
4980,1979,147,125,272,
4981,1864,147,114,261,
4982,1995,153,115,268,
4983,1986,138,112,250,
4984,1928,154,115,269,
4985,1880,116,110,226,
4986,2073,164,91,255,
4987,1969,142,108,250,
4988,2091,158,108,266,
4989,2009,137,109,246,
4990,1943,134,115,249,
4991,2073,170,111,281,
4992,2048,158,125,283,
4993,1930,131,93,224,
4994,1939,151,105,256,
4995,1912,161,94,255,
4996,2022,157,109,266,
4997,2043,171,124,295,
4998,1908,129,92,221,
4999,1917,132,116,248,
5000,1942,148,114,262,
5001,1966,137,113,250,
5002,1961,127,114,241,
5003,1957,139,107,246,
5004,1918,151,108,259,
5005,2054,152,151,303,
5006,1979,146,116,262,
5007,1951,142,107,249,
5008,1961,165,103,268,
5009,1949,115,114,229,
5010,2053,145,102,247,
5011,2008,144,133,277,
5012,1953,137,107,244,
5013,2045,141,115,256,
5014,1983,130,83,213,
5015,1921,131,128,259,
5016,1951,143,92,235,
5017,2076,159,115,274,
5018,1982,130,108,238,
5019,2031,131,118,249,
5020,1997,165,107,272,
5021,1866,127,97,224,
5022,1962,136,95,231,
5023,1997,137,123,260,
5024,1991,147,103,250,
5025,1925,145,110,255,
5026,1907,143,109,252,
5027,1977,140,127,267,
5028,1910,141,114,255,
5029,2000,154,109,263,
5030,1973,132,99,231,
5031,1924,126,99,225,
5032,1921,139,111,250,
5033,1979,139,108,247,
5034,1985,150,119,269,
5035,1996,143,129,272,
5036,1908,146,111,257,
5037,1897,130,115,245,
5038,1998,153,115,268,
5039,2062,152,115,267,
5040,1985,170,108,278,
5041,1941,142,99,241,
5042,1967,151,107,258,
5043,1875,150,111,261,
5044,1924,119,106,225,
5045,1999,158,140,298,
5046,1905,145,111,256,
5047,1949,165,110,275,
5048,1931,145,111,256,
5049,1978,148,110,258,
5050,1929,148,113,261,
5051,1994,142,106,248,
5052,1967,138,130,268,
5053,1982,155,110,265,
5054,1928,128,120,248,
5055,1982,164,117,281,
5056,1949,139,93,232,
5057,2001,147,117,264,
5058,1973,152,102,254,
5059,1880,144,111,255,
5060,1907,155,117,272,
5061,1899,137,100,237,
5062,1925,141,120,261,
5063,1919,135,112,247,
5064,2075,136,109,245,
5065,1963,160,102,262,
5066,1911,155,103,258,
5067,1874,118,110,228,
5068,1901,139,114,253,
5069,1863,146,106,252,
5070,1929,148,122,270,
5071,2043,165,113,278,
5072,1919,129,121,250,
5073,1968,157,109,266,
5074,1962,151,101,252,
5075,1986,145,132,277,
5076,1902,144,122,266,
5077,1897,139,101,240,
5078,1902,123,114,237,
5079,1940,142,117,259,
5080,1991,112,115,227,
5081,1941,130,101,231,
5082,1935,130,102,232,
5083,1869,159,110,269,
5084,1959,113,119,232,
5085,1952,128,91,219,
5086,1951,150,123,273,
5087,1964,139,114,253,
5088,2009,126,120,246,
5089,1984,134,106,240,
5090,1935,158,100,258,
5091,1960,167,134,301,
5092,1976,130,120,250,
5093,1990,140,105,245,
5094,1928,137,110,247,
5095,1932,126,100,226,
5096,2019,132,127,259,
5097,1902,122,98,220,
5098,1898,140,132,272,
5099,1826,153,96,249,
5100,1984,128,109,237,
5101,1939,146,124,270,
5102,1995,163,121,284,
5103,1944,144,93,237,
5104,1909,134,88,222,
5105,1999,141,113,254,
5106,1971,140,104,244,
5107,2018,128,97,225,
5108,1972,143,103,246,
5109,1885,156,114,270,
5110,1947,159,105,264,
5111,1932,144,122,266,
5112,2037,146,105,251,
5113,1956,153,99,252,
5114,2021,147,123,270,
5115,1932,145,118,263,
5116,1960,150,106,256,
5117,1938,177,117,294,
5118,1976,149,114,263,
5119,2067,157,117,274,
5120,1950,139,104,243,
5121,1970,131,118,249,
5122,1978,139,117,256,
5123,1963,149,90,239,
5124,2002,137,109,246,
5125,1968,138,118,256,
5126,1916,125,101,226,
5127,1987,155,124,279,
5128,1987,132,102,234,
5129,2000,149,102,251,
5130,1946,149,114,263,
5131,2002,129,98,227,
5132,2032,150,124,274,
5133,1927,138,118,256,
5134,1982,119,104,223,
5135,2052,151,125,276,
5136,1958,147,101,248,
5137,1932,157,118,275,
5138,2025,143,110,253,
5139,1897,121,104,225,
5140,1900,166,110,276,
5141,1927,127,95,222,
5142,1896,129,109,238,
5143,2045,164,115,279,
5144,1966,158,114,272,
5145,2006,159,96,255,
5146,1918,133,126,259,
5147,1935,138,100,238,
5148,1939,157,99,256,
5149,1913,154,110,264,
5150,1864,143,105,248,
5151,1929,131,106,237,
5152,1998,165,93,258,
5153,1918,152,112,264,
5154,1968,150,129,279,
5155,1935,153,106,259,
5156,1986,154,122,276,
5157,2032,145,111,256,
5158,1948,133,119,252,
5159,2011,146,116,262,
5160,2031,159,142,301,
5161,2002,152,105,257,
5162,1927,157,110,267,
5163,1921,126,118,244,
5164,2007,137,121,258,
5165,1963,144,119,263,
5166,1944,157,93,250,
5167,2025,147,105,252,
5168,2010,146,104,250,
5169,2047,148,141,289,
5170,1908,125,118,243,
5171,1948,119,111,230,
5172,1939,134,99,233,
5173,2098,157,118,275,
5174,2000,138,120,258,
5175,1988,129,104,233,
5176,2003,155,115,270,
5177,1967,141,123,264,
5178,1928,135,107,242,
5179,1828,128,101,229,
5180,2020,156,101,257,
5181,1959,133,82,215,
5182,2026,136,128,264,
5183,1966,146,111,257,
5184,1928,140,120,260,
5185,2004,156,109,265,
5186,1978,137,133,270,
5187,1980,137,132,269,
5188,1920,117,95,212,
5189,1996,136,125,261,
5190,1976,145,121,266,
5191,2032,143,117,260,
5192,2015,147,111,258,
5193,1890,128,115,243,
5194,1977,136,141,277,
5195,1976,157,105,262,
5196,1965,154,99,253,
5197,1909,129,120,249,
5198,2045,147,115,262,
5199,1916,132,104,236,
5200,1910,147,114,261,
5201,1956,134,92,226,
5202,2008,152,90,242,
5203,1977,143,110,253,
5204,1927,136,113,249,
5205,1914,157,106,263,
5206,1928,137,117,254,
5207,1977,151,118,269,
5208,1965,130,112,242,
5209,2050,157,120,277,
5210,2016,155,144,299,
5211,1964,142,115,257,
5212,1984,151,112,263,
5213,2034,164,124,288,
5214,2008,145,95,240,
5215,1974,151,108,259,
5216,2047,156,110,266,
5217,1969,137,111,248,
5218,1957,143,105,248,
5219,1971,142,114,256,
5220,1919,146,100,246,
5221,2026,140,108,248,
5222,1925,148,113,261,
5223,1973,146,101,247,
5224,2008,152,120,272,
5225,1997,148,130,278,
5226,1985,142,95,237,
5227,1926,154,119,273,
5228,1915,133,111,244,
5229,1940,145,112,257,
5230,1921,149,109,258,
5231,2031,127,128,255,
5232,1984,150,105,255,
5233,1880,132,115,247,
5234,1972,154,107,261,
5235,1937,131,100,231,
5236,1964,152,124,276,
5237,1940,126,94,220,
5238,2102,129,129,258,
5239,1964,136,112,248,
5240,1988,140,102,242,
5241,1966,143,112,255,
5242,2081,129,118,247,
5243,1953,138,128,266,
5244,1983,148,119,267,
5245,1973,167,114,281,
5246,1942,135,94,229,
5247,1930,136,96,232,
5248,1939,151,99,250,
5249,1927,129,107,236,
5250,1965,141,118,259,
5251,1935,146,104,250,
5252,1937,143,115,258,
5253,1912,134,124,258,
5254,2020,150,114,264,
5255,2047,161,128,289,
5256,2023,141,109,250,
5257,1977,134,130,264,
5258,1967,155,111,266,
5259,1950,123,136,259,
5260,1988,142,106,248,
5261,1979,151,111,262,
5262,2019,160,138,298,
5263,1934,129,117,246,
5264,1989,143,121,264,
5265,1885,135,97,232,
5266,1965,146,133,279,
5267,1993,146,120,266,
5268,2000,141,111,252,
5269,1960,127,115,242,
5270,1932,125,103,228,
5271,1900,131,114,245,
5272,2001,161,115,276,
5273,1975,137,125,262,
5274,1885,147,103,250,
5275,1982,137,109,246,
5276,1918,124,112,236,
5277,2013,124,139,263,
5278,1951,138,133,271,
5279,1895,137,115,252,
5280,1915,154,111,265,
5281,1995,143,125,268,
5282,1949,167,110,277,
5283,1931,132,89,221,
5284,2006,168,115,283,
5285,2064,141,119,260,
5286,1993,138,113,251,
5287,2011,120,106,226,
5288,1920,110,112,222,
5289,1956,142,109,251,
5290,1992,157,111,268,
5291,1994,144,116,260,
5292,2025,153,129,282,
5293,2014,132,114,246,
5294,1975,132,117,249,
5295,1937,142,97,239,
5296,1913,149,106,255,
5297,2048,155,118,273,
5298,2008,142,120,262,
5299,1928,145,108,253,
5300,1819,118,98,216,
5301,1966,146,107,253,
5302,1944,168,111,279,
5303,1974,165,95,260,
5304,1932,144,120,264,
5305,1939,129,98,227,
5306,2010,158,107,265,
5307,1949,141,104,245,
5308,2011,148,115,263,
5309,1950,133,112,245,
5310,2015,156,119,275,
5311,2048,154,110,264,
5312,1985,148,130,278,
5313,1932,141,115,256,
5314,1971,133,116,249,
5315,1995,139,137,276,
5316,1961,152,129,281,
5317,1963,136,122,258,
5318,1948,123,105,228,
5319,1947,129,95,224,
5320,1941,137,106,243,
5321,1984,165,116,281,
5322,1950,142,116,258,
5323,1956,134,103,237,
5324,2042,156,105,261,
5325,1948,140,99,239,
5326,1810,135,108,243,
5327,1929,137,100,237,
5328,1947,138,116,254,
5329,1915,137,128,265,
5330,2032,134,125,259,
5331,1936,125,120,245,
5332,1979,134,102,236,
5333,1916,155,84,239,
5334,1955,149,107,256,
5335,1960,155,116,271,
5336,1925,147,111,258,
5337,1973,150,130,280,
5338,1962,157,103,260,
5339,1948,157,112,269,
5340,1991,148,117,265,
5341,1906,127,103,230,
5342,1966,130,117,247,
5343,1903,148,106,254,
5344,1999,125,99,224,
5345,1957,123,127,250,
5346,1937,119,120,239,
5347,2007,138,111,249,
5348,1945,161,103,264,
5349,1982,137,108,245,
5350,1988,135,126,261,
5351,1979,144,121,265,
5352,1956,138,126,264,
5353,2036,155,110,265,
5354,1985,124,118,242,
5355,2000,143,108,251,
5356,1964,147,119,266,
5357,1942,134,90,224,
5358,1997,146,111,257,
5359,1909,119,108,227,
5360,1869,149,119,268,
5361,1926,146,147,293,
5362,1941,140,115,255,
5363,2001,134,112,246,
5364,2000,123,115,238,
5365,1996,151,103,254,
5366,1913,135,100,235,
5367,2002,158,116,274,
5368,1953,157,115,272,
5369,2008,137,123,260,
5370,1892,138,95,233,
5371,1926,126,106,232,
5372,2010,136,126,262,
5373,1983,138,110,248,
5374,2049,157,89,246,
5375,1962,137,130,267,
5376,1983,137,130,267,
5377,1970,140,124,264,
5378,1974,122,118,240,
5379,2064,142,132,274,
5380,1972,150,108,258,
5381,1999,139,107,246,
5382,1951,138,123,261,
5383,2052,140,126,266,
5384,1931,135,102,237,
5385,1962,160,109,269,
5386,1904,154,100,254,
5387,2006,143,103,246,
5388,1927,138,105,243,
5389,2019,157,103,260,
5390,1910,154,98,252,
5391,2030,153,124,277,
5392,1937,122,114,236,
5393,1893,133,98,231,
5394,1930,129,113,242,
5395,1970,143,109,252,
5396,1990,148,111,259,
5397,1995,128,110,238,
5398,1935,125,111,236,
5399,1904,152,130,282,
5400,1918,140,106,246,
5401,1939,124,111,235,
5402,1950,143,93,236,
5403,2046,147,122,269,
5404,1981,137,126,263,
5405,1910,148,99,247,
5406,1945,142,115,257,
5407,2002,148,107,255,
5408,1999,159,111,270,
5409,1918,148,109,257,
5410,1967,127,92,219,
5411,2001,150,90,240,
5412,2082,155,111,266,
5413,1977,136,116,252,
5414,2036,152,142,294,
5415,2002,135,125,260,
5416,2009,162,103,265,
5417,1954,141,117,258,
5418,2033,137,119,256,
5419,1994,150,127,277,
5420,1975,128,97,225,
5421,1949,155,100,255,
5422,1974,138,113,251,
5423,1873,122,110,232,
5424,2029,147,120,267,
5425,1970,138,101,239,
5426,1986,146,104,250,
5428,1986,135,106,241,
5429,1938,127,109,236,
5430,1976,136,110,246,
5431,1903,143,93,236,
5432,2006,167,111,278,
5433,1948,120,123,243,
5434,1916,143,105,248,
5435,1948,135,117,252,
5436,1960,146,98,244,
5437,2038,147,113,260,
5438,1909,150,118,268,
5439,2056,145,132,277,
5440,2006,135,134,269,
5441,1959,148,113,261,
5442,1960,127,116,243,
5443,2000,147,93,240,
5444,1946,122,108,230,
5445,1984,143,122,265,
5446,1940,130,115,245,
5447,2009,128,106,234,
5448,1897,154,110,264,
5449,1983,139,124,263,
5450,1964,126,111,237,
5451,1915,156,104,260,
5452,1849,150,102,252,
5453,1933,138,126,264,
5454,1964,156,119,275,
5455,2023,146,116,262,
5456,1967,138,102,240,
5457,1920,120,93,213,
5458,2001,151,121,272,
5459,1984,158,116,274,
5460,2005,143,122,265,
5461,1866,121,115,236,
5462,1933,144,121,265,
5463,2018,154,127,281,
5464,1948,150,99,249,
5465,2031,151,108,259,
5466,1925,160,98,258,
5467,2022,164,107,271,
5468,1904,150,105,255,
5469,1941,160,98,258,
5470,1899,130,108,238,
5471,1880,137,125,262,
5472,1979,161,86,247,
5473,2001,147,109,256,
5474,1938,131,113,244,
5475,1906,130,104,234,
5476,1987,175,122,297,
5477,1906,126,97,223,
5478,1956,143,116,259,
5479,1996,148,123,271,
5480,1960,137,111,248,
5481,1937,145,113,258,
5482,1930,132,109,241,
5483,1960,143,117,260,
5484,2006,153,114,267,
5485,1959,151,101,252,
5486,1999,151,124,275,
5487,1901,159,104,263,
5488,1921,127,115,242,
5489,1965,150,130,280,
5490,1991,152,113,265,
5491,1934,119,119,238,
5492,2032,169,100,269,
5493,1969,141,127,268,
5494,1908,158,93,251,
5495,1959,129,117,246,
5496,2001,123,121,244,
5497,2009,132,106,238,
5498,1950,136,110,246,
5499,1878,140,102,242,
5500,2035,153,115,268,
5501,1934,157,126,283,
5502,1949,154,107,261,
5503,1918,158,121,279,
5504,1982,139,112,251,
5505,1994,132,121,253,
5506,1954,163,101,264,
5507,1898,139,97,236,
5508,1937,142,108,250,
5509,1924,119,120,239,
5510,1882,149,99,248,
5511,1926,167,134,301,
5512,1996,145,118,263,
5513,2016,147,123,270,
5514,2010,131,109,240,
5515,2001,164,99,263,
5516,2029,149,113,262,
5517,1971,137,98,235,
5518,1955,162,121,283,
5519,1881,144,115,259,
5520,1952,157,102,259,
5521,2029,151,118,269,
5522,1992,159,111,270,
5523,1954,145,107,252,
5524,1969,175,122,297,
5525,2000,161,127,288,
5526,1964,123,113,236,
5527,2048,161,127,288,
5528,2008,140,112,252,
5529,1894,153,106,259,
5530,1937,146,119,265,
5531,1874,143,104,247,
5532,2026,149,119,268,
5533,1935,151,111,262,
5534,1903,129,98,227,
5535,1987,132,124,256,
5536,1942,134,98,232,
5537,2058,146,124,270,
5538,2036,132,136,268,
5539,1987,152,134,286,
5540,2045,143,129,272,
5541,1954,146,101,247,
5542,1978,120,114,234,
5543,1937,165,111,276,
5544,1993,137,117,254,
5545,1900,110,106,216,
5546,2034,132,123,255,
5547,1991,137,112,249,
5548,2079,156,130,286,
5549,1896,123,109,232,
5550,1973,156,112,268,
5551,1993,149,102,251,
5552,1950,147,109,256,
5553,1977,152,111,263,
5554,1950,145,112,257,
5555,2025,148,125,273,
5556,1997,160,117,277,
5557,1935,142,110,252,
5558,1990,127,112,239,
5559,1956,166,95,261,
5560,1972,147,111,258,
5561,1913,123,105,228,
5562,1961,137,102,239,
5563,1969,157,92,249,
5564,1973,137,109,246,
5565,2018,155,120,275,
5566,1947,139,121,260,
5567,2010,175,108,283,
5568,1975,120,115,235,
5569,1934,142,96,238,
5570,1974,152,123,275,
5571,1931,139,107,246,
5572,1951,142,114,256,
5573,1984,144,103,247,
5574,1923,157,103,260,
5575,2043,149,99,248,
5576,2038,179,119,298,
5578,1959,167,120,287,
5579,2024,156,125,281,
5580,2000,150,103,253,
5581,1948,113,101,214,
5582,1990,134,104,238,
5583,1996,141,98,239,
5584,2011,159,119,278,
5585,1898,171,119,290,
5586,1988,130,114,244,
5587,1982,134,132,266,
5588,1983,139,118,257,
5589,1917,132,93,225,
5590,1925,138,100,238,
5591,1964,174,116,290,
5592,1954,147,95,242,
5593,1939,140,104,244,
5594,1937,125,124,249,
5595,1929,136,97,233,
5596,1979,129,111,240,
5597,2011,157,120,277,
5598,1952,150,104,254,
5599,2002,163,125,288,
5600,1879,162,94,256,
5601,1931,117,132,249,
5602,1958,150,95,245,
5603,1872,126,106,232,
5604,1987,137,108,245,
5605,1932,154,103,257,
5606,2010,130,90,220,
5607,1934,133,93,226,
5608,1989,153,105,258,
5609,1852,131,113,244,
5610,1992,155,108,263,
5611,1981,156,127,283,
5612,1922,135,107,242,
5613,2001,155,125,280,
5614,1939,141,104,245,
5615,2017,155,122,277,
5616,2032,157,117,274,
5617,1944,122,121,243,
5618,1873,134,113,247,
5619,1946,140,106,246,
5620,1852,128,112,240,
5621,1977,138,121,259,
5622,1898,152,102,254,
5623,1944,134,94,228,
5624,1937,136,100,236,
5625,1924,120,107,227,
5626,1948,151,103,254,
5627,1978,135,123,258,
5628,1936,149,121,270,
5629,1959,136,114,250,
5630,1956,117,117,234,
5631,1937,145,115,260,
5632,1958,128,119,247,
5633,1946,140,103,243,
5634,2025,141,109,250,
5635,1947,145,113,258,
5636,1935,140,102,242,
5637,1940,161,122,283,
5638,2011,148,99,247,
5639,2081,157,123,280,
5640,1918,147,105,252,
5641,1884,145,114,259,
5642,1946,132,109,241,
5643,1969,168,100,268,
5644,1949,140,101,241,
5645,2039,141,117,258,
5646,1985,154,101,255,
5647,1967,139,104,243,
5648,1981,133,113,246,
5649,1980,150,118,268,
5650,2041,160,116,276,
5651,2042,144,130,274,
5652,2016,148,142,290,
5653,2015,152,127,279,
5654,2016,149,116,265,
5655,2000,136,108,244,
5656,2002,146,110,256,
5657,2021,165,111,276,
5658,2022,142,131,273,
5659,1993,141,106,247,
5660,2003,139,98,237,
5661,2022,137,107,244,
5662,1897,127,110,237,
5663,1933,143,98,241,
5664,1942,150,109,259,
5665,1991,154,109,263,
5666,2039,158,114,272,
5667,2000,155,129,284,
5668,2016,156,104,260,
5669,1932,146,98,244,
5670,1945,125,122,247,
5671,1955,127,112,239,
5672,1929,125,80,205,
5673,1914,135,108,243,
5674,1947,134,122,256,
5675,1952,140,119,259,
5676,1870,130,113,243,
5677,1830,127,86,213,
5678,2042,130,121,251,
5679,1937,146,97,243,
5680,1921,149,111,260,
5681,2028,149,126,275,
5682,1970,130,128,258,
5683,1949,161,116,277,
5684,2048,152,111,263,
5685,1966,137,124,261,
5686,1937,123,110,233,
5687,1951,130,106,236,
5688,1924,140,95,235,
5689,1990,135,111,246,
5690,2017,135,107,242,
5691,1959,160,103,263,
5692,2061,155,124,279,
5693,1869,123,108,231,
5694,2005,138,120,258,
5695,2001,148,117,265,
5696,1959,168,114,282,
5697,1969,136,121,257,
5698,1972,139,112,251,
5699,1944,165,101,266,
5700,1910,136,112,248,
5701,1992,134,111,245,
5702,1949,130,97,227,
5703,1971,141,111,252,
5704,1910,146,129,275,
5705,1934,134,111,245,
5706,1992,161,131,292,
5707,1961,155,110,265,
5708,1881,135,116,251,
5709,1960,124,93,217,
5710,1935,129,111,240,
5711,1969,143,132,275,
5712,1988,127,104,231,
5713,1969,139,131,270,
5714,1929,157,105,262,
5715,2035,149,130,279,
5716,2088,128,131,259,
5717,2033,156,107,263,
5718,2067,146,123,269,
5719,2025,135,116,251,
5720,1909,143,105,248,
5721,2033,153,102,255,
5722,1989,145,124,269,
5723,1929,131,119,250,
5724,2039,138,104,242,
5725,2047,149,140,289,
5726,1907,132,93,225,
5727,1893,146,107,253,
5728,2012,136,102,238,
5729,1922,130,128,258,
5730,1993,155,97,252,
5731,1977,157,113,270,
5732,1876,143,109,252,
5733,1970,152,106,258,
5734,2000,151,97,248,
5735,1877,135,107,242,
5736,1823,126,88,214,
5737,2047,134,108,242,
5738,2002,140,104,244,
5739,1905,135,96,231,
5740,1929,147,128,275,
5741,1948,154,105,259,
5742,2048,148,123,271,
5743,1946,134,105,239,
5744,1956,138,112,250,
5745,1976,140,106,246,
5746,2008,154,115,269,
5747,1966,122,121,243,
5748,1929,126,106,232,
5749,1945,179,113,292,
5750,1956,137,127,264,
5751,1899,136,128,264,
5752,1922,156,98,254,
5753,1933,131,105,236,
5754,1965,149,106,255,
5755,1972,130,88,218,
5756,1919,137,99,236,
5757,1990,136,104,240,
5758,2002,142,110,252,
5759,2118,169,109,278,
5760,1851,142,108,250,
5761,1999,149,118,267,
5762,1943,147,106,253,
5763,1922,146,113,259,
5764,1997,154,106,260,
5765,2011,170,116,286,
5766,2002,157,111,268,
5767,1949,146,118,264,
5768,1993,135,116,251,
5769,1953,140,98,238,
5770,1918,135,123,258,
5771,1973,142,112,254,
5772,1929,150,119,269,
5773,1878,117,115,232,
5774,1890,132,96,228,
5775,1939,132,116,248,
5776,1960,129,96,225,
5777,1987,148,119,267,
5778,1944,141,102,243,
5779,1974,145,125,270,
5780,1966,136,108,244,
5781,1928,133,99,232,
5782,1937,136,102,238,
5783,1915,162,109,271,
5784,1972,127,126,253,
5785,2022,153,120,273,
5786,2019,164,111,275,
5787,1946,144,126,270,
5788,1989,143,98,241,
5789,2002,131,131,262,
5790,1859,131,96,227,
5791,1907,133,123,256,
5792,1968,162,123,285,
5793,1899,146,91,237,
5794,1985,157,110,267,
5795,2070,157,115,272,
5796,1955,146,125,271,
5797,2012,129,117,246,
5798,2000,150,109,259,
5799,1916,151,106,257,
5800,1918,131,102,233,
5801,1920,134,95,229,
5802,2029,160,128,288,
5803,1961,141,102,243,
5804,2057,174,99,273,
5805,1888,127,91,218,
5806,1949,139,86,225,
5807,2010,150,130,280,
5808,1907,140,114,254,
5809,1901,144,100,244,
5810,1909,132,94,226,
5811,1941,134,121,255,
5812,1973,148,104,252,
5813,1951,145,128,273,
5814,2019,167,108,275,
5815,1875,158,112,270,
5816,1930,140,106,246,
5817,1890,127,116,243,
5818,1989,153,123,276,
5819,1917,126,113,239,
5820,1984,146,115,261,
5821,1986,143,116,259,
5822,1990,127,101,228,
5823,1971,128,112,240,
5824,1978,150,118,268,
5825,2071,162,125,287,
5826,1926,146,123,269,
5827,1931,157,89,246,
5828,1991,151,111,262,
5829,1969,147,126,273,
5830,1932,140,109,249,
5831,1948,140,118,258,
5832,1981,140,123,263,
5833,2006,148,115,263,
5834,1997,155,124,279,
5835,2005,130,103,233,
5836,2052,130,107,237,
5837,1930,155,110,265,
5838,1880,147,119,266,
5839,1997,143,108,251,
5840,1971,146,95,241,
5841,1911,148,112,260,
5842,1958,136,133,269,
5843,1989,150,105,255,
5844,1954,130,129,259,
5845,1939,125,126,251,
5846,1905,156,97,253,
5847,1975,134,117,251,
5848,2052,150,110,260,
5849,1982,141,111,252,
5850,1946,142,120,262,
5851,1983,131,124,255,
5852,1976,149,121,270,
5853,1968,158,120,278,
5854,1899,155,101,256,
5855,2031,156,106,262,
5856,1889,157,120,277,
5857,1983,140,113,253,
5858,1963,150,111,261,
5859,1938,158,104,262,
5860,1933,158,98,256,
5861,1967,139,133,272,
5862,1942,132,137,269,
5863,2020,136,124,260,
5864,1938,163,110,273,
5865,2053,147,127,274,
5866,1892,126,111,237,
5867,1889,129,114,243,
5868,1977,148,117,265,
5869,2020,141,123,264,
5870,1898,152,118,270,
5871,1972,151,116,267,
5872,1883,160,110,270,
5873,1999,125,107,232,
5874,1900,125,122,247,
5875,1976,131,113,244,
5876,2051,146,105,251,
5877,1942,146,115,261,
5878,1987,141,126,267,
5879,2028,124,113,237,
5880,1999,136,116,252,
5881,1895,131,115,246,
5882,1993,158,115,273,
5883,1914,142,102,244,
5884,1929,136,114,250,
5885,1928,152,133,285,
5886,2006,130,119,249,
5887,2009,153,115,268,
5888,1949,141,106,247,
5889,1955,154,109,263,
5890,1964,139,116,255,
5891,1974,129,112,241,
5892,1998,144,113,257,
5893,1958,148,103,251,
5894,1977,140,130,270,
5895,1957,148,104,252,
5896,2056,143,126,269,
5897,1963,131,130,261,
5898,2004,155,118,273,
5899,1924,152,129,281,
5900,1992,140,121,261,
5901,1848,116,106,222,
5902,1957,133,100,233,
5903,1952,141,117,258,
5904,1938,153,125,278,
5905,2012,164,116,280,
5906,1891,137,107,244,
5907,1983,148,108,256,
5908,1959,139,105,244,
5909,1983,128,131,259,
5910,1907,144,110,254,
5911,1933,133,123,256,
5912,1997,157,112,269,
5913,1976,135,98,233,
5914,2016,155,121,276,
5915,1921,150,108,258,
5916,1951,144,104,248,
5917,1970,153,116,269,
5918,1942,143,111,254,
5919,1977,110,118,228,
5920,2002,134,101,235,
5921,2033,136,112,248,
5922,2002,168,99,267,
5923,2037,183,105,288,
5924,1920,120,117,237,
5925,2028,152,110,262,
5926,1912,145,94,239,
5927,2003,125,122,247,
5928,1972,151,123,274,
5929,1939,145,107,252,
5930,2007,132,119,251,
5931,1992,158,126,284,
5932,2013,149,108,257,
5933,2030,146,113,259,
5934,1972,160,108,268,
5935,1993,154,127,281,
5936,1951,148,121,269,
5937,1976,117,112,229,
5938,2052,152,121,273,
5939,1987,157,119,276,
5940,1905,145,98,243,
5941,1998,142,118,260,
5942,1990,142,126,268,
5943,1983,157,110,267,
5944,2095,138,108,246,
5945,1992,125,124,249,
5946,1996,142,110,252,
5947,1961,155,118,273,
5948,1939,150,112,262,
5949,1899,157,99,256,
5950,1989,147,113,260,
5951,1900,166,117,283,
5952,2036,131,111,242,
5953,1885,143,107,250,
5954,1944,142,111,253,
5955,2008,142,126,268,
5956,1919,135,82,217,
5957,1945,152,87,239,
5958,1872,136,108,244,
5959,1974,146,128,274,
5960,1908,152,109,261,
5961,1969,130,120,250,
5962,1981,138,132,270,
5963,1957,146,115,261,
5964,1931,157,117,274,
5965,1941,154,103,257,
5966,1960,132,100,232,
5967,1974,162,104,266,
5968,2031,146,114,260,
5969,1979,138,119,257,
5970,1981,151,114,265,
5971,1941,135,101,236,
5972,2019,142,98,240,
5973,2009,156,109,265,
5974,1963,127,100,227,
5975,2041,128,132,260,
5976,1885,144,100,244,
5977,1900,137,109,246,
5978,1917,122,116,238,
5979,1987,141,131,272,
5980,1955,141,117,258,
5981,1991,159,126,285,
5982,1999,129,99,228,
5983,2017,133,133,266,
5984,1952,145,108,253,
5985,1892,140,107,247,
5986,2040,164,128,292,
5987,1938,131,114,245,
5988,1941,151,113,264,
5989,1932,127,100,227,
5990,1996,138,124,262,
5991,2002,145,120,265,
5992,1919,139,102,241,
5993,1914,140,126,266,
5994,2034,141,117,258,
5995,2042,146,123,269,
5996,1898,115,110,225,
5997,1958,141,112,253,
5998,1968,140,132,272,
5999,1951,143,116,259,
6000,1964,119,115,234,
6001,1932,137,119,256,
6002,1995,127,123,250,
6003,2016,144,124,268,
6004,1933,131,107,238,
6005,2009,138,120,258,
6006,2017,132,123,255,
6007,1871,137,121,258,
6008,1927,137,102,239,
6009,2005,151,112,263,
6010,1936,146,113,259,
6011,1949,148,112,260,
6012,1967,134,113,247,
6013,1907,138,92,230,
6014,1986,160,117,277,
6015,1924,160,117,277,
6016,1999,151,98,249,
6017,1953,152,94,246,
6018,1971,139,119,258,
6019,1971,134,105,239,
6020,2078,134,138,272,
6021,1935,137,104,241,
6022,1961,154,121,275,
6023,1982,149,126,275,
6024,1960,122,112,234,
6025,1905,133,109,242,
6026,1923,116,106,222,
6027,1999,156,120,276,
6028,1852,128,118,246,
6029,2037,162,106,268,
6030,1968,143,114,257,
6031,1997,125,107,232,
6032,1987,146,107,253,
6033,1969,140,102,242,
6034,2013,144,130,274,
6035,1993,137,127,264,
6036,2027,153,114,267,
6037,1892,123,121,244,
6038,2017,138,132,270,
6039,1975,137,109,246,
6040,2034,151,120,271,
6041,2064,141,129,270,
6042,1918,102,122,224,
6043,2041,150,111,261,
6044,1884,144,101,245,
6045,1959,140,115,255,
6046,1994,149,121,270,
6047,1966,161,115,276,
6048,1887,144,104,248,
6049,1973,153,110,263,
6050,1994,147,120,267,
6051,1872,125,109,234,
6052,1892,133,112,245,
6053,1917,123,107,230,
6054,1927,149,109,258,
6055,2030,161,107,268,
6056,2028,144,101,245,
6057,2032,138,116,254,
6058,2049,155,109,264,
6059,1978,140,110,250,
6060,1951,148,111,259,
6061,1983,149,103,252,
6062,1991,145,96,241,
6063,2001,149,99,248,
6064,1983,157,125,282,
6065,1918,131,104,235,
6066,1954,126,100,226,
6067,1944,137,112,249,
6068,1967,149,100,249,
6069,1978,135,111,246,
6070,1923,129,99,228,
6071,1932,131,115,246,
6072,1872,116,104,220,
6073,1946,135,111,246,
6074,1900,132,93,225,
6075,1976,156,103,259,
6076,2008,128,119,247,
6077,1943,132,98,230,
6078,1974,143,114,257,
6079,2027,138,127,265,
6080,1950,128,122,250,
6081,1922,141,105,246,
6082,1908,144,103,247,
6083,1941,152,117,269,
6084,1936,126,117,243,
6085,1993,131,109,240,
6086,1982,150,103,253,
6087,2061,156,113,269,
6088,1960,145,96,241,
6089,1920,110,112,222,
6090,1971,141,119,260,
6091,1966,148,114,262,
6092,1918,156,104,260,
6093,1883,131,105,236,
6094,1896,145,120,265,
6095,2086,132,104,236,
6096,1973,147,94,241,
6097,1957,151,132,283,
6098,1967,138,105,243,
6099,2010,156,97,253,
6100,1944,127,79,206,
6101,1987,134,130,264,
6102,1894,163,96,259,
6103,1952,154,100,254,
6104,1944,152,106,258,
6105,1980,138,116,254,
6106,1987,141,123,264,
6107,1906,143,106,249,
6108,1869,128,93,221,
6109,1938,147,104,251,
6110,1910,143,111,254,
6111,1981,144,118,262,
6112,1970,145,110,255,
6113,1988,146,123,269,
6114,1932,126,106,232,
6115,1934,130,99,229,
6116,1989,137,121,258,
6117,1902,148,108,256,
6118,1941,144,98,242,
6119,1927,124,96,220,
6120,1922,137,109,246,
6121,1895,151,94,245,
6122,1915,128,108,236,
6123,1955,124,111,235,
6124,2033,138,122,260,
6125,1952,157,121,278,
6126,1972,118,113,231,
6127,1851,120,119,239,
6128,1908,134,116,250,
6129,1994,153,115,268,
6130,1986,139,104,243,
6131,1889,143,112,255,
6132,2013,148,104,252,
6133,2047,144,121,265,
6134,1964,154,108,262,
6135,1923,150,111,261,
6136,1972,139,112,251,
6137,1915,172,120,292,
6138,1987,152,107,259,
6139,1976,131,111,242,
6140,1952,159,98,257,
6141,1963,153,105,258,
6142,1976,141,114,255,
6143,1967,148,128,276,
6144,2013,149,106,255,
6145,1913,133,102,235,
6146,1956,139,108,247,
6147,2032,138,110,248,
6148,1993,150,106,256,
6149,1960,125,100,225,
6150,1937,149,99,248,
6151,2004,148,108,256,
6152,1917,134,122,256,
6153,2034,141,130,271,
6154,1911,125,117,242,
6155,2020,129,126,255,
6156,1877,122,101,223,
6157,1961,142,132,274,
6158,1956,141,101,242,
6159,1961,152,107,259,
6160,1998,156,114,270,
6161,1970,142,109,251,
6162,1990,145,117,262,
6163,1876,129,97,226,
6164,2079,157,107,264,
6165,2000,139,122,261,
6166,2022,151,130,281,
6167,1893,140,99,239,
6168,1862,156,103,259,
6169,2012,150,112,262,
6170,1939,144,108,252,
6171,2000,120,105,225,
6172,1889,131,118,249,
6173,2008,134,113,247,
6174,1860,141,107,248,
6175,1959,143,97,240,
6176,1974,164,91,255,
6177,1950,145,108,253,
6178,1940,129,128,257,
6179,2033,146,115,261,
6180,1985,157,114,271,
6181,1967,168,101,269,
6182,1938,143,116,259,
6183,2041,151,116,267,
6184,1943,141,112,253,
6185,1908,126,104,230,
6186,1926,158,108,266,
6187,2038,150,100,250,
6188,2014,149,117,266,
6189,1921,158,97,255,
6190,2038,158,110,268,
6191,1975,148,95,243,
6192,2015,151,113,264,
6193,2001,163,129,292,
6194,1888,145,106,251,
6195,1976,157,106,263,
6196,1967,161,115,276,
6197,1975,137,116,253,
6198,1918,134,93,227,
6199,1948,131,116,247,
6200,1972,138,122,260,
6201,1955,128,126,254,
6202,1928,140,97,237,
6203,1944,142,132,274,
6204,1928,138,109,247,
6205,2058,131,105,236,
6206,1964,136,121,257,
6207,1946,150,101,251,
6208,2037,157,99,256,
6209,1996,153,102,255,
6210,2004,135,127,262,
6211,1988,150,119,269,
6212,1920,157,115,272,
6213,1957,141,98,239,
6214,2003,162,114,276,
6215,1952,148,119,267,
6216,1982,140,114,254,
6217,1922,147,142,289,
6218,1924,144,103,247,
6219,1947,144,100,244,
6220,1871,135,90,225,
6221,1947,130,114,244,
6222,1948,153,102,255,
6223,1908,130,92,222,
6224,1962,156,115,271,
6225,1930,127,105,232,
6226,2003,141,111,252,
6227,2015,146,111,257,
6228,1913,140,116,256,
6229,1987,144,106,250,
6230,1936,126,118,244,
6231,1990,146,87,233,
6232,2026,157,116,273,
6233,1948,138,105,243,
6234,1950,140,116,256,
6235,1982,161,120,281,
6236,1917,132,100,232,
6237,1995,137,93,230,
6238,1858,130,115,245,
6239,1875,149,118,267,
6240,1914,127,102,229,
6241,1996,144,127,271,
6242,2000,130,121,251,
6243,1935,132,111,243,
6244,2086,153,119,272,
6245,1946,149,133,282,
6246,1931,150,135,285,
6247,2021,147,116,263,
6248,1947,140,100,240,
6249,1991,135,117,252,
6250,1906,111,85,196,
6251,1968,145,110,255,
6252,1907,141,122,263,
6253,1925,140,109,249,
6254,2012,138,99,237,
6255,1993,128,97,225,
6256,1984,146,106,252,
6257,1957,140,111,251,
6258,2025,132,122,254,
6259,1996,156,106,262,
6260,2002,149,118,267,
6261,1957,136,102,238,
6262,1961,161,109,270,
6263,1989,135,110,245,
6264,1900,157,124,281,
6265,1982,121,110,231,
6266,2015,155,115,270,
6267,2007,134,113,247,
6268,1999,162,116,278,
6269,2018,176,108,284,
6270,2105,170,123,293,
6271,1981,152,104,256,
6272,2048,153,105,258,
6273,1869,154,96,250,
6274,1961,140,94,234,
6275,1982,137,108,245,
6276,2074,149,114,263,
6277,2013,144,104,248,
6278,1953,146,127,273,
6279,1940,132,123,255,
6280,1963,150,114,264,
6281,1940,126,109,235,
6282,1870,140,112,252,
6283,1921,125,98,223,
6284,1942,138,99,237,
6285,1913,123,128,251,
6286,1997,149,105,254,
6287,2079,162,114,276,
6288,1931,138,104,242,
6289,1988,152,120,272,
6290,1959,143,103,246,
6291,1936,141,109,250,
6292,1934,139,120,259,
6293,2099,145,117,262,
6294,1914,131,120,251,
6295,1977,161,120,281,
6296,1969,131,104,235,
6297,1928,149,115,264,
6298,2040,170,106,276,
6299,1976,141,113,254,
6300,1941,143,101,244,
6301,1953,160,106,266,
6302,1989,146,120,266,
6303,1994,143,121,264,
6304,1961,153,98,251,
6305,2033,137,108,245,
6306,1880,142,109,251,
6307,1993,141,118,259,
6308,1929,128,106,234,
6309,2009,129,103,232,
6310,2027,156,132,288,
6311,1984,152,101,253,
6312,1871,134,96,230,
6313,2013,148,124,272,
6314,1963,131,105,236,
6315,1998,127,129,256,
6316,1876,115,102,217,
6317,1889,133,109,242,
6318,1981,158,110,268,
6319,1948,147,102,249,
6320,1949,136,105,241,
6321,1931,136,121,257,
6322,1994,136,97,233,
6323,1952,130,101,231,
6324,1939,158,110,268,
6325,1967,150,102,252,
6326,1961,136,113,249,
6327,1976,141,105,246,
6328,1845,120,110,230,
6329,1987,141,109,250,
6330,1927,157,100,257,
6331,1963,140,128,268,
6332,1977,128,133,261,
6333,1960,147,125,272,
6334,1975,135,121,256,
6335,1898,163,93,256,
6336,2025,138,116,254,
6337,1951,151,119,270,
6338,1995,137,109,246,
6339,1916,134,77,211,
6340,2048,155,120,275,
6341,1916,110,101,211,
6342,1976,144,121,265,
6343,2006,155,122,277,
6344,1999,142,108,250,
6345,1976,138,103,241,
6346,1958,133,113,246,
6347,2014,167,133,300,
6348,1938,134,115,249,
6349,1784,134,95,229,
6350,1940,135,104,239,
6351,1971,145,135,280,
6352,1959,158,125,283,
6353,2065,141,118,259,
6354,2005,140,128,268,
6355,1994,135,110,245,
6356,1946,145,118,263,
6357,1927,146,99,245,
6358,1925,148,105,253,
6359,2006,159,115,274,
6360,1937,138,114,252,
6361,1994,136,128,264,
6362,1962,146,102,248,
6363,1976,130,123,253,
6364,1933,127,103,230,
6365,2014,131,111,242,
6366,1992,142,116,258,
6367,1997,154,119,273,
6368,1842,146,109,255,
6369,2002,145,99,244,
6370,1972,136,98,234,
6371,2008,122,110,232,
6372,1954,150,109,259,
6373,1911,141,114,255,
6374,1991,128,99,227,
6375,2006,135,98,233,
6376,1992,148,113,261,
6377,1981,160,98,258,
6378,1901,149,111,260,
6379,2005,140,107,247,
6380,1992,158,99,257,
6381,1951,168,132,300,
6382,1893,163,105,268,
6383,1910,136,92,228,
6384,1947,134,118,252,
6385,1961,145,90,235,
6386,1899,152,88,240,
6387,1969,151,125,276,
6388,1944,110,103,213,
6389,1967,156,116,272,
6390,1911,127,115,242,
6391,1951,134,106,240,
6392,2047,180,125,305,
6393,1983,161,99,260,
6394,1980,154,100,254,
6395,1931,161,97,258,
6396,2026,141,130,271,
6397,1933,151,87,238,
6398,1897,124,111,235,
6399,2049,172,107,279,
6400,2029,165,112,277,
6401,2026,142,105,247,
6402,1976,132,120,252,
6403,2006,149,123,272,
6404,1971,146,126,272,
6405,1920,152,135,287,
6406,1993,136,114,250,
6407,1939,153,109,262,
6408,1945,132,117,249,
6409,1951,152,106,258,
6410,2010,137,137,274,
6411,1966,153,103,256,
6412,1941,138,93,231,
6413,1967,160,102,262,
6414,1924,138,108,246,
6415,1955,131,111,242,
6416,2014,169,102,271,
6417,1998,152,118,270,
6418,1971,122,115,237,
6419,1969,131,101,232,
6420,1845,126,96,222,
6421,2052,142,118,260,
6422,2053,139,117,256,
6423,1995,151,110,261,
6424,1952,158,97,255,
6425,1982,139,107,246,
6426,2039,149,113,262,
6427,2023,131,118,249,
6428,1925,141,113,254,
6429,1976,146,109,255,
6430,2007,163,118,281,
6431,1975,144,121,265,
6432,2001,160,116,276,
6433,1952,135,98,233,
6434,1929,157,119,276,
6435,2028,152,95,247,
6436,1929,139,101,240,
6437,1942,146,112,258,
6438,2007,142,119,261,
6439,1950,142,136,278,
6440,1937,146,108,254,
6441,1874,136,115,251,
6442,1883,140,112,252,
6443,1955,141,117,258,
6444,1891,138,106,244,
6445,2042,129,115,244,
6446,1933,135,111,246,
6447,1934,126,96,222,
6448,2004,150,102,252,
6449,1946,131,95,226,
6450,2043,138,107,245,
6451,1880,112,107,219,
6452,1967,131,115,246,
6453,1974,169,109,278,
6454,2014,173,111,284,
6455,2044,160,114,274,
6456,2071,140,122,262,
6457,1921,149,115,264,
6458,1918,124,115,239,
6459,1940,128,111,239,
6460,1963,145,111,256,
6461,1986,157,125,282,
6462,1924,134,119,253,
6463,2051,146,112,258,
6464,1963,137,113,250,
6465,1894,157,106,263,
6466,2013,169,127,296,
6467,1926,143,108,251,
6468,1896,136,97,233,
6469,1992,148,115,263,
6470,1974,167,118,285,
6471,1984,129,97,226,
6472,1995,150,114,264,
6473,2035,165,108,273,
6474,2024,146,112,258,
6475,2007,132,126,258,
6476,1978,148,123,271,
6477,1971,157,91,248,
6478,1966,150,103,253,
6479,2080,131,126,257,
6480,1982,155,115,270,
6481,1993,162,104,266,
6482,1953,138,124,262,
6483,1954,152,122,274,
6484,1909,148,102,250,
6485,1971,149,104,253,
6486,1987,148,97,245,
6487,1953,157,111,268,
6488,2003,146,106,252,
6489,1861,147,101,248,
6490,2042,127,124,251,
6491,2019,159,101,260,
6492,1896,134,103,237,
6493,2003,163,117,280,
6494,1998,154,122,276,
6495,2001,131,116,247,
6496,1903,143,92,235,
6497,1861,132,96,228,
6498,1958,165,108,273,
6499,1974,130,105,235,
6500,1986,130,112,242,
6501,1961,157,121,278,
6502,1927,125,98,223,
6503,1964,146,90,236,
6504,1966,149,119,268,
6505,1964,145,107,252,
6506,1987,148,103,251,
6507,1983,150,101,251,
6508,1917,135,105,240,
6509,1978,155,109,264,
6510,1903,129,102,231,
6511,1916,138,113,251,
6512,1940,159,98,257,
6513,1971,141,105,246,
6514,1936,145,106,251,
6515,1989,166,122,288,
6516,1913,124,129,253,
6517,1890,129,111,240,
6518,1939,138,115,253,
6519,1913,162,110,272,
6520,1895,154,97,251,
6521,1910,136,110,246,
6522,1949,142,101,243,
6523,1919,130,125,255,
6524,1912,132,99,231,
6525,1952,149,123,272,
6526,1952,141,102,243,
6527,1932,132,110,242,
6528,1984,140,139,279,
6529,1961,126,123,249,
6530,1999,140,118,258,
6531,1899,138,107,245,
6532,1906,142,96,238,
6533,1921,114,90,204,
6534,2019,151,91,242,
6535,1982,135,99,234,
6536,1935,139,89,228,
6537,1981,156,116,272,
6538,1982,136,129,265,
6539,2009,136,122,258,
6540,1897,136,107,243,
6541,1901,136,99,235,
6542,1969,134,133,267,
6543,2023,153,129,282,
6544,1980,154,107,261,
6545,2048,144,113,257,
6546,1996,129,111,240,
6547,2043,151,121,272,
6548,1987,144,115,259,
6549,1949,132,118,250,
6550,1937,133,110,243,
6551,1893,137,118,255,
6552,1976,146,102,248,
6553,1932,145,108,253,
6554,1969,141,113,254,
6555,1980,152,101,253,
6556,1904,150,103,253,
6557,1944,155,116,271,
6558,2025,140,123,263,
6559,1958,168,111,279,
6560,1884,145,93,238,
6561,1988,131,102,233,
6562,1944,138,97,235,
6563,2014,129,130,259,
6564,1888,130,106,236,
6565,1926,144,113,257,
6566,1871,119,87,206,
6567,2031,131,112,243,
6568,1954,133,100,233,
6569,1972,147,129,276,
6570,1907,153,111,264,
6571,1986,129,121,250,
6572,1918,143,104,247,
6573,2021,133,99,232,
6574,2010,128,116,244,
6575,1893,149,100,249,
6576,1922,144,122,266,
6577,1826,129,96,225,
6578,1959,140,122,262,
6579,1936,136,106,242,
6580,1936,135,113,248,
6581,2005,151,116,267,
6582,1993,157,118,275,
6583,1902,133,103,236,
6584,1963,129,99,228,
6585,1983,141,98,239,
6586,1945,139,90,229,
6587,1987,137,119,256,
6588,1953,148,124,272,
6589,1973,136,133,269,
6590,2057,147,117,264,
6591,1905,143,122,265,
6592,1891,127,105,232,
6593,1875,151,100,251,
6594,1993,130,118,248,
6595,2007,123,99,222,
6596,1926,118,122,240,
6597,1960,128,131,259,
6598,1939,150,114,264,
6599,1993,143,105,248,
6600,1924,120,110,230,
6601,1968,165,115,280,
6602,1983,148,123,271,
6603,1976,128,122,250,
6604,1941,128,132,260,
6605,2005,150,120,270,
6606,1932,150,114,264,
6607,1971,138,107,245,
6608,1969,162,111,273,
6609,1967,138,109,247,
6610,1925,145,102,247,
6611,1887,167,111,278,
6612,1976,145,111,256,
6613,2004,151,107,258,
6614,1969,137,102,239,
6615,1864,142,109,251,
6616,1920,135,109,244,
6617,1967,139,98,237,
6618,1916,135,107,242,
6619,1958,125,120,245,
6620,1964,145,106,251,
6621,1951,153,110,263,
6622,1944,127,113,240,
6623,1905,144,92,236,
6624,1910,156,101,257,
6625,1921,138,129,267,
6626,1904,138,102,240,
6627,1945,148,111,259,
6628,2075,168,100,268,
6629,1918,163,107,270,
6630,1967,157,116,273,
6631,1898,147,97,244,
6632,1901,137,116,253,
6633,2000,128,123,251,
6634,1984,154,101,255,
6635,1930,147,116,263,
6636,1900,128,117,245,
6637,1997,138,110,248,
6638,1942,130,120,250,
6639,2059,141,116,257,
6640,1974,147,117,264,
6641,1971,150,112,262,
6642,1992,140,115,255,
6643,1933,146,100,246,
6644,1957,134,119,253,
6645,1957,138,106,244,
6646,1945,169,115,284,
6647,1996,140,98,238,
6648,1901,116,96,212,
6649,1938,129,114,243,
6650,1995,157,96,253,
6651,2016,164,100,264,
6652,1843,128,96,224,
6653,1969,156,124,280,
6654,1989,123,111,234,
6655,1947,152,111,263,
6656,2003,147,86,233,
6657,1959,135,100,235,
6658,1935,149,110,259,
6659,1959,155,109,264,
6660,1930,133,122,255,
6661,2018,125,110,235,
6662,1991,154,107,261,
6663,1996,148,101,249,
6664,1862,131,87,218,
6665,1996,155,108,263,
6666,2006,120,124,244,
6667,1888,136,107,243,
6668,1912,141,112,253,
6669,1910,135,105,240,
6670,1857,128,99,227,
6671,1968,131,107,238,
6672,1980,139,115,254,
6673,2016,148,136,284,
6674,1950,130,126,256,
6675,1981,144,100,244,
6676,2078,145,121,266,
6677,1968,142,114,256,
6678,2059,147,123,270,
6679,1937,155,104,259,
6680,1972,154,118,272,
6681,1920,135,102,237,
6682,1946,129,94,223,
6683,1951,151,106,257,
6684,1983,150,89,239,
6685,1932,143,113,256,
6686,1967,138,124,262,
6687,1909,139,119,258,
6688,1996,127,119,246,
6689,1940,129,123,252,
6690,1896,137,103,240,
6691,1948,170,99,269,
6692,2036,155,111,266,
6693,1994,137,128,265,
6694,2048,149,134,283,
6695,1985,134,112,246,
6696,1910,132,120,252,
6697,1984,136,107,243,
6698,1944,134,122,256,
6699,1913,169,95,264,
6700,2016,164,116,280,
6701,1965,151,113,264,
6702,1949,133,87,220,
6703,2016,166,115,281,
6704,1911,134,117,251,
6705,1911,131,112,243,
6706,2014,139,91,230,
6707,2002,136,104,240,
6708,1959,159,115,274,
6709,1928,144,104,248,
6710,1936,149,127,276,
6711,2011,141,107,248,
6712,1983,126,124,250,
6713,1856,132,100,232,
6714,2016,129,113,242,
6715,1946,140,110,250,
6716,1851,138,113,251,
6717,1923,147,97,244,
6718,1970,137,110,247,
6719,1951,156,115,271,
6720,1938,143,116,259,
6721,1991,158,121,279,
6722,2127,145,116,261,
6723,1881,139,107,246,
6724,2008,147,102,249,
6725,1924,159,97,256,
6726,1994,152,121,273,
6727,1856,139,109,248,
6728,1891,140,121,261,
6729,2000,143,119,262,
6730,1874,118,99,217,
6731,1986,144,113,257,
6732,2006,142,117,259,
6733,1950,142,98,240,
6734,1978,153,94,247,
6735,1902,139,99,238,
6736,1972,133,103,236,
6737,2019,157,113,270,
6738,1959,137,107,244,
6739,1924,163,132,295,
6740,2024,133,125,258,
6741,2065,146,108,254,
6742,1979,140,129,269,
6743,1965,143,110,253,
6744,1923,154,112,266,
6745,1926,135,121,256,
6746,2038,168,131,299,
6747,1944,151,117,268,
6748,1986,139,134,273,
6749,2022,141,121,262,
6750,1909,156,89,245,
6751,1998,126,96,222,
6752,1953,132,110,242,
6753,1999,149,122,271,
6754,1923,143,111,254,
6755,1943,136,102,238,
6756,1925,131,99,230,
6757,1949,157,87,244,
6758,1974,153,106,259,
6759,2008,135,118,253,
6760,1919,132,114,246,
6761,1944,148,108,256,
6762,1993,128,112,240,
6763,1974,138,115,253,
6764,1969,139,104,243,
6765,1984,155,129,284,
6766,1955,133,127,260,
6767,1999,139,133,272,
6768,1943,155,101,256,
6769,2059,163,131,294,
6770,1928,143,113,256,
6771,1957,147,112,259,
6772,1911,152,100,252,
6773,1892,145,87,232,
6774,1962,122,111,233,
6775,1958,156,123,279,
6776,2004,150,97,247,
6777,1939,157,106,263,
6778,2030,159,116,275,
6779,2025,148,114,262,
6780,1930,123,105,228,
6781,1894,152,112,264,
6782,1900,131,85,216,
6783,1948,140,102,242,
6784,1950,140,139,279,
6785,1919,145,98,243,
6786,1901,131,108,239,
6787,1948,127,98,225,
6788,1955,138,124,262,
6789,2005,169,130,299,
6790,1978,164,106,270,
6791,1923,158,90,248,
6792,2006,137,117,254,
6793,1991,133,116,249,
6794,2013,158,94,252,
6795,1969,131,117,248,
6796,1996,154,121,275,
6797,1992,142,126,268,
6798,1940,141,110,251,
6799,2008,150,112,262,
6800,1958,139,107,246,
6801,1934,146,104,250,
6802,1899,142,94,236,
6803,1945,140,110,250,
6804,1995,154,103,257,
6805,1964,129,109,238,
6806,1947,120,105,225,
6807,1911,138,99,237,
6808,1937,145,98,243,
6809,1947,157,109,266,
6810,2038,146,119,265,
6811,2061,144,135,279,
6812,1967,165,115,280,
6813,1975,169,93,262,
6814,1959,142,108,250,
6815,1979,157,112,269,
6816,1900,150,121,271,
6817,2007,126,104,230,
6818,1937,146,98,244,
6819,2002,129,99,228,
6820,1900,136,107,243,
6821,1927,146,99,245,
6822,1866,144,112,256,
6823,1959,152,91,243,
6824,1962,127,121,248,
6825,1920,135,109,244,
6826,1855,134,94,228,
6827,1992,144,139,283,
6828,1897,138,122,260,
6829,1985,147,92,239,
6830,1956,126,117,243,
6831,1907,134,119,253,
6832,1989,150,114,264,
6833,1976,145,102,247,
6834,1992,143,115,258,
6835,1935,129,107,236,
6836,1920,127,98,225,
6837,1926,150,103,253,
6838,1957,141,102,243,
6839,1934,133,109,242,
6840,1992,154,113,267,
6841,2019,162,119,281,
6842,1889,140,93,233,
6843,1954,153,106,259,
6844,1958,158,97,255,
6845,1933,152,83,235,
6846,1916,139,119,258,
6847,2003,140,114,254,
6848,1868,126,119,245,
6849,1923,131,126,257,
6850,1984,148,132,280,
6851,1958,145,103,248,
6852,1950,135,115,250,
6853,1957,148,116,264,
6854,2027,139,124,263,
6855,1980,165,100,265,
6856,1968,154,107,261,
6857,1937,141,97,238,
6858,1885,106,115,221,
6859,1912,128,113,241,
6860,1987,149,115,264,
6861,1917,126,105,231,
6862,1948,145,122,267,
6863,2051,146,133,279,
6864,2018,150,116,266,
6865,1962,145,116,261,
6866,2082,156,111,267,
6867,1965,168,116,284,
6868,1978,152,117,269,
6869,1988,159,100,259,
6870,1955,148,112,260,
6871,1907,152,113,265,
6872,1980,159,123,282,
6873,1931,124,120,244,
6874,2010,147,120,267,
6875,1974,134,110,244,
6876,2047,153,103,256,
6877,1843,117,111,228,
6878,1931,137,100,237,
6879,1960,151,117,268,
6880,1983,121,117,238,
6881,1939,153,114,267,
6882,1981,159,105,264,
6883,1977,137,119,256,
6884,1919,140,114,254,
6885,2017,133,108,241,
6886,2059,137,117,254,
6887,1940,149,112,261,
6888,1920,126,117,243,
6889,2020,147,114,261,
6890,2020,148,116,264,
6891,1954,149,100,249,
6892,1953,167,99,266,
6893,1970,149,114,263,
6894,1959,126,109,235,
6895,1991,152,109,261,
6896,2014,135,120,255,
6897,2027,140,106,246,
6898,2016,147,138,285,
6899,2000,149,123,272,
6900,1932,139,115,254,
6901,2015,163,127,290,
6902,1982,145,103,248,
6903,1985,157,126,283,
6904,1987,134,121,255,
6905,1939,146,105,251,
6906,1962,143,127,270,
6907,1963,126,123,249,
6908,1989,154,117,271,
6909,1984,146,79,225,
6910,1915,131,115,246,
6911,1998,137,128,265,
6912,2040,140,125,265,
6913,1945,163,95,258,
6914,1979,129,113,242,
6915,1966,151,96,247,
6916,1905,129,104,233,
6917,1935,136,108,244,
6918,1871,133,99,232,
6919,1998,144,102,246,
6920,1970,157,107,264,
6921,1897,143,127,270,
6922,1965,131,128,259,
6923,1964,145,123,268,
6924,1887,136,104,240,
6925,1976,137,85,222,
6926,1947,153,109,262,
6927,1952,157,123,280,
6928,1944,130,96,226,
6929,1967,138,96,234,
6930,2062,150,115,265,
6931,1969,154,111,265,
6932,2039,151,116,267,
6933,2040,137,131,268,
6934,2063,145,100,245,
6935,1998,124,109,233,
6936,1949,149,118,267,
6937,1989,142,103,245,
6938,2016,116,109,225,
6939,1957,128,125,253,
6940,2060,164,135,299,
6941,1999,144,115,259,
6942,2010,131,121,252,
6943,1985,149,119,268,
6944,2032,136,122,258,
6945,1927,150,108,258,
6946,2021,151,99,250,
6947,1945,136,121,257,
6948,1950,120,116,236,
6949,1976,160,103,263,
6950,1966,138,94,232,
6951,1954,159,126,285,
6952,1915,135,119,254,
6953,1966,139,105,244,
6954,2014,147,127,274,
6955,1910,134,126,260,
6956,1935,135,103,238,
6957,1989,140,113,253,
6958,2002,133,141,274,
6959,1919,150,106,256,
6960,2003,158,131,289,
6961,2000,130,118,248,
6962,2012,145,119,264,
6963,1915,139,108,247,
6964,2014,135,102,237,
6965,1918,145,97,242,
6966,1972,147,123,270,
6967,1970,154,106,260,
6968,1981,159,120,279,
6969,1954,134,121,255,
6970,1976,135,124,259,
6971,1989,158,111,269,
6972,1949,151,98,249,
6973,1973,142,137,279,
6974,1937,130,101,231,
6975,1978,140,116,256,
6976,1885,134,102,236,
6977,1963,144,126,270,
6978,2029,149,123,272,
6979,2021,150,122,272,
6980,1932,126,107,233,
6981,2023,159,113,272,
6982,1932,131,131,262,
6983,1946,135,123,258,
6984,1957,160,114,274,
6985,1951,136,109,245,
6986,1926,137,111,248,
6987,1972,136,122,258,
6988,1932,145,111,256,
6989,2014,135,111,246,
6990,2002,132,100,232,
6991,1981,143,104,247,
6992,1888,149,99,248,
6993,1971,160,109,269,
6994,1927,144,126,270,
6995,1990,153,106,259,
6996,1876,127,105,232,
6997,1883,144,83,227,
6998,1990,142,114,256,
6999,2053,128,111,239,
7000,1944,131,97,228,
7001,2061,146,126,272,
7002,2003,127,105,232,
7003,1964,138,102,240,
7004,1939,140,119,259,
7005,1931,148,135,283,
7006,1969,143,113,256,
7007,1955,136,133,269,
7008,1927,134,116,250,
7009,1925,134,111,245,
7010,1984,150,135,285,
7011,1971,154,99,253,
7012,2028,155,119,274,
7013,1994,129,107,236,
7014,2028,149,115,264,
7015,2077,164,110,274,
7016,1955,124,111,235,
7017,1922,146,112,258,
7018,1960,122,83,205,
7019,2020,146,111,257,
7020,1850,137,97,234,
7021,2005,140,119,259,
7022,1968,120,118,238,
7023,1878,122,122,244,
7024,1932,135,97,232,
7025,1958,144,106,250,
7026,2020,158,99,257,
7027,1908,141,104,245,
7028,1950,148,107,255,
7029,1914,155,103,258,
7030,1980,137,106,243,
7031,1982,148,115,263,
7032,2042,148,122,270,
7033,2050,173,117,290,
7034,1904,150,121,271,
7035,1913,118,94,212,
7036,1977,151,114,265,
7037,2029,144,116,260,
7038,1907,132,125,257,
7039,1949,139,130,269,
7040,2037,151,103,254,
7041,1952,125,100,225,
7042,1973,158,108,266,
7043,1982,138,98,236,
7044,1956,149,103,252,
7045,1982,133,107,240,
7046,2006,167,116,283,
7047,1973,137,123,260,
7048,1975,141,117,258,
7049,1978,155,124,279,
7050,2028,148,128,276,
7051,1955,145,119,264,
7052,1961,139,103,242,
7053,1895,137,119,256,
7054,1986,142,97,239,
7055,1951,143,100,243,
7056,1970,132,119,251,
7057,1947,132,114,246,
7058,1996,144,122,266,
7059,2043,179,100,279,
7060,1921,149,94,243,
7061,2046,140,131,271,
7062,1947,149,109,258,
7063,2020,132,136,268,
7064,1907,155,109,264,
7065,1979,161,120,281,
7066,2040,137,102,239,
7067,1986,147,90,237,
7068,1997,150,120,270,
7069,1917,150,100,250,
7070,1906,131,120,251,
7071,1943,154,105,259,
7072,1907,118,127,245,
7073,1949,131,132,263,
7074,2047,130,125,255,
7075,1909,119,117,236,
7076,1908,143,96,239,
7077,1966,148,106,254,
7078,2058,155,126,281,
7079,2044,144,107,251,
7080,1918,131,112,243,
7081,1975,155,98,253,
7082,1976,132,111,243,
7083,1946,142,131,273,
7084,1969,139,104,243,
7085,2003,133,123,256,
7086,1961,144,106,250,
7087,1946,151,111,262,
7088,1988,113,137,250,
7089,1950,155,99,254,
7090,2011,153,112,265,
7091,1982,151,108,259,
7092,2036,150,113,263,
7093,1934,122,134,256,
7094,1996,161,97,258,
7095,2000,130,108,238,
7096,2032,145,114,259,
7097,1991,124,101,225,
7098,1945,134,113,247,
7099,1959,152,103,255,
7100,1856,140,92,232,
7101,1961,144,114,258,
7102,1935,131,127,258,
7103,1999,136,114,250,
7104,1931,148,95,243,
7105,1926,128,126,254,
7106,1917,154,118,272,
7107,2024,159,115,274,
7108,1927,147,120,267,
7109,1918,129,113,242,
7110,1982,133,115,248,
7111,2016,141,116,257,
7112,2007,156,102,258,
7113,1994,136,116,252,
7114,1965,158,103,261,
7115,2082,135,92,227,
7116,2007,149,115,264,
7117,2014,151,131,282,
7118,2009,154,139,293,
7119,1966,156,113,269,
7120,2006,143,131,274,
7121,1976,161,98,259,
7122,1899,142,111,253,
7123,1954,161,97,258,
7124,2055,148,106,254,
7125,1957,132,115,247,
7126,1908,141,112,253,
7127,1891,153,117,270,
7128,1854,146,83,229,
7129,1918,156,123,279,
7130,2001,142,129,271,
7131,2026,136,137,273,
7132,1973,161,121,282,
7133,1965,142,117,259,
7134,1902,145,115,260,
7135,1955,141,93,234,
7136,1957,142,116,258,
7137,2003,134,114,248,
7138,1976,156,114,270,
7139,1954,150,107,257,
7140,2003,134,116,250,
7141,1962,129,111,240,
7142,1949,130,103,233,
7143,1942,130,107,237,
7144,1987,121,125,246,
7145,2046,173,136,309,
7146,1904,141,102,243,
7147,1868,119,123,242,
7148,1988,134,96,230,
7149,1942,142,112,254,
7150,1930,133,113,246,
7151,1895,146,113,259,
7152,1924,151,103,254,
7153,1935,143,110,253,
7154,1978,136,117,253,
7155,1968,130,127,257,
7156,1974,131,120,251,
7157,1906,133,107,240,
7158,1965,126,102,228,
7159,2003,153,125,278,
7160,1980,140,113,253,
7161,1935,134,122,256,
7162,1976,159,126,285,
7163,1939,157,127,284,
7164,1949,133,107,240,
7165,1976,143,103,246,
7166,2014,153,132,285,
7167,1902,136,110,246,
7168,2018,144,121,265,
7169,2010,139,119,258,
7170,1942,148,97,245,
7171,1949,135,127,262,
7172,1908,125,84,209,
7173,1945,140,111,251,
7174,1981,139,116,255,
7175,1971,133,102,235,
7176,1957,122,105,227,
7177,1905,122,108,230,
7178,2080,142,124,266,
7179,1977,120,118,238,
7180,1982,141,112,253,
7181,1984,138,111,249,
7182,1926,138,109,247,
7183,1918,115,136,251,
7184,1948,149,115,264,
7185,1876,135,102,237,
7186,1962,127,119,246,
7187,2027,142,115,257,
7188,2015,157,115,272,
7189,2009,155,122,277,
7190,1988,122,100,222,
7191,2047,133,123,256,
7192,1946,141,121,262,
7193,1990,147,113,260,
7194,1919,140,118,258,
7195,1961,132,126,258,
7196,2012,129,116,245,
7197,2036,155,138,293,
7198,2005,146,109,255,
7199,1989,137,115,252,
7200,1983,148,127,275,
7201,1995,135,104,239,
7202,1927,137,106,243,
7203,1906,143,107,250,
7204,2014,144,117,261,
7205,1989,136,121,257,
7206,1937,146,116,262,
7207,1967,135,125,260,
7208,1957,162,106,268,
7209,1868,131,103,234,
7210,1901,135,107,242,
7211,1959,130,104,234,
7212,1946,131,126,257,
7213,1866,158,122,280,
7214,1977,136,105,241,
7215,2049,164,119,283,
7216,2017,118,114,232,
7217,1980,145,106,251,
7218,2099,146,126,272,
7219,1956,132,126,258,
7220,1999,147,114,261,
7221,1962,141,115,256,
7222,1911,151,110,261,
7223,1926,144,97,241,
7224,2006,137,128,265,
7225,1980,161,103,264,
7226,1957,143,116,259,
7227,1973,146,118,264,
7228,1864,138,125,263,
7229,1961,133,118,251,
7230,1939,146,114,260,
7231,2044,170,100,270,
7232,1986,132,92,224,
7233,1936,164,106,270,
7234,1978,151,116,267,
7235,1953,141,102,243,
7236,1932,138,124,262,
7237,2033,136,90,226,
7238,2101,159,102,261,
7239,1974,145,103,248,
7240,1925,138,122,260,
7241,1979,162,86,248,
7242,1953,151,117,268,
7243,1981,146,126,272,
7244,1960,140,108,248,
7245,1997,155,122,277,
7246,1950,147,107,254,
7247,1986,130,117,247,
7248,1862,141,105,246,
7249,2056,154,136,290,
7250,1923,133,105,238,
7251,2024,150,120,270,
7252,2025,161,103,264,
7253,1967,126,118,244,
7254,2063,131,124,255,
7255,2007,148,113,261,
7256,1933,138,116,254,
7257,1870,150,105,255,
7258,2013,150,116,266,
7259,1966,139,106,245,
7260,1968,148,101,249,
7261,1926,112,98,210,
7262,1951,145,101,246,
7263,1934,145,125,270,
7264,1964,142,97,239,
7265,1931,144,109,253,
7266,1952,141,106,247,
7267,1922,155,108,263,
7268,1943,151,106,257,
7269,2005,147,110,257,
7270,1971,146,117,263,
7271,1976,145,119,264,
7272,2014,154,141,295,
7273,1990,140,104,244,
7274,1972,137,117,254,
7275,1871,132,96,228,
7276,1967,134,113,247,
7277,1984,155,97,252,
7278,1931,147,113,260,
7279,1894,133,102,235,
7280,1990,135,122,257,
7281,1946,133,91,224,
7282,1984,169,118,287,
7283,1923,137,105,242,
7284,2048,139,124,263,
7285,2010,134,111,245,
7286,1961,140,116,256,
7287,1945,124,116,240,
7288,2066,132,123,255,
7289,2040,154,100,254,
7290,1927,136,111,247,
7291,1922,136,105,241,
7292,1996,140,122,262,
7293,1938,154,99,253,
7294,1993,145,121,266,
7295,1938,142,111,253,
7296,1948,143,95,238,
7297,2086,174,118,292,
7298,2026,127,111,238,
7299,2058,148,125,273,
7300,1993,156,120,276,
7301,2013,131,111,242,
7302,1983,154,107,261,
7303,1892,136,110,246,
7304,1925,152,109,261,
7305,2121,149,107,256,
7306,1895,148,92,240,
7307,1941,143,104,247,
7308,2055,137,110,247,
7309,2014,164,103,267,
7310,1982,147,106,253,
7311,1986,148,108,256,
7312,2012,154,111,265,
7313,2016,139,105,244,
7314,1964,126,116,242,
7315,1988,145,106,251,
7316,2005,120,117,237,
7317,1985,160,117,277,
7318,1915,129,122,251,
7319,1950,114,124,238,
7320,1955,135,105,240,
7321,1953,125,106,231,
7322,2011,151,119,270,
7323,1935,152,110,262,
7324,1920,129,95,224,
7325,1934,154,115,269,
7326,1905,117,104,221,
7327,2095,155,138,293,
7328,1965,134,123,257,
7329,1923,119,112,231,
7330,2047,144,86,230,
7331,2004,150,119,269,
7332,2078,139,111,250,
7333,1996,148,106,254,
7334,1968,148,126,274,
7335,1975,164,121,285,
7336,1914,151,113,264,
7337,1999,150,125,275,
7338,1956,146,113,259,
7339,1865,143,112,255,
7340,1935,138,105,243,
7341,1954,145,110,255,
7342,2077,148,99,247,
7343,1909,154,101,255,
7344,2014,152,93,245,
7345,1935,160,131,291,
7346,2000,146,130,276,
7347,2010,141,119,260,
7348,1933,159,117,276,
7349,1918,137,110,247,
7350,1961,132,106,238,
7351,1986,128,107,235,
7352,1925,131,123,254,
7353,1911,153,101,254,
7354,2042,143,102,245,
7355,2013,153,134,287,
7356,2005,144,118,262,
7357,1917,134,115,249,
7358,2010,153,96,249,
7359,2035,141,114,255,
7360,1924,136,97,233,
7361,1978,145,113,258,
7362,2070,159,128,287,
7363,2032,150,101,251,
7364,2016,156,126,282,
7365,1976,136,115,251,
7366,1923,164,98,262,
7367,1928,147,121,268,
7368,1937,154,120,274,
7369,1935,151,93,244,
7370,2007,167,131,298,
7371,1942,143,103,246,
7372,2065,170,112,282,
7373,1962,123,126,249,
7374,1950,143,136,279,
7375,1924,148,98,246,
7376,1944,140,97,237,
7377,1943,154,101,255,
7378,1974,137,102,239,
7379,1981,146,120,266,
7380,1943,126,102,228,
7381,2002,131,115,246,
7382,1965,142,115,257,
7383,1976,133,99,232,
7384,2014,153,113,266,
7385,1975,143,99,242,
7386,1968,148,122,270,
7387,1930,146,100,246,
7388,1931,132,87,219,
7389,2076,159,141,300,
7390,1930,161,120,281,
7391,1982,126,98,224,
7392,1961,148,113,261,
7393,1930,124,113,237,
7394,2030,154,107,261,
7395,1936,142,118,260,
7396,2006,145,108,253,
7397,1914,135,119,254,
7398,1986,133,119,252,
7399,1848,130,117,247,
7400,1953,135,110,245,
7401,2010,149,110,259,
7402,1952,141,110,251,
7403,2033,138,121,259,
7404,1912,166,119,285,
7405,1986,139,114,253,
7406,1981,120,127,247,
7407,1981,150,138,288,
7408,1992,144,111,255,
7409,1861,141,127,268,
7410,1891,129,113,242,
7412,2023,147,110,257,
7413,2005,137,115,252,
7414,1981,141,118,259,
7415,2002,145,124,269,
7416,1982,158,115,273,
7417,1955,125,123,248,
7418,2056,146,117,263,
7419,2000,142,119,261,
7420,1994,166,108,274,
7421,1964,135,119,254,
7422,1979,129,117,246,
7423,1922,140,99,239,
7424,1972,143,106,249,
7425,1954,154,102,256,
7426,2040,159,130,289,
7427,1975,153,107,260,
7428,1947,133,136,269,
7429,1888,134,110,244,
7430,1990,146,123,269,
7431,2052,170,93,263,
7432,1924,147,118,265,
7433,2061,149,113,262,
7434,1953,145,104,249,
7435,1918,157,123,280,
7436,1951,144,109,253,
7437,1946,138,124,262,
7438,1955,153,100,253,
7439,1999,153,106,259,
7440,2070,156,132,288,
7441,1973,156,110,266,
7442,1944,150,118,268,
7443,1994,130,126,256,
7444,2015,140,116,256,
7445,2030,152,122,274,
7446,2029,158,101,259,
7447,1998,143,109,252,
7448,1950,143,115,258,
7449,1903,137,114,251,
7450,1915,148,100,248,
7451,1900,138,115,253,
7452,1929,141,112,253,
7453,1929,125,106,231,
7454,1890,124,92,216,
7455,1896,118,102,220,
7456,1956,145,127,272,
7457,1957,134,112,246,
7458,1995,149,103,252,
7459,1977,147,110,257,
7460,1970,161,117,278,
7461,2005,153,104,257,
7462,1869,134,94,228,
7463,1986,137,107,244,
7464,1988,145,120,265,
7465,1955,159,117,276,
7466,1976,154,117,271,
7467,1954,119,110,229,
7468,2010,137,109,246,
7469,1961,143,107,250,
7470,1899,139,110,249,
7471,2034,137,106,243,
7472,1969,159,100,259,
7473,2002,111,132,243,
7474,1950,151,106,257,
7475,1931,143,106,249,
7476,1974,132,114,246,
7477,1991,144,110,254,
7478,1930,150,124,274,
7479,1996,139,121,260,
7480,1942,142,95,237,
7481,1900,125,123,248,
7482,1941,127,119,246,
7483,1938,121,121,242,
7484,1920,140,109,249,
7485,2020,141,106,247,
7486,1987,140,123,263,
7487,1926,144,113,257,
7488,1957,134,101,235,
7489,1985,156,104,260,
7490,1967,160,114,274,
7491,2039,140,109,249,
7492,2005,147,108,255,
7493,2000,150,117,267,
7494,1993,159,118,277,
7495,1911,149,101,250,
7496,1995,133,115,248,
7497,1997,154,117,271,
7498,1938,141,111,252,
7499,1946,155,105,260,
7500,2045,158,110,268,
7501,2032,153,107,260,
7502,2028,166,130,296,
7503,1992,140,111,251,
7504,1935,125,90,215,
7505,2107,143,117,260,
7506,1891,125,110,235,
7507,1982,140,106,246,
7508,1946,144,103,247,
7509,1930,153,110,263,
7510,1973,162,116,278,
7511,2021,131,119,250,
7512,1963,119,108,227,
7513,2037,147,121,268,
7514,1870,123,110,233,
7515,2036,168,102,270,
7516,1984,145,110,255,
7517,2007,129,130,259,
7518,2012,131,116,247,
7519,1970,126,124,250,
7520,2024,135,112,247,
7521,1885,151,104,255,
7522,1943,155,101,256,
7523,1927,151,94,245,
7524,2001,164,102,266,
7525,1942,126,111,237,
7526,1945,155,111,266,
7527,1952,127,119,246,
7528,2006,143,123,266,
7529,1957,160,119,279,
7530,1996,169,114,283,
7531,1844,127,108,235,
7532,2007,143,117,260,
7533,1899,135,100,235,
7534,1924,141,108,249,
7535,2001,147,103,250,
7536,1939,159,112,271,
7537,1924,134,116,250,
7538,1988,137,127,264,
7539,1981,148,126,274,
7540,1923,115,130,245,
7541,1980,146,115,261,
7542,1957,138,112,250,
7543,1999,133,103,236,
7544,2030,150,111,261,
7545,2003,137,108,245,
7546,1923,132,117,249,
7547,1928,136,115,251,
7548,1964,122,115,237,
7549,1973,144,109,253,
7550,2020,169,105,274,
7551,1954,150,140,290,
7552,1901,146,115,261,
7553,1929,125,100,225,
7554,1959,149,113,262,
7555,2008,143,120,263,
7556,1925,158,99,257,
7557,2044,134,112,246,
7558,1974,153,103,256,
7559,1918,145,108,253,
7560,1903,147,108,255,
7561,1954,148,99,247,
7562,1977,145,105,250,
7563,1957,153,122,275,
7564,1947,145,110,255,
7565,2004,150,121,271,
7566,1908,146,88,234,
7567,1998,164,119,283,
7568,1938,134,111,245,
7569,2012,140,121,261,
7570,1909,155,108,263,
7571,1957,137,134,271,
7572,1937,135,120,255,
7573,1940,141,114,255,
7574,1966,126,104,230,
7575,1960,122,133,255,
7576,1980,154,104,258,
7577,2035,154,101,255,
7578,1928,130,99,229,
7579,2016,139,117,256,
7580,1955,140,98,238,
7581,2047,139,112,251,
7582,2022,137,111,248,
7583,1999,155,105,260,
7584,1921,127,106,233,
7585,1965,147,125,272,
7586,1943,149,105,254,
7587,1970,134,119,253,
7588,1958,133,104,237,
7589,1986,155,116,271,
7590,1961,150,101,251,
7591,1977,146,129,275,
7592,2010,133,111,244,
7593,1967,117,122,239,
7594,1986,142,116,258,
7595,1989,144,105,249,
7596,1951,130,96,226,
7597,2035,145,121,266,
7598,2017,129,115,244,
7599,1958,152,112,264,
7600,2033,146,112,258,
7601,1936,149,123,272,
7602,1903,145,107,252,
7603,1987,135,108,243,
7604,1996,159,112,271,
7605,1948,142,110,252,
7606,1989,140,120,260,
7607,2027,152,107,259,
7608,1991,143,117,260,
7609,1928,149,115,264,
7610,1976,136,102,238,
7611,1970,144,103,247,
7612,2011,129,116,245,
7613,1982,168,109,277,
7614,2025,167,121,288,
7615,1941,146,105,251,
7616,1934,143,120,263,
7617,1957,146,105,251,
7618,1995,114,121,235,
7619,1977,139,115,254,
7620,1971,160,113,273,
7621,1992,130,123,253,
7622,2011,145,114,259,
7623,1951,148,116,264,
7624,2051,165,119,284,
7625,1942,126,108,234,
7626,1944,135,104,239,
7627,1969,157,127,284,
7628,1986,147,121,268,
7629,1915,137,119,256,
7630,1988,140,97,237,
7631,1979,140,120,260,
7632,1990,158,114,272,
7633,2016,141,100,241,
7634,1983,143,134,277,
7635,1965,129,107,236,
7636,1941,139,113,252,
7637,2049,162,95,257,
7638,1941,139,113,252,
7639,1887,154,125,279,
7640,1936,150,107,257,
7641,1931,142,113,255,
7642,1980,147,120,267,
7643,1963,138,96,234,
7644,1986,121,110,231,
7645,2016,168,112,280,
7646,1879,129,101,230,
7647,1955,139,94,233,
7648,1942,110,108,218,
7649,1994,139,111,250,
7650,1956,160,103,263,
7651,1916,141,124,265,
7652,1899,147,111,258,
7653,1912,141,92,233,
7654,1864,144,87,231,
7655,1908,139,100,239,
7656,1911,126,97,223,
7657,1913,157,97,254,
7658,2075,149,112,261,
7659,1991,138,110,248,
7660,1997,144,118,262,
7661,1936,123,103,226,
7662,2028,132,126,258,
7663,1988,155,108,263,
7664,1944,148,114,262,
7665,1887,126,116,242,
7666,1891,146,100,246,
7667,1907,139,120,259,
7668,1908,154,119,273,
7669,2076,167,115,282,
7670,1973,133,117,250,
7671,1976,137,123,260,
7672,2025,139,101,240,
7673,1976,140,129,269,
7674,1910,143,102,245,
7675,1973,135,118,253,
7676,1987,128,126,254,
7677,1899,125,113,238,
7678,2037,133,112,245,
7679,1910,134,116,250,
7680,1992,153,121,274,
7681,1987,150,107,257,
7682,1997,129,117,246,
7683,1964,149,88,237,
7684,1909,152,92,244,
7685,2041,150,119,269,
7686,2018,142,116,258,
7687,1943,148,110,258,
7688,1978,147,119,266,
7689,1851,121,106,227,
7690,1926,142,102,244,
7691,1959,153,119,272,
7692,1932,146,111,257,
7693,1850,154,97,251,
7694,1965,155,99,254,
7695,1943,145,115,260,
7696,1948,137,110,247,
7697,1961,131,100,231,
7698,1988,157,110,267,
7699,2014,140,123,263,
7700,1873,124,101,225,
7701,2012,124,119,243,
7702,1996,137,108,245,
7703,1985,144,110,254,
7704,1919,145,108,253,
7705,1998,145,119,264,
7706,1938,140,118,258,
7707,1921,117,112,229,
7708,1980,144,106,250,
7709,1994,153,105,258,
7710,1937,153,98,251,
7711,2016,166,123,289,
7712,1981,165,109,274,
7713,1956,138,100,238,
7714,1887,137,105,242,
7715,1929,132,117,249,
7716,2000,151,115,266,
7717,1921,161,99,260,
7718,1979,149,93,242,
7719,2054,147,113,260,
7720,2062,138,106,244,
7721,1902,108,123,231,
7722,1961,143,113,256,
7723,1932,140,110,250,
7724,1986,151,99,250,
7725,1913,118,116,234,
7726,1956,147,116,263,
7727,1977,143,109,252,
7728,1996,134,104,238,
7729,2015,153,138,291,
7730,1898,132,89,221,
7731,1930,141,101,242,
7732,1999,137,100,237,
7733,2019,147,110,257,
7734,1905,160,89,249,
7735,1965,141,110,251,
7736,1977,153,94,247,
7737,1976,150,124,274,
7738,2035,138,106,244,
7739,1953,171,106,277,
7740,1911,140,121,261,
7741,2003,150,110,260,
7742,1920,135,91,226,
7743,1977,134,115,249,
7744,1983,140,111,251,
7745,2013,158,112,270,
7746,1996,136,96,232,
7747,1935,156,124,280,
7748,1901,142,101,243,
7749,1993,143,109,252,
7750,1961,133,119,252,
7751,1926,133,110,243,
7752,2029,149,126,275,
7753,2018,162,97,259,
7754,1968,115,117,232,
7755,1965,131,103,234,
7756,1942,143,110,253,
7757,1987,157,107,264,
7758,1944,154,127,281,
7759,2001,158,115,273,
7760,1946,127,111,238,
7761,1921,142,98,240,
7762,1971,146,111,257,
7763,2028,143,116,259,
7764,2046,151,110,261,
7765,1940,134,105,239,
7766,1973,150,104,254,
7767,1976,140,118,258,
7768,1994,151,110,261,
7769,1964,122,148,270,
7770,1964,140,111,251,
7771,1982,117,113,230,
7772,1962,138,122,260,
7773,1985,157,112,269,
7774,1984,133,108,241,
7775,2028,134,116,250,
7776,1988,155,104,259,
7777,2042,135,136,271,
7778,2002,169,117,286,
7779,1895,133,106,239,
7780,1928,140,101,241,
7781,1967,157,83,240,
7782,1993,151,105,256,
7783,1919,138,98,236,
7784,1882,150,109,259,
7785,1925,159,102,261,
7786,1938,133,129,262,
7787,1937,147,100,247,
7788,2010,137,116,253,
7789,1919,134,87,221,
7790,1974,161,97,258,
7791,1900,157,128,285,
7792,1991,147,114,261,
7793,1937,143,109,252,
7794,2023,151,114,265,
7795,1974,137,105,242,
7796,2034,142,121,263,
7797,1982,137,109,246,
7798,1956,157,110,267,
7799,1941,134,96,230,
7800,1994,135,110,245,
7801,2061,157,123,280,
7802,2039,143,125,268,
7803,1877,158,115,273,
7804,2002,141,131,272,
7805,2028,131,117,248,
7806,1892,151,107,258,
7807,1938,154,114,268,
7808,1885,131,95,226,
7809,1941,139,104,243,
7810,1980,165,139,304,
7811,2022,150,139,289,
7812,1969,140,105,245,
7813,1996,171,108,279,
7814,1896,122,105,227,
7815,1959,132,102,234,
7816,1942,144,109,253,
7817,1960,137,111,248,
7818,1952,134,110,244,
7819,1998,146,122,268,
7820,1970,136,111,247,
7821,1946,122,118,240,
7822,1841,139,93,232,
7823,1933,141,116,257,
7824,1910,135,119,254,
7825,1984,149,113,262,
7826,1913,148,101,249,
7827,1882,151,113,264,
7828,1955,143,109,252,
7829,1844,115,103,218,
7830,1975,123,118,241,
7831,2000,141,118,259,
7832,1940,132,129,261,
7833,2003,119,128,247,
7834,2029,144,122,266,
7835,1980,148,115,263,
7836,1949,132,100,232,
7837,1996,145,128,273,
7838,1999,136,116,252,
7839,1989,139,112,251,
7840,1960,152,93,245,
7841,1961,133,114,247,
7842,1921,171,124,295,
7843,1939,145,113,258,
7844,1976,151,114,265,
7845,2013,139,115,254,
7846,1971,144,143,287,
7847,1962,140,123,263,
7848,1881,145,101,246,
7849,2010,142,118,260,
7850,2052,143,140,283,
7851,1920,135,116,251,
7852,1980,160,105,265,
7853,2012,149,114,263,
7854,1941,166,119,285,
7855,1932,126,121,247,
7856,2041,152,113,265,
7857,1985,161,117,278,
7858,2036,139,133,272,
7859,1941,133,114,247,
7860,1887,128,118,246,
7861,1886,146,97,243,
7862,1983,136,121,257,
7863,1890,149,107,256,
7864,2008,156,111,267,
7865,1968,163,100,263,
7866,2012,165,115,280,
7867,1979,134,88,222,
7868,1899,139,141,280,
7869,1956,146,119,265,
7870,2035,149,112,261,
7871,1968,142,113,255,
7872,2040,144,115,259,
7873,1989,159,108,267,
7874,1936,147,121,268,
7875,1919,130,101,231,
7876,1964,151,107,258,
7877,2025,157,118,275,
7878,1936,129,111,240,
7879,1974,137,114,251,
7880,1996,163,114,277,
7881,1966,136,102,238,
7882,1988,152,115,267,
7883,2020,158,106,264,
7884,2020,125,101,226,
7885,1908,126,123,249,
7886,1931,142,99,241,
7887,1992,151,114,265,
7888,1997,168,124,292,
7889,1997,158,118,276,
7890,2058,161,117,278,
7891,1883,133,97,230,
7892,1940,112,112,224,
7893,1889,145,127,272,
7894,1948,143,113,256,
7895,2057,134,112,246,
7896,1920,159,97,256,
7897,1908,138,125,263,
7898,1904,130,112,242,
7899,1942,152,121,273,
7900,1955,130,107,237,
7901,1998,154,89,243,
7902,1880,132,125,257,
7903,1946,140,117,257,
7904,1929,149,112,261,
7905,1945,136,108,244,
7906,2048,160,121,281,
7907,1971,139,125,264,
7908,2018,146,113,259,
7909,1931,173,104,277,
7910,1935,159,117,276,
7911,1923,139,123,262,
7912,1954,143,120,263,
7913,1937,144,87,231,
7914,1951,142,111,253,
7915,1965,146,122,268,
7916,1937,142,102,244,
7917,1922,143,146,289,
7918,1952,129,102,231,
7919,2011,157,124,281,
7920,1953,147,114,261,
7921,1998,153,110,263,
7922,1973,154,83,237,
7923,2008,135,110,245,
7924,1975,139,112,251,
7925,1942,134,118,252,
7926,1939,140,102,242,
7927,2001,133,115,248,
7928,1982,140,130,270,
7929,1971,146,120,266,
7930,2016,155,107,262,
7931,1966,135,123,258,
7932,1932,111,110,221,
7933,1902,124,116,240,
7934,1942,140,115,255,
7935,2005,147,127,274,
7936,2033,156,132,288,
7937,1845,143,93,236,
7938,1906,128,104,232,
7939,2005,147,136,283,
7940,1948,133,106,239,
7941,1990,139,115,254,
7942,2043,141,116,257,
7943,2015,141,129,270,
7944,1986,121,111,232,
7945,1921,128,111,239,
7946,1968,153,111,264,
7947,1920,149,129,278,
7948,1999,150,127,277,
7949,1997,142,109,251,
7950,2023,143,104,247,
7951,2017,161,112,273,
7952,1950,132,124,256,
7953,2022,161,121,282,
7954,1952,142,114,256,
7955,1922,136,131,267,
7956,2016,137,113,250,
7957,1857,130,105,235,
7958,2037,135,104,239,
7959,1929,142,113,255,
7960,2042,133,108,241,
7961,2013,135,108,243,
7962,1926,129,121,250,
7963,1931,145,104,249,
7964,1956,109,117,226,
7965,2012,134,126,260,
7966,1888,126,110,236,
7967,2030,156,114,270,
7968,2040,144,117,261,
7969,1864,140,120,260,
7970,1975,146,120,266,
7971,1977,157,106,263,
7972,1955,142,106,248,
7973,1895,131,101,232,
7974,1936,142,115,257,
7975,1966,125,119,244,
7976,1942,141,125,266,
7977,1967,146,116,262,
7978,2006,139,107,246,
7979,1994,122,112,234,
7980,2031,123,127,250,
7981,1979,148,115,263,
7982,1964,140,120,260,
7983,1934,141,106,247,
7984,2046,137,111,248,
7985,1993,154,115,269,
7986,2023,156,112,268,
7987,1989,165,113,278,
7988,1953,149,114,263,
7990,1936,120,135,255,
7991,1987,152,98,250,
7992,1986,146,100,246,
7993,1924,134,116,250,
7994,1980,153,114,267,
7995,1878,131,103,234,
7996,1892,136,119,255,
7997,1929,127,117,244,
7998,1912,115,112,227,
7999,2017,147,135,282,
8000,1985,154,114,268,
8001,1913,155,103,258,
8002,1896,132,103,235,
8003,2005,130,125,255,
8004,1961,132,124,256,
8005,2032,137,125,262,
8006,1972,159,130,289,
8007,1932,132,100,232,
8008,1955,156,101,257,
8009,1989,139,120,259,
8010,1969,141,112,253,
8011,1913,157,99,256,
8012,1943,138,113,251,
8013,1942,137,113,250,
8014,1886,130,105,235,
8015,1983,143,94,237,
8016,1868,158,126,284,
8017,1988,146,101,247,
8018,1932,130,106,236,
8019,1893,138,87,225,
8020,1939,156,117,273,
8021,1894,151,107,258,
8022,1882,135,106,241,
8023,2032,135,123,258,
8024,1870,136,107,243,
8025,1916,146,96,242,
8026,1987,149,121,270,
8027,1970,160,106,266,
8028,1995,184,125,309,
8029,2009,143,114,257,
8030,1935,142,111,253,
8031,1936,140,131,271,
8032,1985,143,132,275,
8033,2033,168,119,287,
8034,1997,162,127,289,
8035,1975,148,119,267,
8036,1966,155,107,262,
8037,2000,140,116,256,
8038,1952,139,114,253,
8039,2037,159,111,270,
8040,1973,147,122,269,
8041,1966,147,106,253,
8042,1969,139,106,245,
8043,2036,137,123,260,
8044,2012,134,135,269,
8045,1979,138,95,233,
8046,1962,139,100,239,
8047,1871,147,116,263,
8048,1901,127,105,232,
8049,1975,153,107,260,
8050,1967,147,90,237,
8051,1970,167,104,271,
8052,1910,122,104,226,
8053,2009,142,102,244,
8054,1963,140,120,260,
8055,2002,141,108,249,
8056,1975,140,126,266,
8057,1989,144,113,257,
8058,1972,143,119,262,
8059,1945,159,105,264,
8060,1985,128,94,222,
8061,2011,134,116,250,
8062,1964,141,126,267,
8063,2024,158,117,275,
8064,1913,137,95,232,
8065,1937,128,107,235,
8066,1902,146,106,252,
8067,1980,131,115,246,
8068,2037,175,114,289,
8069,2032,127,104,231,
8070,2035,129,137,266,
8071,2001,149,101,250,
8072,1994,154,107,261,
8073,1855,131,112,243,
8074,2007,149,110,259,
8075,1961,133,113,246,
8076,1940,149,114,263,
8077,1944,122,106,228,
8078,1906,122,107,229,
8079,1964,117,119,236,
8080,2022,135,105,240,
8081,1953,132,117,249,
8082,1919,155,106,261,
8083,1963,151,109,260,
8084,1984,157,115,272,
8085,1981,138,132,270,
8086,1992,139,103,242,
8087,2052,144,118,262,
8088,2029,135,110,245,
8089,1930,156,109,265,
8090,2028,149,101,250,
8091,2029,146,116,262,
8092,1916,136,125,261,
8093,1933,131,109,240,
8094,1915,133,100,233,
8095,2000,159,121,280,
8096,1999,140,107,247,
8097,1985,123,104,227,
8098,1994,155,103,258,
8099,1971,155,125,280,
8100,1922,150,91,241,
8101,1969,153,119,272,
8102,2054,150,100,250,
8103,1917,131,113,244,
8104,2024,140,117,257,
8105,1967,137,88,225,
8106,1937,137,118,255,
8107,1865,138,92,230,
8108,2008,151,90,241,
8109,2028,141,116,257,
8110,2053,179,110,289,
8111,1974,139,129,268,
8112,1967,132,112,244,
8113,1894,140,116,256,
8114,2049,158,112,270,
8115,1914,139,124,263,
8116,1949,143,100,243,
8117,1974,136,111,247,
8118,1984,148,119,267,
8119,2031,149,117,266,
8120,1901,135,119,254,
8121,1943,146,128,274,
8122,2052,151,129,280,
8123,1995,164,114,278,
8124,1930,125,114,239,
8125,1995,149,120,269,
8126,2070,150,146,296,
8127,1918,119,102,221,
8128,1980,151,106,257,
8129,1957,135,105,240,
8130,1973,140,112,252,
8131,1953,152,119,271,
8132,1976,142,103,245,
8133,2015,158,104,262,
8134,2014,141,111,252,
8135,1948,145,125,270,
8136,1929,139,118,257,
8137,1991,146,130,276,
8138,1927,149,118,267,
8139,1967,167,114,281,
8140,1993,134,121,255,
8141,1971,143,100,243,
8142,1965,145,108,253,
8143,1902,124,97,221,
8144,1975,140,128,268,
8145,1974,148,106,254,
8146,2097,150,115,265,
8147,2007,140,113,253,
8148,2002,130,122,252,
8149,1926,134,117,251,
8150,1929,152,114,266,
8151,1966,147,116,263,
8152,1966,114,108,222,
8153,1864,123,107,230,
8154,1996,144,103,247,
8155,1931,113,109,222,
8156,1925,136,116,252,
8157,1980,141,114,255,
8158,1984,159,128,287,
8159,1965,149,105,254,
8160,1968,150,109,259,
8161,1868,144,111,255,
8162,1913,163,105,268,
8163,1962,134,108,242,
8164,1953,142,116,258,
8165,1910,155,117,272,
8166,1968,142,102,244,
8167,2029,145,123,268,
8168,1909,113,104,217,
8169,1887,168,107,275,
8170,1964,130,102,232,
8171,1889,140,98,238,
8172,2026,137,140,277,
8173,1912,147,93,240,
8174,2006,148,127,275,
8175,1941,142,109,251,
8176,1901,122,100,222,
8177,1980,142,130,272,
8178,2012,130,120,250,
8179,1924,134,114,248,
8180,1915,139,107,246,
8181,2047,148,122,270,
8182,2036,139,117,256,
8183,1914,146,116,262,
8184,1946,127,111,238,
8185,2002,163,109,272,
8186,2069,154,123,277,
8187,2014,137,121,258,
8188,1938,145,114,259,
8189,1917,152,94,246,
8190,1987,141,106,247,
8191,1992,145,110,255,
8192,1964,142,118,260,
8193,1961,148,106,254,
8194,1982,130,104,234,
8195,1904,153,96,249,
8196,1940,140,108,248,
8197,1929,133,121,254,
8198,1927,139,101,240,
8199,1971,170,100,270,
8200,2026,183,119,302,
8201,1994,117,116,233,
8202,1963,116,115,231,
8203,2005,156,104,260,
8204,1960,138,124,262,
8205,2032,146,109,255,
8206,2011,143,125,268,
8207,1990,158,120,278,
8208,1899,133,109,242,
8209,1982,166,95,261,
8210,1946,154,110,264,
8211,2062,149,114,263,
8212,1959,125,101,226,
8213,1997,166,116,282,
8214,1985,130,107,237,
8215,1935,135,113,248,
8216,1915,119,109,228,
8217,1946,113,113,226,
8218,1976,139,128,267,
8219,1927,142,112,254,
8220,1860,138,111,249,
8221,1999,145,115,260,
8222,2001,163,107,270,
8223,1970,134,105,239,
8224,2001,157,113,270,
8225,1945,150,104,254,
8226,1836,134,109,243,
8227,1907,148,124,272,
8228,1952,149,116,265,
8229,1958,149,93,242,
8230,1963,154,115,269,
8231,1974,137,126,263,
8232,1971,165,104,269,
8233,1943,138,108,246,
8234,1927,133,110,243,
8235,1999,136,96,232,
8236,1956,153,115,268,
8237,2016,157,112,269,
8238,1997,143,128,271,
8239,1971,139,124,263,
8240,1960,156,98,254,
8241,1971,147,128,275,
8242,1979,148,104,252,
8243,1944,137,106,243,
8244,1989,141,112,253,
8245,1901,123,94,217,
8246,2070,133,101,234,
8247,2003,136,114,250,
8248,1993,141,106,247,
8249,1989,165,117,282,
8250,1977,166,106,272,
8251,2012,150,107,257,
8252,1939,144,95,239,
8253,2070,145,122,267,
8254,1925,150,105,255,
8255,1886,128,98,226,
8256,1955,140,103,243,
8257,1944,139,124,263,
8258,1981,128,118,246,
8259,2032,144,111,255,
8260,1962,129,103,232,
8261,1967,141,121,262,
8262,2015,131,117,248,
8263,2011,145,102,247,
8264,1968,132,124,256,
8265,1890,128,112,240,
8266,1952,145,120,265,
8267,2045,142,120,262,
8268,2015,161,119,280,
8269,1975,138,112,250,
8270,1965,160,109,269,
8271,1934,153,106,259,
8272,1925,129,117,246,
8273,1934,151,115,266,
8274,1957,149,109,258,
8275,1966,120,119,239,
8276,2021,122,108,230,
8277,1974,129,108,237,
8278,1911,126,107,233,
8279,2005,142,105,247,
8280,1971,149,101,250,
8281,1911,131,119,250,
8282,2000,133,108,241,
8283,1963,141,119,260,
8284,1964,126,93,219,
8285,2002,146,90,236,
8286,2028,151,110,261,
8287,1970,136,103,239,
8288,1939,131,108,239,
8289,1887,138,124,262,
8290,2011,148,113,261,
8291,2001,147,94,241,
8292,1952,138,116,254,
8293,1965,147,95,242,
8294,1965,150,118,268,
8295,1887,127,101,228,
8296,1985,157,105,262,
8297,2006,153,125,278,
8298,1867,128,125,253,
8299,2018,148,116,264,
8300,2052,146,113,259,
8301,1943,140,114,254,
8302,1933,136,92,228,
8303,2039,158,123,281,
8304,2072,144,111,255,
8305,1986,140,99,239,
8306,1952,140,114,254,
8307,1948,145,106,251,
8308,2017,146,114,260,
8309,1989,138,118,256,
8310,1976,148,133,281,
8311,1967,159,109,268,
8312,1997,139,109,248,
8313,1929,142,114,256,
8314,1966,146,120,266,
8315,1856,119,94,213,
8316,1987,135,111,246,
8317,2047,141,107,248,
8318,2009,137,121,258,
8319,1942,136,109,245,
8320,1952,134,115,249,
8321,1897,141,123,264,
8322,1927,138,113,251,
8323,1976,153,118,271,
8324,1934,142,112,254,
8325,2010,167,108,275,
8326,1977,137,112,249,
8327,2044,166,102,268,
8328,1961,141,106,247,
8329,2062,156,121,277,
8330,2006,143,101,244,
8331,2015,159,120,279,
8332,1974,130,105,235,
8333,2081,166,111,277,
8334,1982,152,105,257,
8335,1825,133,97,230,
8336,2039,130,124,254,
8337,1965,141,110,251,
8338,1975,162,101,263,
8339,2000,137,109,246,
8340,1936,147,112,259,
8341,1982,153,110,263,
8342,1951,117,123,240,
8343,1938,131,98,229,
8344,2002,144,125,269,
8345,1949,138,132,270,
8346,1970,138,98,236,
8347,1946,163,113,276,
8348,2009,141,110,251,
8349,1959,148,114,262,
8350,1913,139,128,267,
8351,2005,167,104,271,
8352,1958,130,96,226,
8353,1912,128,103,231,
8354,1915,132,119,251,
8355,1926,164,95,259,
8356,1881,138,96,234,
8357,1917,157,121,278,
8358,1935,158,114,272,
8359,2003,133,110,243,
8360,1956,133,116,249,
8361,1938,147,118,265,
8362,1955,132,112,244,
8363,2047,138,129,267,
8364,1971,148,101,249,
8365,1953,147,106,253,
8366,1996,129,115,244,
8367,1969,138,97,235,
8368,1923,136,109,245,
8369,1907,129,103,232,
8370,1962,145,123,268,
8371,1925,137,118,255,
8372,1950,146,102,248,
8373,2013,152,142,294,
8374,1927,130,113,243,
8375,1860,145,125,270,
8376,1980,145,121,266,
8377,1976,159,91,250,
8378,1941,153,102,255,
8379,1886,162,105,267,
8380,1860,139,107,246,
8381,1957,137,107,244,
8382,1937,119,101,220,
8383,2011,137,113,250,
8384,1931,126,121,247,
8385,1974,143,117,260,
8386,1995,151,121,272,
8387,1979,150,127,277,
8388,1966,133,108,241,
8389,1964,175,114,289,
8390,1973,134,115,249,
8391,1907,141,114,255,
8392,2068,147,122,269,
8393,1973,139,116,255,
8394,1908,153,104,257,
8395,2011,137,107,244,
8396,1950,146,105,251,
8397,1948,125,105,230,
8398,1883,144,134,278,
8399,1952,139,105,244,
8400,1960,165,108,273,
8401,1948,138,107,245,
8402,1943,124,111,235,
8403,1987,145,115,260,
8404,1935,163,118,281,
8405,1968,151,119,270,
8406,1984,143,120,263,
8407,1978,128,114,242,
8408,1919,139,134,273,
8409,1926,124,115,239,
8410,1992,141,121,262,
8411,1980,142,105,247,
8412,1928,146,124,270,
8413,1925,153,105,258,
8414,2018,130,109,239,
8415,1952,143,111,254,
8416,2016,171,110,281,
8417,1976,149,124,273,
8418,1973,137,136,273,
8419,2003,141,123,264,
8420,2017,133,116,249,
8421,1929,135,119,254,
8422,1951,122,111,233,
8423,1950,141,123,264,
8424,1910,151,79,230,
8425,1987,155,83,238,
8426,1967,128,109,237,
8427,1965,135,107,242,
8428,1955,145,137,282,
8429,2021,138,123,261,
8430,1990,146,116,262,
8431,1885,129,122,251,
8432,1957,151,90,241,
8433,1983,146,125,271,
8434,2016,123,104,227,
8435,1902,154,110,264,
8436,1994,163,118,281,
8437,1977,145,111,256,
8438,2046,151,117,268,
8439,1893,161,100,261,
8440,1977,139,117,256,
8441,1982,147,115,262,
8442,1960,152,100,252,
8443,1927,135,134,269,
8444,2013,146,111,257,
8445,1947,143,127,270,
8446,1923,139,95,234,
8447,2025,133,113,246,
8448,1920,137,110,247,
8449,2117,164,131,295,
8450,1991,141,120,261,
8451,1995,162,97,259,
8452,1915,129,94,223,
8453,1928,149,89,238,
8454,2020,155,108,263,
8455,1927,154,117,271,
8456,1926,140,125,265,
8457,2029,148,107,255,
8458,1950,141,116,257,
8459,1997,142,114,256,
8460,2019,136,103,239,
8461,1984,154,126,280,
8462,1862,146,94,240,
8463,1977,133,118,251,
8464,2022,146,108,254,
8465,1956,157,112,269,
8466,1998,132,120,252,
8467,1935,149,105,254,
8468,2003,158,95,253,
8469,1833,142,99,241,
8470,1976,148,122,270,
8471,2001,153,118,271,
8472,2004,155,120,275,
8473,1980,138,126,264,
8474,1914,154,120,274,
8475,1897,127,112,239,
8476,1943,148,107,255,
8477,1964,137,114,251,
8478,1938,134,123,257,
8479,2000,149,121,270,
8480,1947,141,96,237,
8481,1935,126,106,232,
8482,2014,153,119,272,
8483,1973,131,108,239,
8484,2012,144,132,276,
8485,1926,128,92,220,
8486,1921,129,133,262,
8487,1950,144,103,247,
8488,1983,137,113,250,
8489,1988,144,111,255,
8490,1965,132,95,227,
8491,1922,127,117,244,
8492,2019,149,96,245,
8493,1925,129,108,237,
8494,1948,148,133,281,
8495,1946,134,102,236,
8496,1941,122,115,237,
8497,1961,147,121,268,
8498,1944,138,116,254,
8499,1929,138,107,245,
8500,1963,129,116,245,
8501,1923,147,121,268,
8502,1943,143,110,253,
8503,1972,147,130,277,
8504,1912,143,130,273,
8505,1961,163,70,233,
8506,1954,135,119,254,
8507,1991,157,130,287,
8508,1977,156,112,268,
8509,2011,131,113,244,
8510,1911,141,106,247,
8511,1960,125,110,235,
8512,1913,131,97,228,
8513,1989,162,113,275,
8514,1910,142,111,253,
8515,2027,142,112,254,
8516,1959,151,107,258,
8517,1947,121,108,229,
8518,1883,150,96,246,
8519,2053,148,136,284,
8520,1940,142,98,240,
8521,1956,126,103,229,
8522,1904,131,115,246,
8523,1953,137,110,247,
8524,1954,131,111,242,
8525,1938,128,93,221,
8526,1965,146,126,272,
8527,1911,152,106,258,
8528,2012,141,119,260,
8529,2025,156,104,260,
8530,1911,120,106,226,
8531,1996,127,136,263,
8532,1933,144,121,265,
8533,1927,122,95,217,
8534,2010,131,117,248,
8535,1964,135,119,254,
8536,1964,137,91,228,
8537,1964,149,111,260,
8538,2055,130,114,244,
8539,1984,167,104,271,
8540,1983,156,131,287,
8541,1988,136,147,283,
8542,2067,147,126,273,
8543,1934,142,113,255,
8544,2021,165,109,274,
8545,1953,134,114,248,
8546,1939,156,112,268,
8547,1915,134,101,235,
8548,1940,136,100,236,
8549,1951,145,103,248,
8550,2006,138,116,254,
8551,1909,147,108,255,
8552,1902,135,100,235,
8553,1947,137,118,255,
8554,1957,149,112,261,
8555,2000,150,105,255,
8556,1985,141,144,285,
8557,1940,142,99,241,
8558,2067,158,132,290,
8559,2023,151,134,285,
8560,1977,156,115,271,
8561,2027,139,115,254,
8562,1950,153,100,253,
8563,1979,128,112,240,
8564,1868,144,105,249,
8565,1970,154,103,257,
8566,1912,164,86,250,
8567,2012,151,93,244,
8568,1891,125,100,225,
8569,1934,140,101,241,
8570,2074,146,118,264,
8571,2000,154,112,266,
8572,2058,152,122,274,
8573,2012,148,139,287,
8574,1982,149,99,248,
8575,1957,138,120,258,
8576,2012,130,113,243,
8577,2034,150,133,283,
8578,1989,154,115,269,
8579,2019,135,102,237,
8580,2022,138,107,245,
8581,2015,135,103,238,
8582,1935,155,117,272,
8583,1880,114,104,218,
8584,1941,149,99,248,
8585,1905,134,110,244,
8586,1912,130,122,252,
8587,1930,149,103,252,
8588,1890,150,109,259,
8589,1978,133,117,250,
8590,1904,130,119,249,
8591,1949,134,119,253,
8592,1995,132,112,244,
8593,1934,127,103,230,
8594,2026,140,121,261,
8595,1964,151,107,258,
8596,2003,153,107,260,
8597,2083,136,121,257,
8598,1970,140,95,235,
8599,1943,153,114,267,
8600,1994,155,121,276,
8601,2011,148,120,268,
8602,2017,154,127,281,
8603,1961,146,120,266,
8604,1966,130,135,265,
8605,1938,154,101,255,
8606,1988,150,127,277,
8607,1982,134,127,261,
8608,1935,133,107,240,
8609,1922,127,115,242,
8610,2022,178,113,291,
8611,1976,149,101,250,
8612,1886,137,111,248,
8613,2000,143,111,254,
8614,1952,128,102,230,
8615,1958,130,113,243,
8616,1930,143,98,241,
8617,1965,140,120,260,
8618,1933,138,118,256,
8619,1941,142,112,254,
8620,1914,144,100,244,
8621,1956,153,104,257,
8622,1955,128,127,255,
8623,1989,143,121,264,
8624,2031,158,111,269,
8625,1959,130,107,237,
8626,1899,131,118,249,
8627,1918,155,117,272,
8628,1922,134,118,252,
8629,1947,141,98,239,
8630,1960,166,107,273,
8631,1940,138,104,242,
8632,1907,149,129,278,
8633,1990,156,112,268,
8634,1890,169,120,289,
8635,1926,147,122,269,
8636,1997,139,119,258,
8637,1991,131,113,244,
8638,2003,142,107,249,
8639,1944,131,112,243,
8640,1911,133,117,250,
8641,2011,156,105,261,
8642,1970,142,121,263,
8643,1913,159,104,263,
8644,1894,140,118,258,
8645,1958,137,128,265,
8646,1936,127,140,267,
8647,1914,129,97,226,
8648,2099,141,123,264,
8649,1942,151,120,271,
8650,1961,143,95,238,
8651,1919,128,127,255,
8652,1983,148,120,268,
8653,1925,123,107,230,
8654,1960,134,101,235,
8655,1942,149,128,277,
8656,2020,135,128,263,
8657,1905,144,110,254,
8658,1994,164,123,287,
8659,1890,144,107,251,
8660,1978,144,113,257,
8661,1960,154,105,259,
8662,1972,159,117,276,
8663,1877,131,101,232,
8664,1890,145,123,268,
8665,1954,125,106,231,
8666,2018,130,119,249,
8667,1888,142,119,261,
8668,1898,148,123,271,
8669,2014,143,107,250,
8670,2034,158,107,265,
8671,2044,170,120,290,
8672,1994,157,120,277,
8673,1954,145,111,256,
8674,1978,135,117,252,
8675,1898,161,103,264,
8676,1993,142,110,252,
8677,2062,137,143,280,
8678,1916,117,105,222,
8679,1957,141,128,269,
8680,1967,135,107,242,
8681,1951,146,113,259,
8682,2015,155,132,287,
8683,2014,129,112,241,
8684,2019,146,121,267,
8685,2032,164,125,289,
8686,2035,155,113,268,
8687,1980,120,121,241,
8688,1949,158,120,278,
8689,1919,138,114,252,
8690,2032,134,102,236,
8691,2042,160,116,276,
8692,1982,139,111,250,
8693,1920,130,121,251,
8694,1978,134,106,240,
8695,1981,131,123,254,
8696,1920,136,116,252,
8697,1900,158,101,259,
8698,1959,149,117,266,
8699,1995,155,115,270,
8700,2077,136,108,244,
8701,1943,140,105,245,
8702,1894,143,111,254,
8703,1969,162,94,256,
8704,1976,143,105,248,
8705,1925,140,119,259,
8706,1903,145,113,258,
8707,1966,153,124,277,
8708,1908,139,102,241,
8709,1921,124,118,242,
8710,1925,143,110,253,
8711,1972,127,124,251,
8712,1908,152,121,273,
8713,1966,122,116,238,
8714,1903,131,87,218,
8715,1936,154,115,269,
8716,1927,148,111,259,
8717,1975,127,104,231,
8718,2017,136,103,239,
8719,1948,146,118,264,
8720,1949,140,101,241,
8721,2058,158,110,268,
8722,1988,148,106,254,
8723,1957,162,92,254,
8724,1957,150,105,255,
8725,1901,134,108,242,
8726,1903,140,112,252,
8727,1942,155,90,245,
8728,1931,141,93,234,
8729,1920,131,104,235,
8730,1941,156,123,279,
8731,1986,132,125,257,
8732,1956,140,127,267,
8733,1890,135,102,237,
8734,1871,131,113,244,
8735,1948,136,104,240,
8736,1979,149,117,266,
8737,1905,161,112,273,
8738,1892,141,104,245,
8739,1912,144,110,254,
8740,2056,142,124,266,
8741,1941,143,90,233,
8742,2045,153,105,258,
8743,1915,155,117,272,
8744,1986,147,116,263,
8745,1925,145,105,250,
8746,1892,152,100,252,
8747,1937,144,117,261,
8748,1976,134,119,253,
8749,1939,145,112,257,
8750,2017,136,108,244,
8751,1981,130,121,251,
8752,1926,152,116,268,
8753,2042,136,118,254,
8754,2051,135,125,260,
8755,1990,152,106,258,
8756,1985,137,94,231,
8757,1963,137,108,245,
8758,2004,149,110,259,
8759,1963,136,109,245,
8760,2055,163,128,291,
8761,2008,146,109,255,
8762,1928,149,124,273,
8763,1927,149,96,245,
8764,1966,150,124,274,
8765,1868,132,126,258,
8766,1933,154,110,264,
8767,1957,137,109,246,
8768,2018,130,123,253,
8769,2035,154,136,290,
8770,1982,158,109,267,
8771,1924,140,103,243,
8772,1943,165,116,281,
8773,1937,130,113,243,
8774,1979,139,134,273,
8775,2067,157,109,266,
8776,2021,146,101,247,
8777,1989,120,118,238,
8778,1939,138,141,279,
8779,1910,142,106,248,
8780,1982,160,129,289,
8781,1901,150,110,260,
8782,1942,131,112,243,
8783,2016,134,118,252,
8784,1953,144,99,243,
8785,1962,134,108,242,
8786,1944,132,112,244,
8787,1888,121,112,233,
8788,1920,120,104,224,
8789,1920,136,115,251,
8790,1868,124,104,228,
8791,1985,147,122,269,
8792,1923,122,120,242,
8793,1943,133,113,246,
8794,1978,137,110,247,
8795,1968,136,87,223,
8796,1955,123,105,228,
8797,1962,151,112,263,
8798,1969,145,113,258,
8799,2024,142,108,250,
8800,1936,135,105,240,
8801,2087,156,128,284,
8802,1985,150,129,279,
8803,1995,137,124,261,
8804,1921,146,101,247,
8805,2031,150,122,272,
8806,1999,157,118,275,
8807,2016,146,120,266,
8808,1953,153,105,258,
8809,1935,137,101,238,
8810,2018,169,118,287,
8811,1922,158,103,261,
8812,1901,128,122,250,
8813,2024,160,105,265,
8814,1972,137,113,250,
8815,1971,163,123,286,
8816,1939,147,125,272,
8817,1909,135,94,229,
8818,1941,131,107,238,
8819,1950,146,100,246,
8820,1969,152,118,270,
8821,1935,153,112,265,
8822,1990,161,111,272,
8823,2063,128,122,250,
8824,1957,134,108,242,
8825,1963,162,112,274,
8826,1930,122,108,230,
8827,2023,163,113,276,
8828,1976,142,99,241,
8829,1928,155,112,267,
8830,2007,145,106,251,
8831,2003,130,113,243,
8832,1948,148,110,258,
8833,1907,143,108,251,
8834,1967,136,108,244,
8835,2003,153,101,254,
8836,1947,152,105,257,
8837,1934,141,114,255,
8838,1908,158,125,283,
8839,1958,133,129,262,
8840,1963,149,97,246,
8841,2005,144,96,240,
8842,1925,143,90,233,
8843,2067,165,138,303,
8844,1969,147,110,257,
8845,1972,155,104,259,
8846,1956,146,130,276,
8847,1891,137,112,249,
8848,1926,137,116,253,
8849,2011,149,108,257,
8850,1969,143,129,272,
8851,1932,131,121,252,
8852,1922,141,102,243,
8853,2042,166,122,288,
8854,1966,136,120,256,
8855,1915,133,111,244,
8856,1923,144,113,257,
8857,1960,138,116,254,
8858,1917,131,132,263,
8859,1915,138,114,252,
8860,1975,132,111,243,
8861,1888,143,135,278,
8862,2005,126,130,256,
8863,2048,142,122,264,
8864,1872,141,100,241,
8865,1939,145,92,237,
8866,1984,154,124,278,
8867,1926,150,121,271,
8868,2054,148,119,267,
8869,1974,161,106,267,
8870,2056,147,127,274,
8871,1954,125,121,246,
8872,1944,163,101,264,
8873,1911,152,96,248,
8874,1964,139,118,257,
8875,1985,147,132,279,
8876,1932,133,108,241,
8877,1971,146,88,234,
8878,2005,151,95,246,
8879,2000,157,111,268,
8880,1966,123,105,228,
8881,2046,140,115,255,
8882,2053,148,111,259,
8883,1998,139,123,262,
8884,1999,133,113,246,
8885,1935,132,100,232,
8886,1992,141,116,257,
8887,2003,159,111,270,
8888,1954,142,95,237,
8889,1965,128,105,233,
8890,1886,163,101,264,
8891,1914,144,114,258,
8892,1956,138,121,259,
8893,1965,151,91,242,
8894,1987,139,122,261,
8895,1956,158,125,283,
8896,2005,133,110,243,
8897,1868,127,108,235,
8898,1948,142,103,245,
8899,1991,144,110,254,
8900,2004,151,124,275,
8901,2019,150,105,255,
8902,1920,139,114,253,
8903,1875,159,111,270,
8904,1977,130,107,237,
8905,2068,134,132,266,
8906,1947,148,115,263,
8907,1958,135,118,253,
8908,1947,142,107,249,
8909,1977,142,121,263,
8910,2053,126,93,219,
8911,1988,131,105,236,
8912,2047,144,119,263,
8913,1981,138,106,244,
8914,2017,156,110,266,
8915,1965,161,95,256,
8916,1928,147,98,245,
8917,1963,136,117,253,
8918,2020,136,108,244,
8919,1982,147,113,260,
8920,2016,143,120,263,
8921,1905,157,127,284,
8922,1955,154,104,258,
8923,1991,123,108,231,
8924,2010,140,106,246,
8925,1973,157,117,274,
8926,1996,136,124,260,
8927,2022,150,128,278,
8928,1981,137,108,245,
8929,2036,155,133,288,
8930,1960,153,115,268,
8931,1917,132,102,234,
8932,1964,146,122,268,
8933,1954,136,101,237,
8934,2044,150,110,260,
8935,1994,158,99,257,
8936,1993,146,122,268,
8937,1933,132,108,240,
8938,1964,145,119,264,
8939,1941,134,121,255,
8940,1871,128,108,236,
8941,1984,138,116,254,
8942,1997,148,112,260,
8943,1855,130,112,242,
8944,2058,122,107,229,
8945,2019,166,109,275,
8946,1927,108,107,215,
8947,1988,146,98,244,
8948,1929,124,108,232,
8949,1952,132,122,254,
8950,1974,135,118,253,
8951,1896,151,108,259,
8952,2002,163,135,298,
8953,1928,149,102,251,
8954,2015,148,104,252,
8955,1943,141,122,263,
8956,1979,127,105,232,
8957,1953,156,101,257,
8958,1956,138,112,250,
8959,1983,140,124,264,
8960,1857,145,100,245,
8961,1849,127,103,230,
8962,1941,152,117,269,
8963,1944,121,116,237,
8964,1923,138,109,247,
8965,1791,126,119,245,
8966,2003,160,111,271,
8967,1991,141,102,243,
8968,1937,143,93,236,
8969,2028,166,118,284,
8970,2013,153,108,261,
8971,1995,143,125,268,
8972,1935,139,92,231,
8973,1943,141,137,278,
8974,1875,127,126,253,
8975,2030,151,133,284,
8976,2059,142,130,272,
8977,1993,150,115,265,
8978,1903,141,110,251,
8979,1995,141,102,243,
8980,1929,152,105,257,
8981,1954,146,109,255,
8982,1981,147,118,265,
8983,1867,161,112,273,
8984,1936,143,114,257,
8985,1885,136,92,228,
8986,1984,151,102,253,
8987,1991,128,111,239,
8988,1943,126,107,233,
8989,1980,153,130,283,
8990,2071,151,120,271,
8991,1934,147,99,246,
8992,1994,126,114,240,
8993,1981,138,121,259,
8994,1967,140,113,253,
8995,1929,115,99,214,
8996,2000,150,103,253,
8997,2001,158,121,279,
8998,1946,140,124,264,
8999,1924,137,108,245,
9000,1953,155,110,265,
9001,1956,143,106,249,
9002,2002,132,99,231,
9003,1924,112,90,202,
9004,1968,142,95,237,
9005,1967,144,114,258,
9006,2014,136,103,239,
9007,1835,139,117,256,
9008,1910,135,117,252,
9009,1967,143,103,246,
9010,2030,133,105,238,
9011,1980,139,118,257,
9012,2035,158,107,265,
9013,2022,137,122,259,
9014,1951,166,113,279,
9015,2002,141,126,267,
9016,1936,127,116,243,
9017,2074,157,105,262,
9018,1947,141,103,244,
9019,1959,145,118,263,
9020,1982,136,108,244,
9021,1951,132,131,263,
9022,1905,116,111,227,
9023,1979,162,92,254,
9024,2027,139,116,255,
9025,2004,167,114,281,
9026,1890,134,93,227,
9027,1981,162,118,280,
9028,1961,149,114,263,
9029,2004,158,116,274,
9030,1930,155,111,266,
9031,1988,142,119,261,
9032,1987,145,112,257,
9033,1956,135,108,243,
9034,1977,137,132,269,
9035,2010,159,106,265,
9036,1935,136,114,250,
9037,1928,139,124,263,
9038,1910,136,87,223,
9039,1998,150,101,251,
9040,2067,145,123,268,
9041,1982,146,110,256,
9042,2004,137,113,250,
9043,1976,158,99,257,
9044,1926,162,102,264,
9045,1973,138,129,267,
9046,2008,155,106,261,
9047,1964,143,105,248,
9048,1984,152,99,251,
9049,1986,149,106,255,
9050,2011,151,117,268,
9051,2016,156,114,270,
9052,2004,143,104,247,
9053,1912,136,107,243,
9054,1844,129,105,234,
9055,2007,154,105,259,
9056,1935,145,117,262,
9057,1986,130,115,245,
9058,1992,142,97,239,
9059,1865,146,105,251,
9060,2038,145,111,256,
9061,1963,139,107,246,
9062,1975,135,128,263,
9063,1944,140,110,250,
9064,1967,146,112,258,
9065,1957,152,122,274,
9066,1871,147,96,243,
9067,1939,140,103,243,
9068,1979,155,99,254,
9069,1918,136,115,251,
9070,1958,140,112,252,
9071,1994,158,129,287,
9072,2002,140,122,262,
9073,1976,136,126,262,
9074,1988,153,112,265,
9075,2009,160,120,280,
9076,2024,141,143,284,
9077,1965,132,117,249,
9078,2026,155,91,246,
9079,1996,160,110,270,
9080,1980,137,110,247,
9081,1981,166,113,279,
9082,2028,146,111,257,
9083,1960,143,113,256,
9084,2036,163,131,294,
9085,1951,134,107,241,
9086,1899,138,110,248,
9087,1980,142,113,255,
9088,1916,134,117,251,
9089,2048,173,136,309,
9090,1965,122,114,236,
9091,1902,142,117,259,
9092,1930,171,113,284,
9093,1979,139,111,250,
9094,1891,130,111,241,
9095,2007,140,121,261,
9096,1976,143,126,269,
9097,1992,162,82,244,
9098,2059,125,119,244,
9099,1921,138,108,246,
9100,2003,151,112,263,
9101,1985,141,105,246,
9102,1951,126,106,232,
9103,1972,146,102,248,
9104,2001,133,103,236,
9105,1884,129,114,243,
9106,2041,152,115,267,
9107,1933,141,108,249,
9108,1916,123,103,226,
9109,1895,144,101,245,
9110,1895,132,125,257,
9111,1917,154,99,253,
9112,1910,138,105,243,
9113,1906,127,114,241,
9114,1993,151,112,263,
9115,1943,159,111,270,
9116,2032,161,117,278,
9117,1980,122,126,248,
9118,1977,143,113,256,
9119,1957,152,116,268,
9120,1915,150,102,252,
9121,1983,133,123,256,
9122,1943,131,97,228,
9123,2061,138,119,257,
9124,1928,134,101,235,
9125,1999,147,117,264,
9126,1991,136,126,262,
9127,1955,124,100,224,
9128,1968,161,113,274,
9129,1998,138,115,253,
9130,1932,124,103,227,
9131,1946,133,103,236,
9132,1946,143,116,259,
9133,2016,142,108,250,
9134,1887,144,111,255,
9135,1945,145,113,258,
9136,1995,180,109,289,
9137,1965,158,108,266,
9138,1906,138,121,259,
9139,1980,170,106,276,
9140,1961,147,111,258,
9141,1982,155,127,282,
9142,2011,120,107,227,
9143,2004,144,118,262,
9144,1925,154,104,258,
9145,1950,132,110,242,
9146,1989,136,104,240,
9147,1912,130,110,240,
9148,2033,131,109,240,
9149,1907,133,126,259,
9150,1931,129,120,249,
9151,1918,108,96,204,
9152,1969,156,108,264,
9153,1982,157,126,283,
9154,1959,133,102,235,
9155,1964,121,109,230,
9156,1912,140,115,255,
9157,1909,134,105,239,
9158,1935,177,98,275,
9159,1955,107,106,213,
9160,2023,146,128,274,
9161,1965,148,116,264,
9162,1929,134,105,239,
9163,1989,150,125,275,
9164,1942,135,114,249,
9165,1977,154,123,277,
9166,1942,127,119,246,
9167,1974,153,89,242,
9168,1827,138,103,241,
9169,2011,158,110,268,
9170,2000,148,122,270,
9171,1992,131,103,234,
9172,2005,143,115,258,
9173,1951,153,115,268,
9174,2012,146,123,269,
9175,2002,148,112,260,
9176,2001,144,122,266,
9177,1961,128,123,251,
9178,2011,140,130,270,
9179,2090,153,102,255,
9180,2021,145,123,268,
9181,1954,134,114,248,
9182,1912,138,115,253,
9183,1977,145,100,245,
9184,1994,133,132,265,
9185,1912,124,117,241,
9186,1993,144,114,258,
9187,2033,158,110,268,
9188,2003,121,104,225,
9189,1915,139,103,242,
9190,1893,137,108,245,
9191,1984,126,115,241,
9192,1939,158,122,280,
9193,2048,155,120,275,
9194,1918,133,119,252,
9195,1951,148,122,270,
9196,1953,130,100,230,
9197,1986,140,117,257,
9198,1960,136,118,254,
9199,2050,149,113,262,
9200,1931,119,111,230,
9201,1982,162,122,284,
9202,1979,150,121,271,
9203,2013,122,114,236,
9204,1960,141,120,261,
9205,1960,129,115,244,
9206,1944,143,117,260,
9207,2041,159,119,278,
9208,1999,150,116,266,
9209,1884,144,104,248,
9210,1951,145,114,259,
9211,1992,158,116,274,
9212,1992,127,132,259,
9213,1983,148,99,247,
9214,1994,138,111,249,
9215,1921,147,104,251,
9216,1934,139,122,261,
9217,1985,147,102,249,
9218,1942,150,124,274,
9219,1945,141,118,259,
9220,1928,182,120,302,
9221,1905,142,120,262,
9222,1921,123,123,246,
9223,2012,160,128,288,
9224,2020,135,103,238,
9225,1970,145,120,265,
9226,1887,139,124,263,
9227,2015,160,112,272,
9228,2000,150,110,260,
9229,1931,143,101,244,
9230,1919,139,114,253,
9231,1979,156,118,274,
9232,2004,132,116,248,
9233,1966,128,101,229,
9234,2014,133,117,250,
9235,1958,144,108,252,
9236,2049,152,92,244,
9237,1944,150,96,246,
9238,1886,130,104,234,
9239,1998,155,110,265,
9240,1965,141,113,254,
9241,1949,133,108,241,
9242,1985,139,112,251,
9243,1948,154,99,253,
9244,1895,150,107,257,
9245,1938,145,113,258,
9246,1970,158,138,296,
9247,2060,152,131,283,
9248,1984,149,124,273,
9249,1968,123,102,225,
9250,1961,144,122,266,
9251,1852,141,112,253,
9252,2002,141,109,250,
9253,1975,135,128,263,
9254,2053,146,111,257,
9255,2000,145,111,256,
9256,1986,142,119,261,
9257,1954,123,126,249,
9258,2024,173,104,277,
9259,2079,156,127,283,
9260,1984,123,122,245,
9261,1933,151,115,266,
9262,1932,144,92,236,
9263,1899,157,102,259,
9264,1926,130,107,237,
9265,1933,136,95,231,
9266,1912,146,106,252,
9267,1953,155,114,269,
9268,2006,155,95,250,
9269,1984,156,120,276,
9270,1928,143,118,261,
9271,1957,160,96,256,
9272,1943,151,110,261,
9273,1967,140,110,250,
9274,2000,157,113,270,
9275,2015,150,115,265,
9276,1967,155,121,276,
9277,1970,128,118,246,
9278,1968,131,83,214,
9279,2010,139,107,246,
9280,1944,135,117,252,
9281,1947,131,107,238,
9282,1971,131,110,241,
9283,1879,127,125,252,
9284,1866,135,108,243,
9285,1968,146,120,266,
9286,1880,145,102,247,
9287,2041,147,131,278,
9288,1953,133,108,241,
9289,1953,137,101,238,
9290,2013,160,121,281,
9291,1918,129,101,230,
9292,2017,148,127,275,
9293,1919,139,94,233,
9294,2022,157,121,278,
9295,1982,159,102,261,
9296,1991,136,128,264,
9297,1901,141,108,249,
9298,1894,144,97,241,
9299,1917,160,97,257,
9300,1965,150,112,262,
9301,1955,129,126,255,
9302,1934,135,96,231,
9303,1933,141,106,247,
9304,1989,124,120,244,
9305,1956,121,118,239,
9306,1993,143,115,258,
9307,2064,149,117,266,
9308,1905,138,115,253,
9309,1939,147,98,245,
9310,1931,130,113,243,
9311,2021,166,94,260,
9312,1920,131,131,262,
9313,2000,186,112,298,
9314,1985,137,116,253,
9315,2013,141,119,260,
9316,1962,152,93,245,
9317,1914,149,112,261,
9318,1947,120,107,227,
9319,1935,148,106,254,
9320,1924,140,110,250,
9321,1908,145,105,250,
9322,1983,147,88,235,
9323,1930,142,112,254,
9324,1911,124,110,234,
9325,1981,139,123,262,
9326,1918,137,103,240,
9327,1965,132,107,239,
9328,1978,138,102,240,
9329,1981,149,95,244,
9330,1995,138,107,245,
9331,1977,150,120,270,
9332,2030,168,110,278,
9333,2045,137,110,247,
9334,2009,153,104,257,
9335,1962,148,99,247,
9336,1980,146,128,274,
9337,1903,144,106,250,
9338,1974,126,116,242,
9339,1972,149,123,272,
9340,1991,155,107,262,
9341,1942,142,118,260,
9342,2019,138,107,245,
9343,1962,151,105,256,
9344,1984,162,115,277,
9345,1871,124,123,247,
9346,1913,131,101,232,
9347,2015,138,113,251,
9348,1965,151,107,258,
9349,1975,152,97,249,
9350,1951,137,107,244,
9351,2023,148,99,247,
9352,2043,154,125,279,
9353,1959,136,125,261,
9354,1961,134,130,264,
9355,1968,151,85,236,
9356,1906,134,118,252,
9357,1872,132,105,237,
9358,1943,138,99,237,
9359,1942,164,109,273,
9360,1900,137,107,244,
9361,2004,145,114,259,
9362,1959,136,102,238,
9363,1952,150,115,265,
9364,1950,121,120,241,
9365,1995,155,129,284,
9366,1942,167,108,275,
9367,1926,155,100,255,
9368,2024,156,108,264,
9369,1999,154,112,266,
9370,2059,147,126,273,
9371,1941,141,103,244,
9372,1914,143,119,262,
9373,2035,153,122,275,
9374,1966,133,95,228,
9375,2012,150,103,253,
9376,1945,138,126,264,
9377,2000,138,102,240,
9378,1949,151,120,271,
9379,1949,131,127,258,
9380,1943,138,112,250,
9381,1915,148,119,267,
9382,1921,120,106,226,
9383,1959,142,124,266,
9384,1924,135,110,245,
9385,1998,145,102,247,
9386,1984,148,110,258,
9387,1961,157,109,266,
9388,1996,143,117,260,
9389,2001,164,109,273,
9390,1990,144,135,279,
9391,1964,166,124,290,
9392,1985,153,123,276,
9393,1971,160,112,272,
9394,1971,116,121,237,
9395,1966,156,113,269,
9396,1978,138,117,255,
9397,1942,126,117,243,
9398,1953,153,104,257,
9399,1918,138,99,237,
9400,1929,126,94,220,
9401,1945,127,122,249,
9402,1917,116,114,230,
9403,1881,141,110,251,
9404,1989,113,117,230,
9405,1871,149,129,278,
9406,2024,167,112,279,
9407,1999,151,102,253,
9408,1978,150,131,281,
9409,1993,138,101,239,
9410,1921,139,113,252,
9411,1967,131,110,241,
9412,1884,127,101,228,
9413,1963,114,126,240,
9414,1948,144,123,267,
9415,1959,148,112,260,
9416,1858,134,125,259,
9417,2144,167,108,275,
9418,1918,136,123,259,
9419,1983,143,106,249,
9420,1959,144,120,264,
9421,1952,150,101,251,
9422,2011,138,100,238,
9423,2024,168,132,300,
9424,1956,160,127,287,
9425,1905,134,126,260,
9426,1909,145,116,261,
9427,1874,141,119,260,
9428,1914,133,123,256,
9429,1916,141,117,258,
9430,1960,141,115,256,
9431,1979,156,126,282,
9432,1961,151,99,250,
9433,1917,135,118,253,
9434,1962,138,111,249,
9435,1873,136,103,239,
9436,1908,135,115,250,
9437,2072,162,119,281,
9438,2029,155,107,262,
9439,1956,143,128,271,
9440,1951,142,110,252,
9441,1963,142,106,248,
9442,1917,135,116,251,
9443,1936,152,106,258,
9444,1885,150,135,285,
9445,1985,143,114,257,
9446,2042,147,134,281,
9447,1944,152,116,268,
9448,1973,151,102,253,
9449,1944,125,107,232,
9450,1972,148,116,264,
9451,2045,164,118,282,
9452,1932,136,107,243,
9453,2003,149,109,258,
9454,1979,141,114,255,
9455,1978,134,124,258,
9456,2052,143,120,263,
9457,1982,155,104,259,
9458,2020,153,131,284,
9459,2051,171,133,304,
9460,1939,176,91,267,
9461,1919,139,99,238,
9462,2014,139,144,283,
9463,1962,140,112,252,
9464,1926,140,112,252,
9465,1891,138,87,225,
9466,2004,150,115,265,
9467,1959,139,101,240,
9468,1860,131,84,215,
9469,2043,143,110,253,
9470,1953,143,115,258,
9471,1950,124,108,232,
9472,1909,151,112,263,
9473,1965,136,107,243,
9474,1957,128,102,230,
9475,1982,139,120,259,
9476,2045,157,117,274,
9477,1904,123,109,232,
9478,1980,146,125,271,
9479,1997,127,102,229,
9480,2017,142,110,252,
9481,1993,157,115,272,
9482,1931,140,96,236,
9483,1946,138,112,250,
9484,2024,150,117,267,
9485,2012,142,112,254,
9486,2027,146,123,269,
9487,1946,140,117,257,
9488,1990,138,124,262,
9489,1957,164,104,268,
9490,1947,147,123,270,
9491,1949,144,122,266,
9492,1974,141,120,261,
9493,1998,125,129,254,
9494,2015,177,100,277,
9495,1985,124,116,240,
9496,1999,149,126,275,
9497,1925,143,111,254,
9498,1991,146,108,254,
9499,1959,153,119,272,
9500,1965,135,114,249,
9501,1995,136,123,259,
9502,2009,153,115,268,
9503,2032,132,126,258,
9504,1912,142,119,261,
9505,1917,175,96,271,
9506,1973,151,108,259,
9507,1938,147,119,266,
9508,1992,162,116,278,
9509,1934,141,99,240,
9510,1894,143,103,246,
9511,1949,139,104,243,
9512,1949,138,97,235,
9513,1859,144,107,251,
9514,1933,125,119,244,
9515,2014,146,110,256,
9516,2014,163,124,287,
9517,1951,150,132,282,
9518,1931,151,103,254,
9519,1965,134,120,254,
9520,1940,130,105,235,
9521,1977,130,127,257,
9522,2025,152,122,274,
9523,2038,167,124,291,
9524,1919,112,108,220,
9525,1899,129,97,226,
9526,2085,138,132,270,
9527,1990,114,114,228,
9528,1920,136,108,244,
9529,1944,117,105,222,
9530,1928,134,107,241,
9531,2018,130,123,253,
9532,2110,149,105,254,
9533,1909,121,123,244,
9534,1934,150,130,280,
9535,2035,125,118,243,
9536,1952,131,106,237,
9537,1975,143,137,280,
9538,1933,151,110,261,
9539,1960,119,116,235,
9540,2039,150,122,272,
9541,2004,143,110,253,
9542,2033,138,109,247,
9543,1900,137,102,239,
9544,1977,154,118,272,
9545,1934,144,94,238,
9546,1995,149,109,258,
9547,1983,147,109,256,
9548,1956,139,96,235,
9549,1975,138,108,246,
9550,1958,143,120,263,
9551,1952,123,125,248,
9552,1957,136,118,254,
9553,1978,173,128,301,
9554,1941,128,117,245,
9555,1985,145,132,277,
9556,1953,144,116,260,
9557,1973,161,116,277,
9558,1946,133,87,220,
9559,1953,134,95,229,
9560,1907,128,129,257,
9561,1967,153,112,265,
9562,1991,157,114,271,
9563,2006,152,104,256,
9564,1886,119,97,216,
9565,1956,144,119,263,
9566,1952,157,111,268,
9567,1961,141,109,250,
9568,1890,151,124,275,
9569,2035,153,125,278,
9570,2032,146,107,253,
9571,2005,145,91,236,
9572,1922,140,127,267,
9573,1972,134,101,235,
9574,1980,153,119,272,
9575,1942,151,108,259,
9576,1966,146,113,259,
9577,1980,137,116,253,
9578,1972,133,99,232,
9579,1971,152,105,257,
9580,2031,130,106,236,
9581,1970,135,114,249,
9582,2005,142,108,250,
9583,1987,115,120,235,
9584,1935,135,123,258,
9585,1955,129,107,236,
9586,1972,118,107,225,
9587,1990,132,117,249,
9588,2009,136,134,270,
9589,1956,149,111,260,
9590,1861,121,91,212,
9591,1989,130,133,263,
9592,1952,140,105,245,
9593,1946,139,124,263,
9594,1948,149,110,259,
9595,1965,156,130,286,
9596,2000,141,138,279,
9597,1988,146,109,255,
9598,2028,140,132,272,
9599,1982,143,119,262,
9600,1961,148,131,279,
9601,2031,163,107,270,
9602,2010,161,127,288,
9603,1944,136,98,234,
9604,2005,150,114,264,
9605,1964,162,117,279,
9606,1916,128,115,243,
9607,1935,133,93,226,
9608,2038,132,131,263,
9609,2027,154,107,261,
9610,1951,141,103,244,
9611,2011,160,113,273,
9612,1976,150,115,265,
9613,2011,161,140,301,
9614,1962,146,113,259,
9615,1910,151,110,261,
9616,1925,132,112,244,
9617,1970,141,109,250,
9618,2028,165,118,283,
9619,1988,124,114,238,
9620,1761,128,92,220,
9621,2026,168,111,279,
9622,2007,127,119,246,
9623,1931,134,102,236,
9624,1977,127,102,229,
9625,1982,151,111,262,
9626,1939,136,108,244,
9627,1978,136,107,243,
9628,1969,150,97,247,
9629,1921,135,113,248,
9630,2000,130,108,238,
9631,1981,151,113,264,
9632,1997,154,110,264,
9633,1966,137,108,245,
9634,1960,144,105,249,
9635,1977,135,114,249,
9636,1998,136,107,243,
9637,1956,127,105,232,
9638,2005,166,102,268,
9639,2000,147,108,255,
9640,2039,160,103,263,
9641,1930,149,85,234,
9642,1998,139,134,273,
9643,2020,146,111,257,
9644,1935,138,126,264,
9645,1919,135,114,249,
9646,1941,140,113,253,
9647,1918,155,100,255,
9648,1993,145,107,252,
9649,1937,146,109,255,
9650,1896,138,107,245,
9651,1967,139,109,248,
9652,2007,142,118,260,
9653,1982,173,124,297,
9654,1932,129,114,243,
9655,1952,143,101,244,
9656,1945,134,130,264,
9657,1906,144,113,257,
9658,1935,134,116,250,
9659,1919,149,105,254,
9660,2031,150,105,255,
9661,1931,130,105,235,
9662,1994,156,129,285,
9663,1950,133,115,248,
9664,1947,153,107,260,
9665,2050,154,124,278,
9666,2040,138,108,246,
9667,1918,127,120,247,
9668,1972,140,117,257,
9669,1989,151,127,278,
9670,1978,141,113,254,
9671,1937,135,106,241,
9672,1964,131,118,249,
9673,1999,134,104,238,
9674,2000,129,125,254,
9675,1943,136,116,252,
9676,1916,159,116,275,
9677,2007,148,112,260,
9678,1895,153,114,267,
9679,1939,145,108,253,
9680,1967,141,126,267,
9681,1893,150,121,271,
9682,2003,142,117,259,
9683,1976,155,119,274,
9684,2055,157,119,276,
9685,2035,141,100,241,
9686,2004,161,107,268,
9687,2050,147,107,254,
9688,1931,145,103,248,
9689,2037,137,121,258,
9690,1975,141,115,256,
9691,1882,131,126,257,
9692,2036,155,113,268,
9693,2027,167,139,306,
9694,1956,118,114,232,
9695,1941,130,98,228,
9696,1865,142,112,254,
9697,1943,135,114,249,
9698,1958,150,120,270,
9699,1968,149,111,260,
9700,2026,154,124,278,
9701,2003,150,86,236,
9702,1954,148,130,278,
9703,1959,127,126,253,
9704,1928,132,118,250,
9705,1895,131,102,233,
9706,2036,158,94,252,
9707,1946,153,108,261,
9708,2018,146,118,264,
9709,1813,139,97,236,
9710,1974,145,112,257,
9711,1965,134,98,232,
9712,2002,158,111,269,
9713,2000,150,114,264,
9714,2044,124,125,249,
9715,1932,144,88,232,
9716,1983,135,120,255,
9717,1929,147,105,252,
9718,1984,136,126,262,
9719,1972,125,148,273,
9720,1951,131,120,251,
9721,1993,148,109,257,
9722,2021,148,113,261,
9723,1931,142,107,249,
9724,1994,142,117,259,
9725,1978,147,105,252,
9726,1951,156,112,268,
9727,2011,168,110,278,
9728,1963,136,107,243,
9729,1978,149,132,281,
9730,1892,153,109,262,
9731,2010,147,130,277,
9732,2005,131,116,247,
9733,1999,141,106,247,
9734,1916,133,103,236,
9735,2033,153,125,278,
9736,1985,137,106,243,
9737,1893,130,102,232,
9738,1954,153,118,271,
9739,1994,149,105,254,
9740,2082,149,126,275,
9741,2041,122,122,244,
9742,1982,179,116,295,
9743,2017,150,129,279,
9744,1958,134,113,247,
9745,2046,139,129,268,
9746,1957,148,93,241,
9747,1971,138,102,240,
9748,1934,143,99,242,
9749,2010,131,110,241,
9750,2024,131,113,244,
9751,1967,156,117,273,
9752,2011,123,108,231,
9753,1928,132,111,243,
9754,2045,152,111,263,
9755,1903,135,109,244,
9756,2013,149,121,270,
9757,1924,157,128,285,
9758,1966,135,102,237,
9759,1999,127,119,246,
9760,2026,160,110,270,
9761,1969,133,123,256,
9762,1978,149,117,266,
9763,1931,152,106,258,
9764,1975,158,118,276,
9765,2006,142,118,260,
9766,1984,155,113,268,
9767,1915,134,105,239,
9768,1962,134,120,254,
9769,1970,137,123,260,
9770,1875,111,112,223,
9771,1992,149,116,265,
9772,2004,153,96,249,
9773,1977,127,107,234,
9774,1991,145,111,256,
9775,1991,140,87,227,
9776,1971,143,129,272,
9777,1931,154,114,268,
9778,1953,161,119,280,
9779,2016,142,120,262,
9780,1960,140,111,251,
9781,1945,145,100,245,
9782,1998,152,123,275,
9783,1981,122,112,234,
9784,1931,130,110,240,
9785,1890,129,117,246,
9786,2009,148,98,246,
9787,1967,151,95,246,
9788,2023,166,124,290,
9789,1927,149,113,262,
9790,1926,142,112,254,
9791,1942,142,123,265,
9792,2017,148,109,257,
9793,1890,169,100,269,
9794,1971,163,113,276,
9795,1919,136,104,240,
9796,1911,134,85,219,
9797,2050,145,113,258,
9798,1975,122,119,241,
9799,1951,137,116,253,
9800,2007,161,109,270,
9801,1959,138,121,259,
9802,1979,157,107,264,
9803,1983,132,89,221,
9804,1988,145,111,256,
9805,2023,141,116,257,
9806,1979,131,104,235,
9807,1998,145,130,275,
9808,1926,128,90,218,
9809,1959,148,119,267,
9810,1938,163,125,288,
9811,1998,166,113,279,
9812,2003,143,110,253,
9813,1899,140,123,263,
9814,2001,137,96,233,
9815,1929,155,119,274,
9816,1969,147,99,246,
9817,2002,135,118,253,
9818,1934,155,130,285,
9819,2056,141,114,255,
9820,1959,137,113,250,
9821,2044,168,127,295,
9822,1933,130,120,250,
9823,2013,129,106,235,
9824,1871,123,94,217,
9825,1998,150,120,270,
9826,1973,142,133,275,
9827,1986,140,106,246,
9828,1989,134,113,247,
9829,1911,133,106,239,
9830,2050,160,110,270,
9831,1993,133,114,247,
9832,2030,152,117,269,
9833,1902,147,119,266,
9834,2010,148,136,284,
9835,1963,150,111,261,
9836,1908,128,115,243,
9837,1952,124,108,232,
9838,1939,129,114,243,
9839,1994,158,103,261,
9840,2041,156,112,268,
9841,2041,146,112,258,
9842,1977,148,108,256,
9843,2033,159,110,269,
9844,1968,148,117,265,
9845,1948,137,104,241,
9846,1962,156,108,264,
9847,1961,147,108,255,
9848,2004,137,112,249,
9849,1959,141,93,234,
9850,1904,129,119,248,
9851,1863,140,101,241,
9852,1995,165,124,289,
9853,1947,142,139,281,
9854,1983,161,96,257,
9855,2023,139,128,267,
9856,1902,144,108,252,
9857,2003,147,117,264,
9858,2019,146,98,244,
9859,1995,169,116,285,
9860,1971,134,95,229,
9861,1931,158,128,286,
9862,2008,141,115,256,
9863,1971,147,108,255,
9864,2038,155,108,263,
9865,1974,131,109,240,
9866,1865,123,98,221,
9867,1992,175,105,280,
9868,1913,149,106,255,
9869,1925,144,129,273,
9870,1903,135,98,233,
9871,1958,140,101,241,
9872,1965,129,118,247,
9873,2004,157,108,265,
9874,1899,158,101,259,
9875,2030,143,136,279,
9876,1967,153,107,260,
9877,1927,166,97,263,
9878,1954,128,111,239,
9879,1852,123,112,235,
9880,1974,137,108,245,
9881,2005,142,117,259,
9882,1916,155,103,258,
9883,2005,133,101,234,
9884,2008,158,107,265,
9885,2093,170,117,287,
9886,1923,145,116,261,
9887,1919,165,107,272,
9888,2075,151,133,284,
9889,2030,149,127,276,
9890,1974,152,126,278,
9891,1971,105,116,221,
9892,1975,143,130,273,
9893,2019,135,92,227,
9894,1944,134,114,248,
9895,2039,143,124,267,
9896,1963,130,105,235,
9897,1965,158,121,279,
9898,1979,136,110,246,
9899,1954,150,116,266,
9900,1967,146,110,256,
9901,1981,139,127,266,
9902,1881,118,93,211,
9903,1956,144,128,272,
9904,1950,133,90,223,
9905,1941,125,106,231,
9906,1921,143,119,262,
9907,2033,157,128,285,
9908,1997,157,120,277,
9909,1878,134,110,244,
9910,1935,133,107,240,
9911,1975,138,109,247,
9912,1886,134,109,243,
9913,1932,148,114,262,
9914,1855,138,111,249,
9915,1941,163,109,272,
9916,1977,132,108,240,
9917,1963,167,113,280,
9918,1994,155,130,285,
9919,1966,147,99,246,
9920,1985,135,148,283,
9921,1978,173,114,287,
9922,1971,154,102,256,
9923,1992,143,108,251,
9924,1949,150,124,274,
9925,1950,149,102,251,
9926,2000,134,129,263,
9927,1984,154,109,263,
9928,1954,121,119,240,
9929,1938,117,121,238,
9930,2014,147,122,269,
9931,1975,126,120,246,
9932,2030,164,136,300,
9933,1940,121,103,224,
9934,1988,145,120,265,
9935,2027,153,117,270,
9936,1998,129,105,234,
9937,1963,168,108,276,
9938,1984,137,129,266,
9939,1905,153,115,268,
9940,1960,127,114,241,
9941,1979,161,110,271,
9942,2014,165,114,279,
9943,1986,132,107,239,
9944,1970,142,114,256,
9945,1927,144,106,250,
9946,1959,139,135,274,
9947,2011,148,111,259,
9948,1967,120,114,234,
9949,2013,139,103,242,
9950,1962,137,96,233,
9951,1934,143,109,252,
9952,1928,127,123,250,
9953,1972,161,118,279,
9954,2015,155,121,276,
9955,1968,149,108,257,
9956,2009,168,109,277,
9957,1995,156,102,258,
9958,1900,141,119,260,
9959,1968,158,105,263,
9960,1910,129,127,256,
9961,1932,155,114,269,
9962,2000,147,120,267,
9963,2003,140,109,249,
9964,2001,128,104,232,
9965,1952,142,104,246,
9966,2031,150,112,262,
9967,2005,159,109,268,
9968,2006,141,123,264,
9969,1977,146,117,263,
9970,1972,153,110,263,
9971,1914,139,90,229,
9972,1996,158,121,279,
9973,1945,140,124,264,
9974,2150,156,121,277,
9975,1897,124,113,237,
9976,1881,145,96,241,
9977,2004,154,128,282,
9978,2020,152,111,263,
9979,1911,169,98,267,
9980,1910,163,98,261,
9981,2018,151,121,272,
9982,2007,146,100,246,
9983,1946,150,107,257,
9984,1980,134,115,249,
9985,1981,148,154,302,
9986,1951,132,126,258,
9987,1958,152,118,270,
9988,1954,141,124,265,
9989,1932,147,105,252,
9990,1951,144,120,264,
9991,2035,151,105,256,
9992,1976,149,125,274,
9993,1898,129,99,228,
9994,1980,129,106,235,
9995,2049,148,106,254,
9996,1960,128,116,244,
9997,1894,135,101,236,
9998,1933,162,122,284,
9999,1939,155,125,280,
