eventID,numPhotons,numReachedDown,numReachedUp,numPE,
0,598,54,25,79,
1,658,52,36,88,
2,612,54,41,95,
3,623,51,31,82,
4,602,50,21,71,
5,595,41,35,76,
6,661,41,42,83,
7,639,43,48,91,
8,582,43,26,69,
9,622,52,40,92,
10,653,54,32,86,
11,624,54,43,97,
12,612,40,35,75,
13,638,30,40,70,
14,625,42,35,77,
15,620,37,32,69,
16,619,42,36,78,
17,607,34,33,67,
18,583,47,37,84,
19,602,56,29,85,
20,628,41,36,77,
21,571,43,27,70,
22,557,34,34,68,
23,634,54,21,75,
24,610,46,32,78,
25,579,38,39,77,
26,638,43,29,72,
27,614,46,28,74,
28,630,53,28,81,
29,673,50,42,92,
30,589,32,28,60,
31,591,37,35,72,
32,668,46,34,80,
33,629,50,35,85,
34,634,34,39,73,
35,592,45,28,73,
36,584,51,35,86,
37,584,39,30,69,
38,651,38,34,72,
39,624,41,38,79,
40,644,33,33,66,
41,596,38,26,64,
42,601,38,33,71,
43,595,44,28,72,
44,624,46,37,83,
45,639,56,28,84,
46,594,58,35,93,
47,646,45,37,82,
48,605,41,32,73,
49,659,40,52,92,
50,660,50,39,89,
51,615,51,38,89,
52,667,43,35,78,
53,659,55,40,95,
54,609,49,35,84,
55,612,41,30,71,
56,616,38,31,69,
57,586,53,37,90,
58,598,43,37,80,
59,618,50,37,87,
60,661,53,31,84,
61,648,47,32,79,
62,591,46,28,74,
63,584,45,33,78,
64,623,44,32,76,
65,604,37,28,65,
66,636,39,36,75,
67,623,38,42,80,
68,607,53,35,88,
69,648,52,30,82,
70,584,41,40,81,
71,569,49,30,79,
72,583,36,37,73,
73,591,43,31,74,
74,615,49,36,85,
75,602,48,37,85,
76,580,48,29,77,
77,575,57,24,81,
78,605,38,28,66,
79,601,50,47,97,
80,611,47,28,75,
81,629,46,35,81,
82,633,39,34,73,
83,620,51,31,82,
84,634,49,28,77,
85,615,38,31,69,
86,611,52,34,86,
87,644,50,39,89,
88,593,41,35,76,
89,626,52,37,89,
90,612,52,35,87,
91,672,43,38,81,
92,615,44,33,77,
93,587,36,30,66,
94,609,34,30,64,
95,593,47,33,80,
96,658,51,41,92,
97,623,46,34,80,
98,587,45,45,90,
99,617,47,38,85,
100,607,45,43,88,
101,572,34,31,65,
102,591,46,47,93,
103,648,31,40,71,
104,595,27,25,52,
105,624,51,49,100,
106,628,52,35,87,
107,670,45,36,81,
108,577,37,33,70,
109,638,42,44,86,
110,661,55,28,83,
111,566,44,34,78,
112,622,53,30,83,
113,626,43,35,78,
114,607,39,37,76,
115,649,45,40,85,
116,646,43,30,73,
117,614,57,33,90,
118,620,45,26,71,
119,635,58,30,88,
120,618,40,31,71,
121,635,55,35,90,
122,650,56,44,100,
123,633,53,26,79,
124,561,39,34,73,
125,680,51,44,95,
126,656,39,47,86,
127,619,52,32,84,
128,661,62,45,107,
129,618,44,39,83,
130,632,43,34,77,
131,581,57,41,98,
132,608,33,35,68,
133,616,40,45,85,
134,638,48,42,90,
135,678,52,39,91,
136,601,46,33,79,
137,609,42,37,79,
138,594,36,35,71,
139,590,32,29,61,
140,655,54,37,91,
141,570,43,37,80,
142,643,50,41,91,
143,576,41,37,78,
144,643,44,37,81,
145,595,69,35,104,
146,617,36,38,74,
147,563,49,27,76,
148,601,45,37,82,
149,637,47,39,86,
150,595,30,31,61,
151,687,47,29,76,
152,599,38,37,75,
153,665,45,36,81,
154,688,52,36,88,
155,586,39,33,72,
156,603,43,33,76,
157,634,56,37,93,
158,588,37,37,74,
159,594,29,30,59,
160,629,44,39,83,
161,596,53,40,93,
162,609,47,35,82,
163,643,52,34,86,
164,605,54,35,89,
165,653,37,45,82,
166,657,51,36,87,
167,634,43,29,72,
168,572,48,35,83,
169,587,49,32,81,
170,645,50,36,86,
171,614,50,33,83,
172,698,54,37,91,
173,641,44,30,74,
174,595,40,37,77,
175,643,54,31,85,
176,579,44,27,71,
177,621,44,36,80,
178,600,34,38,72,
179,621,47,40,87,
180,604,52,29,81,
181,638,43,30,73,
182,591,37,38,75,
183,618,46,29,75,
184,622,42,36,78,
185,580,42,36,78,
186,618,41,36,77,
187,636,45,33,78,
188,615,49,36,85,
189,636,51,33,84,
190,645,56,39,95,
191,626,48,33,81,
192,600,41,37,78,
193,629,40,31,71,
194,660,50,35,85,
195,612,35,42,77,
196,630,56,37,93,
197,637,52,39,91,
198,624,44,42,86,
199,624,57,34,91,
200,632,50,34,84,
201,626,44,41,85,
202,635,34,33,67,
203,634,48,31,79,
204,600,39,26,65,
205,597,46,32,78,
206,614,44,38,82,
207,611,36,40,76,
208,631,50,33,83,
209,673,47,28,75,
210,600,52,38,90,
211,595,33,43,76,
212,631,51,34,85,
213,604,47,30,77,
214,675,54,30,84,
215,596,39,33,72,
216,584,33,35,68,
217,620,42,30,72,
218,646,34,33,67,
219,607,50,26,76,
220,634,45,29,74,
221,606,59,36,95,
222,656,62,31,93,
223,584,37,34,71,
224,584,40,36,76,
225,590,38,30,68,
226,608,41,37,78,
227,599,44,53,97,
228,678,55,43,98,
229,602,42,37,79,
230,591,39,41,80,
231,626,40,28,68,
232,629,61,33,94,
233,637,55,41,96,
234,638,49,33,82,
235,599,55,29,84,
236,648,59,39,98,
237,626,50,34,84,
238,649,36,48,84,
239,660,57,35,92,
240,623,53,40,93,
241,656,44,42,86,
242,625,40,40,80,
243,627,41,32,73,
244,593,35,39,74,
245,592,36,47,83,
246,603,51,27,78,
247,627,47,43,90,
248,613,42,36,78,
249,609,64,38,102,
250,609,49,26,75,
251,646,52,34,86,
252,598,54,27,81,
253,618,44,42,86,
254,618,54,31,85,
255,616,46,39,85,
256,640,48,37,85,
257,592,45,36,81,
258,634,44,38,82,
259,626,47,36,83,
260,639,41,33,74,
261,625,51,35,86,
262,616,35,45,80,
263,589,39,39,78,
264,662,45,48,93,
265,636,48,37,85,
266,632,41,36,77,
267,660,57,38,95,
268,613,38,44,82,
269,609,42,30,72,
270,589,39,28,67,
271,578,41,23,64,
272,631,45,34,79,
273,615,43,29,72,
274,603,47,27,74,
275,609,43,36,79,
276,624,43,36,79,
277,613,53,35,88,
278,595,49,37,86,
279,650,32,33,65,
280,656,53,38,91,
281,687,46,38,84,
282,645,40,38,78,
283,617,41,46,87,
284,638,64,29,93,
285,615,41,34,75,
286,636,43,45,88,
287,595,46,39,85,
288,610,51,35,86,
289,606,52,25,77,
290,584,40,30,70,
291,579,43,28,71,
292,609,43,32,75,
293,631,45,34,79,
294,597,49,29,78,
295,595,32,35,67,
296,668,35,26,61,
297,606,37,42,79,
298,643,56,36,92,
299,608,56,33,89,
300,605,52,31,83,
301,659,54,40,94,
302,616,46,36,82,
303,577,36,28,64,
304,584,40,29,69,
305,638,48,25,73,
306,646,44,45,89,
307,647,64,40,104,
308,626,42,47,89,
309,639,38,34,72,
310,610,39,36,75,
311,622,45,47,92,
312,617,45,38,83,
313,604,39,36,75,
314,602,43,35,78,
315,608,54,37,91,
316,574,36,34,70,
317,613,55,33,88,
318,657,45,42,87,
319,585,42,41,83,
320,612,50,29,79,
321,605,43,37,80,
322,624,44,44,88,
323,603,44,47,91,
324,634,44,40,84,
325,582,33,30,63,
326,600,44,40,84,
327,624,48,42,90,
328,641,45,34,79,
329,601,42,44,86,
330,648,36,49,85,
331,596,45,26,71,
332,579,45,33,78,
333,635,57,43,100,
334,593,40,40,80,
335,586,47,33,80,
336,582,47,36,83,
337,628,63,39,102,
338,605,41,26,67,
339,620,39,42,81,
340,585,49,35,84,
341,646,38,30,68,
342,672,59,41,100,
343,626,50,38,88,
344,634,36,38,74,
345,633,54,44,98,
346,640,49,39,88,
347,636,36,34,70,
348,660,41,34,75,
349,608,51,30,81,
350,614,39,37,76,
351,617,43,32,75,
352,637,47,29,76,
353,568,41,31,72,
354,668,45,39,84,
355,621,46,28,74,
356,645,43,35,78,
357,568,42,31,73,
358,644,43,42,85,
359,591,35,31,66,
360,644,44,36,80,
361,628,48,32,80,
362,618,37,39,76,
363,626,44,34,78,
364,595,30,28,58,
365,684,62,30,92,
366,625,43,36,79,
367,619,52,22,74,
368,628,49,35,84,
369,597,47,44,91,
370,566,36,39,75,
371,589,33,28,61,
372,560,39,30,69,
373,597,41,36,77,
374,657,45,30,75,
375,660,59,40,99,
376,646,30,34,64,
377,631,43,28,71,
378,626,57,37,94,
379,655,47,42,89,
380,599,41,35,76,
381,611,43,38,81,
382,608,47,38,85,
383,645,35,31,66,
384,613,38,45,83,
385,599,35,32,67,
386,589,39,38,77,
387,619,41,36,77,
388,577,44,32,76,
389,644,51,33,84,
390,591,35,41,76,
391,628,55,22,77,
392,614,47,43,90,
393,600,41,36,77,
394,603,37,43,80,
395,636,55,32,87,
396,606,28,36,64,
397,660,45,39,84,
398,590,45,40,85,
399,643,50,49,99,
400,622,43,30,73,
401,601,36,32,68,
402,621,38,35,73,
403,621,46,28,74,
404,654,30,35,65,
405,627,46,38,84,
406,648,49,33,82,
407,617,37,35,72,
408,641,59,30,89,
409,593,49,32,81,
410,649,42,38,80,
411,575,42,38,80,
412,605,35,36,71,
413,607,40,35,75,
414,625,41,46,87,
415,643,50,38,88,
416,613,52,37,89,
417,613,47,40,87,
418,613,43,43,86,
419,627,48,31,79,
420,607,51,36,87,
421,627,55,37,92,
422,639,43,39,82,
423,641,47,31,78,
424,612,47,32,79,
425,617,42,28,70,
426,633,31,30,61,
427,602,51,32,83,
428,615,45,36,81,
429,664,48,28,76,
430,626,40,39,79,
431,638,50,37,87,
432,585,30,28,58,
433,628,45,44,89,
434,563,51,41,92,
435,623,48,39,87,
436,631,46,41,87,
437,601,37,38,75,
438,592,45,32,77,
439,650,71,31,102,
440,621,45,42,87,
441,630,66,40,106,
442,596,51,38,89,
443,597,41,28,69,
444,665,56,46,102,
445,600,43,42,85,
446,639,53,37,90,
447,579,43,29,72,
448,635,44,37,81,
449,589,33,34,67,
450,591,46,28,74,
451,616,36,35,71,
452,597,37,33,70,
453,599,40,38,78,
454,621,43,25,68,
455,647,42,41,83,
456,613,34,45,79,
457,596,35,23,58,
458,618,41,31,72,
459,656,48,39,87,
460,653,44,29,73,
461,609,40,38,78,
462,700,68,28,96,
463,624,39,33,72,
464,589,37,40,77,
465,623,43,44,87,
466,610,40,43,83,
467,655,66,28,94,
468,615,47,33,80,
469,580,43,40,83,
470,693,48,44,92,
471,589,47,32,79,
472,617,39,27,66,
473,631,50,36,86,
474,651,49,35,84,
475,643,36,49,85,
476,595,46,36,82,
477,617,52,31,83,
478,633,37,31,68,
479,640,52,35,87,
480,649,43,30,73,
481,623,47,37,84,
482,587,41,30,71,
483,611,53,29,82,
484,600,33,24,57,
485,616,44,34,78,
486,582,44,41,85,
487,586,49,31,80,
488,651,48,37,85,
489,676,53,35,88,
490,610,58,39,97,
491,613,54,41,95,
492,604,50,39,89,
493,624,56,27,83,
494,589,46,28,74,
495,621,49,30,79,
496,608,51,32,83,
497,568,54,29,83,
498,638,41,35,76,
499,609,33,33,66,
500,601,36,30,66,
501,589,46,36,82,
502,675,51,35,86,
503,630,47,30,77,
504,620,48,50,98,
505,645,48,37,85,
506,585,43,44,87,
507,630,33,41,74,
508,637,47,37,84,
509,586,47,35,82,
510,576,36,46,82,
511,656,47,46,93,
512,614,36,25,61,
513,628,46,35,81,
514,604,48,33,81,
515,628,48,39,87,
516,589,44,38,82,
517,643,51,42,93,
518,625,40,30,70,
519,611,42,35,77,
520,626,53,34,87,
521,605,39,28,67,
522,593,49,24,73,
523,607,47,37,84,
524,655,38,36,74,
525,645,48,30,78,
526,615,53,32,85,
527,648,47,41,88,
528,614,46,35,81,
529,600,42,31,73,
530,583,37,26,63,
531,615,43,28,71,
532,627,45,30,75,
533,608,35,36,71,
534,633,46,38,84,
535,666,52,49,101,
536,624,43,39,82,
537,631,48,42,90,
538,599,44,35,79,
539,656,49,41,90,
540,664,46,44,90,
541,602,46,29,75,
542,570,29,22,51,
543,690,69,44,113,
544,640,33,27,60,
545,612,41,32,73,
546,602,46,20,66,
547,605,33,35,68,
548,618,48,38,86,
549,598,47,39,86,
550,621,51,38,89,
551,627,42,29,71,
552,612,47,32,79,
553,580,26,27,53,
554,641,35,32,67,
555,571,32,34,66,
556,575,33,33,66,
557,639,48,38,86,
558,616,36,39,75,
559,611,54,31,85,
560,665,50,47,97,
561,632,43,54,97,
562,585,44,31,75,
563,607,49,32,81,
564,610,34,34,68,
565,611,41,33,74,
566,679,56,38,94,
567,615,48,34,82,
568,622,46,47,93,
569,642,43,46,89,
570,602,35,45,80,
571,658,53,34,87,
572,604,42,38,80,
573,584,32,32,64,
574,594,40,43,83,
575,583,33,35,68,
576,596,37,35,72,
577,646,49,42,91,
578,582,25,26,51,
579,616,37,28,65,
580,613,43,33,76,
581,652,40,30,70,
582,655,38,49,87,
583,658,43,38,81,
584,618,47,36,83,
585,618,39,41,80,
586,611,55,34,89,
587,645,48,32,80,
588,595,51,35,86,
589,618,44,30,74,
590,604,44,38,82,
591,587,33,38,71,
592,630,45,26,71,
593,605,44,33,77,
594,622,34,31,65,
595,631,38,45,83,
596,572,37,38,75,
597,614,43,42,85,
598,619,54,29,83,
599,571,42,25,67,
600,650,53,41,94,
601,610,42,44,86,
602,591,43,37,80,
603,606,47,33,80,
604,607,43,33,76,
605,629,36,35,71,
606,627,49,39,88,
607,595,45,37,82,
608,585,53,28,81,
609,622,44,43,87,
610,613,45,41,86,
611,618,43,31,74,
612,651,44,31,75,
613,599,37,31,68,
614,587,45,24,69,
615,657,51,28,79,
616,552,33,36,69,
617,571,41,36,77,
618,637,56,30,86,
619,647,58,34,92,
620,656,41,46,87,
621,565,35,29,64,
622,618,42,28,70,
623,629,55,30,85,
624,593,43,31,74,
625,636,48,36,84,
626,587,39,31,70,
627,649,47,37,84,
628,614,55,34,89,
629,599,48,26,74,
630,603,42,29,71,
631,645,68,35,103,
632,565,50,37,87,
633,618,41,36,77,
634,604,40,37,77,
635,613,46,27,73,
636,619,45,39,84,
637,606,42,30,72,
638,654,50,33,83,
639,572,41,32,73,
640,608,46,30,76,
641,607,42,41,83,
642,635,37,38,75,
643,648,50,23,73,
644,636,34,43,77,
645,644,39,34,73,
646,622,55,31,86,
647,637,55,42,97,
648,642,55,37,92,
649,666,44,40,84,
650,633,36,36,72,
651,647,54,32,86,
652,617,40,21,61,
653,609,40,30,70,
654,625,51,44,95,
655,658,51,30,81,
656,606,46,33,79,
657,639,53,48,101,
658,627,41,35,76,
659,553,36,23,59,
660,659,34,42,76,
661,640,48,47,95,
662,669,47,33,80,
663,597,43,41,84,
664,610,45,32,77,
665,634,48,35,83,
666,603,44,41,85,
667,671,55,42,97,
668,628,36,46,82,
669,612,47,32,79,
670,619,37,26,63,
671,664,64,38,102,
672,595,45,35,80,
673,618,54,23,77,
674,628,40,25,65,
675,628,38,26,64,
676,625,48,35,83,
677,601,40,31,71,
678,587,41,52,93,
679,614,47,33,80,
680,621,46,29,75,
681,667,37,42,79,
682,678,54,32,86,
683,657,43,40,83,
684,611,34,39,73,
685,673,50,41,91,
686,667,51,36,87,
687,570,36,29,65,
688,642,49,38,87,
689,630,49,42,91,
690,649,42,45,87,
691,638,41,37,78,
692,573,34,28,62,
693,631,41,48,89,
694,629,48,35,83,
695,599,57,24,81,
696,612,40,27,67,
697,641,44,39,83,
698,625,42,28,70,
699,592,49,33,82,
700,608,36,28,64,
701,625,46,29,75,
702,641,50,39,89,
703,618,52,29,81,
704,585,42,27,69,
705,605,42,33,75,
706,615,53,29,82,
707,603,42,42,84,
708,639,54,38,92,
709,677,47,37,84,
710,656,52,50,102,
711,595,40,30,70,
712,613,51,26,77,
713,622,38,26,64,
714,608,46,37,83,
715,613,37,37,74,
716,607,50,33,83,
717,657,38,35,73,
718,602,45,32,77,
719,605,43,35,78,
720,610,48,28,76,
721,580,42,36,78,
722,635,61,32,93,
723,591,47,29,76,
724,653,42,33,75,
725,626,51,28,79,
726,606,40,35,75,
727,590,45,32,77,
728,619,41,39,80,
729,575,39,36,75,
730,638,51,46,97,
731,648,48,34,82,
732,631,35,43,78,
733,629,46,30,76,
734,656,38,42,80,
735,661,51,26,77,
736,591,35,37,72,
737,607,45,37,82,
738,633,36,40,76,
739,653,61,43,104,
740,646,48,32,80,
741,612,37,39,76,
742,617,44,42,86,
743,652,38,31,69,
744,604,36,33,69,
745,593,40,35,75,
746,619,50,37,87,
747,574,40,34,74,
748,628,47,30,77,
749,596,37,38,75,
750,671,39,37,76,
751,628,49,36,85,
752,659,48,42,90,
753,624,52,32,84,
754,658,60,35,95,
755,591,34,25,59,
756,638,50,40,90,
757,581,45,37,82,
758,585,45,36,81,
759,615,38,50,88,
760,619,35,32,67,
761,631,39,39,78,
762,669,50,48,98,
763,614,36,31,67,
764,570,33,25,58,
765,623,40,37,77,
766,603,35,33,68,
767,632,47,47,94,
768,606,44,21,65,
769,628,38,26,64,
770,596,45,30,75,
771,624,59,30,89,
772,575,43,33,76,
773,596,35,41,76,
774,635,57,36,93,
775,607,46,31,77,
776,607,35,31,66,
777,603,44,34,78,
778,651,48,44,92,
779,658,52,33,85,
780,660,53,28,81,
781,679,54,46,100,
782,651,43,33,76,
783,625,47,39,86,
784,613,47,33,80,
785,574,40,38,78,
786,626,49,48,97,
787,581,45,24,69,
788,588,46,28,74,
789,604,38,36,74,
790,619,43,31,74,
791,584,55,45,100,
792,609,43,44,87,
793,652,61,42,103,
794,599,44,34,78,
795,603,53,32,85,
796,644,37,31,68,
797,639,37,35,72,
798,603,48,34,82,
799,596,49,30,79,
800,647,53,35,88,
801,645,49,45,94,
802,557,30,30,60,
803,653,51,31,82,
804,648,53,41,94,
805,602,38,29,67,
806,649,51,40,91,
807,624,49,40,89,
808,588,32,36,68,
809,649,52,34,86,
810,653,53,26,79,
811,563,45,31,76,
812,625,37,44,81,
813,598,40,24,64,
814,623,37,46,83,
815,603,52,31,83,
816,600,62,41,103,
817,656,52,33,85,
818,649,43,29,72,
819,646,49,40,89,
820,621,41,43,84,
821,656,41,41,82,
822,586,26,33,59,
823,576,44,30,74,
824,647,39,29,68,
825,626,38,36,74,
826,643,46,37,83,
827,641,46,37,83,
828,641,31,29,60,
829,588,45,32,77,
830,615,42,32,74,
831,631,42,41,83,
832,617,47,36,83,
833,610,52,29,81,
834,622,43,30,73,
835,594,46,43,89,
836,645,42,35,77,
837,634,36,38,74,
838,643,56,36,92,
839,627,46,38,84,
840,585,45,38,83,
841,544,43,26,69,
842,582,49,37,86,
843,626,50,30,80,
844,561,29,32,61,
845,651,54,36,90,
846,589,48,25,73,
847,612,48,30,78,
848,656,62,43,105,
849,572,41,34,75,
850,609,58,33,91,
851,682,59,37,96,
852,629,43,22,65,
853,616,46,33,79,
854,620,47,27,74,
855,607,34,39,73,
856,624,50,29,79,
857,628,43,30,73,
858,586,37,31,68,
859,637,37,36,73,
860,676,53,42,95,
861,642,60,28,88,
862,587,44,32,76,
863,602,39,41,80,
864,639,48,38,86,
865,601,47,35,82,
866,689,39,36,75,
867,632,47,33,80,
868,595,41,27,68,
869,651,51,41,92,
870,640,51,39,90,
871,634,23,41,64,
872,611,41,27,68,
873,589,40,40,80,
874,636,40,30,70,
875,632,57,46,103,
876,591,54,35,89,
877,590,42,34,76,
878,637,44,24,68,
879,616,38,25,63,
880,629,41,43,84,
881,675,54,34,88,
882,575,41,33,74,
883,630,55,32,87,
884,617,30,34,64,
885,652,53,31,84,
886,606,48,33,81,
887,634,47,36,83,
888,635,45,31,76,
889,682,50,26,76,
890,647,47,30,77,
891,593,45,33,78,
892,667,58,45,103,
893,647,46,43,89,
894,626,50,36,86,
895,581,36,30,66,
896,634,57,31,88,
897,607,52,43,95,
898,645,40,47,87,
899,608,38,39,77,
900,658,49,40,89,
901,621,48,38,86,
902,635,49,31,80,
903,609,35,28,63,
904,633,49,40,89,
905,628,36,28,64,
906,636,50,44,94,
907,604,43,29,72,
908,653,46,37,83,
909,620,35,38,73,
910,643,54,27,81,
911,612,57,21,78,
912,652,47,42,89,
913,653,52,25,77,
914,617,45,38,83,
915,620,40,25,65,
916,595,46,39,85,
917,654,40,48,88,
918,636,52,43,95,
919,591,39,28,67,
920,608,41,33,74,
921,664,50,31,81,
922,633,46,44,90,
923,674,53,38,91,
924,652,56,30,86,
925,614,44,35,79,
926,644,44,38,82,
927,635,53,41,94,
928,632,37,37,74,
929,707,54,38,92,
930,636,41,36,77,
931,591,40,37,77,
932,614,40,36,76,
933,602,49,38,87,
934,595,53,32,85,
935,581,38,26,64,
936,601,41,39,80,
937,560,42,24,66,
938,596,45,39,84,
939,610,37,33,70,
940,602,49,38,87,
941,625,53,38,91,
942,618,45,37,82,
943,601,50,42,92,
944,662,59,35,94,
945,614,47,51,98,
946,680,46,37,83,
947,593,48,23,71,
948,610,48,36,84,
949,607,50,30,80,
950,633,36,26,62,
951,615,49,36,85,
952,572,50,38,88,
953,620,47,36,83,
954,609,47,41,88,
955,649,35,30,65,
956,595,43,34,77,
957,637,58,28,86,
958,638,46,34,80,
959,613,38,33,71,
960,624,42,50,92,
961,622,43,33,76,
962,623,48,41,89,
963,608,45,34,79,
964,606,37,50,87,
965,613,34,47,81,
966,604,36,27,63,
967,605,40,32,72,
968,613,49,28,77,
969,608,49,39,88,
970,668,40,47,87,
971,605,45,29,74,
972,596,30,35,65,
973,598,41,29,70,
974,602,45,31,76,
975,596,45,23,68,
976,631,48,39,87,
977,630,43,32,75,
978,645,41,32,73,
979,650,40,41,81,
980,635,45,38,83,
981,625,55,22,77,
982,605,40,30,70,
983,630,49,34,83,
984,602,49,35,84,
985,650,40,42,82,
986,620,37,31,68,
987,623,52,33,85,
988,618,57,32,89,
989,651,46,31,77,
990,578,37,26,63,
991,642,55,39,94,
992,596,52,42,94,
993,618,37,30,67,
994,608,38,29,67,
995,615,43,31,74,
996,630,41,36,77,
997,624,56,42,98,
998,659,52,43,95,
999,614,36,33,69,
1000,591,53,34,87,
1001,644,43,32,75,
1002,667,50,31,81,
1003,695,44,36,80,
1004,632,43,39,82,
1005,650,43,38,81,
1006,586,54,33,87,
1007,641,42,31,73,
1008,651,55,46,101,
1009,601,53,30,83,
1010,633,43,32,75,
1011,615,48,36,84,
1012,598,49,39,88,
1013,620,44,39,83,
1014,646,45,39,84,
1015,587,47,29,76,
1016,636,36,36,72,
1017,603,60,35,95,
1018,634,44,40,84,
1019,616,42,35,77,
1020,643,46,34,80,
1021,610,47,31,78,
1022,608,56,31,87,
1023,574,42,30,72,
1024,609,48,28,76,
1025,661,50,50,100,
1026,607,41,31,72,
1027,619,50,28,78,
1028,633,60,29,89,
1029,625,42,39,81,
1030,640,41,30,71,
1031,649,50,34,84,
1032,613,40,33,73,
1033,633,45,34,79,
1034,597,49,31,80,
1035,590,42,32,74,
1036,658,48,38,86,
1037,623,48,32,80,
1038,635,39,43,82,
1039,638,36,37,73,
1040,626,57,42,99,
1041,656,43,48,91,
1042,611,46,29,75,
1043,621,45,36,81,
1044,617,43,41,84,
1045,628,45,29,74,
1046,624,34,45,79,
1047,603,45,35,80,
1048,619,42,37,79,
1049,638,55,39,94,
1050,605,27,34,61,
1051,572,31,33,64,
1052,621,39,37,76,
1053,608,34,29,63,
1054,622,47,45,92,
1055,609,31,30,61,
1056,630,42,31,73,
1057,580,34,26,60,
1058,622,43,39,82,
1059,614,50,36,86,
1060,643,39,40,79,
1061,665,37,44,81,
1062,623,48,33,81,
1063,641,54,38,92,
1064,596,38,41,79,
1065,630,44,30,74,
1066,599,50,35,85,
1067,587,45,41,86,
1068,608,64,34,98,
1069,630,51,34,85,
1070,620,37,43,80,
1071,580,40,27,67,
1072,632,58,35,93,
1073,588,51,28,79,
1074,629,41,43,84,
1075,582,44,30,74,
1076,592,43,33,76,
1077,579,41,40,81,
1078,595,44,27,71,
1079,610,40,38,78,
1080,577,39,35,74,
1081,609,50,36,86,
1082,589,42,35,77,
1083,592,38,31,69,
1084,626,42,33,75,
1085,590,43,38,81,
1086,646,47,33,80,
1087,645,45,39,84,
1088,624,39,34,73,
1089,616,39,39,78,
1090,610,38,38,76,
1091,646,47,40,87,
1092,612,42,41,83,
1093,622,43,37,80,
1094,619,51,48,99,
1095,600,31,35,66,
1096,659,47,44,91,
1097,555,38,36,74,
1098,638,53,42,95,
1099,633,54,33,87,
1100,591,46,48,94,
1101,613,37,34,71,
1102,615,47,40,87,
1103,665,46,47,93,
1104,631,41,34,75,
1105,610,43,45,88,
1106,655,48,30,78,
1107,608,41,32,73,
1108,623,57,37,94,
1109,595,40,36,76,
1110,622,40,39,79,
1111,613,37,32,69,
1112,602,48,45,93,
1113,655,57,24,81,
1114,626,45,30,75,
1115,618,34,36,70,
1116,587,44,31,75,
1117,654,40,42,82,
1118,639,40,31,71,
1119,622,43,39,82,
1120,659,37,44,81,
1121,648,44,36,80,
1122,650,52,30,82,
1123,591,35,39,74,
1124,639,43,42,85,
1125,611,56,29,85,
1126,677,40,40,80,
1127,624,42,38,80,
1128,599,43,25,68,
1129,616,57,39,96,
1130,609,45,29,74,
1131,645,43,37,80,
1132,605,48,24,72,
1133,631,39,39,78,
1134,627,46,36,82,
1135,613,44,36,80,
1136,620,45,36,81,
1137,617,37,29,66,
1138,631,46,25,71,
1139,601,36,30,66,
1140,606,39,35,74,
1141,638,52,38,90,
1142,644,52,39,91,
1143,656,57,38,95,
1144,627,62,27,89,
1145,592,49,32,81,
1146,613,41,27,68,
1147,634,30,39,69,
1148,607,49,39,88,
1149,607,46,43,89,
1150,633,47,37,84,
1151,629,48,45,93,
1152,622,39,37,76,
1153,570,42,38,80,
1154,589,52,25,77,
1155,616,38,41,79,
1156,625,57,33,90,
1157,616,51,27,78,
1158,659,44,34,78,
1159,664,46,33,79,
1160,642,54,30,84,
1161,593,38,33,71,
1162,603,46,28,74,
1163,589,47,39,86,
1164,596,44,36,80,
1165,614,43,26,69,
1166,639,54,39,93,
1167,630,37,33,70,
1168,622,30,34,64,
1169,590,59,33,92,
1170,619,35,32,67,
1171,606,51,32,83,
1172,586,46,42,88,
1173,563,32,31,63,
1174,612,36,38,74,
1175,601,41,21,62,
1176,629,52,36,88,
1177,613,56,39,95,
1178,614,52,34,86,
1179,604,42,43,85,
1180,561,32,35,67,
1181,656,43,34,77,
1182,643,35,41,76,
1183,619,49,25,74,
1184,627,58,45,103,
1185,663,45,46,91,
1186,664,67,49,116,
1187,618,48,37,85,
1188,597,47,33,80,
1189,564,46,31,77,
1190,632,40,42,82,
1191,628,53,39,92,
1192,621,39,43,82,
1193,634,41,44,85,
1194,592,39,32,71,
1195,608,48,31,79,
1196,623,59,36,95,
1197,649,49,31,80,
1198,607,45,43,88,
1199,619,33,39,72,
1200,627,44,36,80,
1201,637,47,35,82,
1202,600,40,36,76,
1203,621,35,39,74,
1204,603,41,36,77,
1205,637,51,32,83,
1206,622,42,38,80,
1207,618,44,32,76,
1208,617,42,30,72,
1209,648,34,49,83,
1210,655,50,34,84,
1211,627,59,30,89,
1212,547,47,23,70,
1213,656,38,39,77,
1214,636,62,27,89,
1215,642,42,34,76,
1216,656,45,51,96,
1217,608,33,29,62,
1218,602,37,31,68,
1219,585,37,40,77,
1220,621,43,36,79,
1221,639,43,41,84,
1222,656,43,34,77,
1223,617,41,35,76,
1224,620,53,32,85,
1225,642,46,31,77,
1226,678,48,44,92,
1227,614,46,34,80,
1228,614,42,45,87,
1229,599,40,32,72,
1230,632,50,39,89,
1231,622,42,31,73,
1232,592,38,37,75,
1233,624,58,35,93,
1234,621,49,40,89,
1235,627,44,37,81,
1236,605,34,39,73,
1237,636,38,38,76,
1238,617,43,40,83,
1239,581,37,44,81,
1240,592,56,37,93,
1241,611,39,39,78,
1242,580,42,27,69,
1243,613,52,36,88,
1244,639,51,34,85,
1245,574,49,34,83,
1246,654,53,39,92,
1247,626,39,38,77,
1248,660,53,48,101,
1249,605,32,40,72,
1250,605,36,38,74,
1251,606,58,36,94,
1252,592,40,20,60,
1253,599,42,30,72,
1254,631,58,30,88,
1255,532,28,31,59,
1256,570,45,35,80,
1257,663,43,31,74,
1258,679,47,48,95,
1259,601,47,29,76,
1260,606,67,33,100,
1261,546,58,29,87,
1262,610,36,35,71,
1263,591,55,31,86,
1264,634,42,46,88,
1265,595,49,37,86,
1266,593,49,41,90,
1267,602,42,39,81,
1268,655,58,40,98,
1269,638,47,38,85,
1270,599,40,34,74,
1271,667,67,34,101,
1272,596,40,38,78,
1273,610,61,34,95,
1274,643,45,34,79,
1275,580,38,23,61,
1276,590,47,31,78,
1277,584,48,37,85,
1278,608,39,30,69,
1279,656,47,45,92,
1280,591,34,29,63,
1281,622,27,46,73,
1282,630,41,39,80,
1283,580,34,32,66,
1284,611,46,35,81,
1285,619,48,33,81,
1286,636,45,33,78,
1287,625,40,33,73,
1288,647,49,38,87,
1289,592,48,37,85,
1290,637,39,38,77,
1291,621,51,38,89,
1292,631,48,28,76,
1293,596,40,31,71,
1294,654,54,45,99,
1295,596,48,37,85,
1296,576,35,29,64,
1297,616,46,25,71,
1298,586,48,29,77,
1299,622,46,50,96,
1300,601,38,32,70,
1301,635,55,51,106,
1302,634,53,24,77,
1303,616,47,35,82,
1304,631,44,32,76,
1305,612,36,41,77,
1306,643,41,39,80,
1307,626,39,25,64,
1308,548,49,24,73,
1309,637,39,40,79,
1310,602,46,38,84,
1311,634,45,29,74,
1312,597,47,28,75,
1313,622,47,26,73,
1314,594,42,37,79,
1315,636,54,35,89,
1316,631,39,32,71,
1317,591,36,41,77,
1318,609,37,42,79,
1319,596,34,42,76,
1320,632,49,34,83,
1321,596,41,33,74,
1322,623,45,34,79,
1323,607,44,32,76,
1324,597,41,36,77,
1325,614,49,35,84,
1326,644,47,38,85,
1327,569,40,34,74,
1328,653,50,37,87,
1329,573,38,32,70,
1330,601,35,34,69,
1331,597,53,41,94,
1332,594,42,34,76,
1333,659,63,33,96,
1334,611,45,34,79,
1335,638,42,38,80,
1336,600,50,38,88,
1337,646,58,46,104,
1338,609,34,34,68,
1339,618,43,34,77,
1340,586,49,30,79,
1341,609,45,30,75,
1342,604,51,41,92,
1343,648,56,45,101,
1344,652,58,31,89,
1345,575,40,30,70,
1346,649,52,28,80,
1347,595,45,28,73,
1348,614,40,36,76,
1349,644,48,37,85,
1350,620,57,37,94,
1351,630,48,37,85,
1352,628,43,32,75,
1353,605,37,34,71,
1354,620,48,34,82,
1355,632,40,35,75,
1356,606,46,36,82,
1357,590,40,35,75,
1358,614,50,34,84,
1359,578,40,36,76,
1360,625,46,44,90,
1361,580,43,42,85,
1362,611,46,20,66,
1363,644,38,45,83,
1364,606,49,33,82,
1365,612,57,31,88,
1366,604,54,44,98,
1367,602,45,36,81,
1368,624,50,31,81,
1369,661,54,38,92,
1370,624,52,24,76,
1371,651,44,30,74,
1372,585,41,34,75,
1373,617,39,42,81,
1374,630,52,25,77,
1375,636,41,40,81,
1376,630,58,28,86,
1377,627,53,33,86,
1378,633,52,41,93,
1379,594,39,36,75,
1380,549,32,42,74,
1381,586,43,37,80,
1382,591,54,43,97,
1383,643,43,36,79,
1384,613,53,32,85,
1385,663,37,28,65,
1386,608,45,40,85,
1387,678,68,35,103,
1388,617,41,43,84,
1389,644,43,46,89,
1390,629,53,35,88,
1391,605,43,29,72,
1392,601,43,32,75,
1393,636,43,30,73,
1394,626,47,29,76,
1395,587,39,31,70,
1396,585,34,36,70,
1397,611,40,38,78,
1398,625,42,34,76,
1399,638,43,36,79,
1400,659,45,48,93,
1401,588,45,30,75,
1402,641,48,27,75,
1403,609,56,36,92,
1404,591,46,23,69,
1405,664,44,32,76,
1406,597,30,33,63,
1407,644,45,33,78,
1408,601,42,28,70,
1409,652,54,35,89,
1410,667,43,45,88,
1411,674,51,47,98,
1412,596,36,28,64,
1413,583,41,35,76,
1414,588,45,33,78,
1415,614,42,32,74,
1416,581,51,31,82,
1417,665,48,40,88,
1418,592,37,31,68,
1419,616,50,38,88,
1420,583,53,26,79,
1421,578,38,38,76,
1422,607,33,27,60,
1423,609,38,43,81,
1424,614,42,41,83,
1425,602,53,32,85,
1426,652,46,25,71,
1427,642,53,30,83,
1428,623,46,38,84,
1429,647,50,34,84,
1430,615,47,39,86,
1431,631,36,33,69,
1432,630,50,32,82,
1433,626,47,32,79,
1434,604,43,37,80,
1435,611,54,43,97,
1436,648,47,39,86,
1437,653,45,37,82,
1438,652,48,43,91,
1439,569,39,33,72,
1440,616,47,33,80,
1441,608,40,43,83,
1442,619,43,31,74,
1443,604,45,39,84,
1444,583,35,30,65,
1445,598,41,40,81,
1446,609,45,22,67,
1447,595,42,27,69,
1448,619,41,40,81,
1449,601,53,31,84,
1450,658,61,44,105,
1451,625,55,28,83,
1452,610,49,31,80,
1453,599,38,33,71,
1454,631,54,36,90,
1455,636,40,43,83,
1456,590,34,36,70,
1457,617,44,38,82,
1458,619,37,36,73,
1459,622,61,30,91,
1460,612,57,44,101,
1461,609,43,33,76,
1462,642,44,43,87,
1463,621,48,33,81,
1464,606,40,36,76,
1465,616,50,34,84,
1466,650,51,25,76,
1467,602,42,27,69,
1468,644,52,31,83,
1469,568,36,39,75,
1470,630,55,42,97,
1471,631,48,41,89,
1472,549,32,29,61,
1473,612,33,36,69,
1474,566,41,41,82,
1475,646,45,30,75,
1476,570,41,29,70,
1477,580,55,24,79,
1478,613,40,42,82,
1479,634,43,47,90,
1480,606,41,31,72,
1481,600,37,30,67,
1482,644,47,39,86,
1483,607,47,29,76,
1484,632,44,31,75,
1485,630,40,38,78,
1486,569,44,24,68,
1487,588,41,33,74,
1488,619,46,40,86,
1489,626,53,33,86,
1490,610,54,33,87,
1491,635,40,39,79,
1492,583,42,40,82,
1493,631,31,39,70,
1494,597,63,33,96,
1495,543,39,42,81,
1496,649,48,36,84,
1497,638,49,32,81,
1498,604,45,37,82,
1499,549,52,33,85,
1500,657,49,33,82,
1501,598,46,31,77,
1502,553,39,31,70,
1503,601,42,50,92,
1504,647,52,34,86,
1505,591,42,31,73,
1506,601,54,25,79,
1507,610,41,33,74,
1508,598,36,31,67,
1509,640,36,45,81,
1510,597,52,30,82,
1511,628,43,39,82,
1512,629,38,35,73,
1513,628,45,34,79,
1514,625,59,38,97,
1515,611,55,35,90,
1516,626,37,33,70,
1517,588,41,34,75,
1518,630,40,37,77,
1519,618,45,37,82,
1520,615,39,29,68,
1521,642,40,38,78,
1522,610,41,35,76,
1523,612,43,38,81,
1524,631,55,35,90,
1525,620,41,33,74,
1526,651,69,34,103,
1527,665,53,45,98,
1528,661,44,37,81,
1529,618,46,31,77,
1530,639,50,30,80,
1531,602,52,32,84,
1532,591,39,46,85,
1533,602,34,28,62,
1534,637,53,41,94,
1535,622,51,38,89,
1536,635,30,37,67,
1537,603,31,35,66,
1538,609,56,32,88,
1539,648,50,25,75,
1540,589,50,29,79,
1541,636,45,46,91,
1542,571,42,30,72,
1543,568,46,45,91,
1544,586,38,36,74,
1545,607,51,39,90,
1546,640,43,38,81,
1547,648,41,41,82,
1548,604,44,41,85,
1549,646,49,33,82,
1550,628,34,44,78,
1551,633,40,45,85,
1552,646,51,44,95,
1553,627,33,37,70,
1554,596,36,29,65,
1555,608,44,30,74,
1556,585,42,31,73,
1557,612,40,42,82,
1558,626,46,35,81,
1559,609,49,34,83,
1560,611,48,41,89,
1561,653,56,40,96,
1562,646,50,33,83,
1563,596,53,31,84,
1564,605,42,39,81,
1565,630,57,35,92,
1566,623,46,42,88,
1567,581,43,32,75,
1568,625,52,38,90,
1569,639,41,36,77,
1570,637,49,37,86,
1571,605,27,41,68,
1572,601,40,39,79,
1573,645,51,30,81,
1574,684,44,48,92,
1575,599,38,32,70,
1576,610,47,35,82,
1577,640,40,47,87,
1578,621,39,45,84,
1579,622,50,36,86,
1580,655,59,44,103,
1581,598,42,34,76,
1582,607,49,31,80,
1583,644,45,37,82,
1584,620,40,32,72,
1585,595,46,37,83,
1586,630,46,26,72,
1587,580,36,33,69,
1588,638,44,32,76,
1589,605,53,40,93,
1590,649,43,48,91,
1591,631,46,39,85,
1592,606,52,36,88,
1593,642,50,28,78,
1594,663,45,31,76,
1595,642,49,36,85,
1596,622,52,33,85,
1597,582,40,23,63,
1598,655,42,44,86,
1599,599,39,41,80,
1600,607,52,27,79,
1601,608,44,42,86,
1602,607,55,34,89,
1603,623,49,34,83,
1604,617,49,50,99,
1605,609,44,34,78,
1606,609,45,36,81,
1607,652,42,34,76,
1608,625,42,32,74,
1609,567,52,27,79,
1610,609,36,40,76,
1611,643,48,34,82,
1612,648,42,36,78,
1613,644,45,33,78,
1614,653,61,30,91,
1615,602,45,29,74,
1616,598,42,43,85,
1617,618,35,35,70,
1618,614,52,24,76,
1619,614,45,27,72,
1620,623,45,29,74,
1621,617,50,34,84,
1622,648,55,36,91,
1623,602,51,37,88,
1624,601,51,36,87,
1625,650,48,48,96,
1626,681,55,44,99,
1627,633,48,30,78,
1628,619,36,32,68,
1629,602,41,47,88,
1630,661,53,31,84,
1631,620,52,41,93,
1632,637,53,34,87,
1633,647,33,47,80,
1634,632,43,44,87,
1635,689,42,38,80,
1636,683,45,42,87,
1637,597,51,33,84,
1638,667,45,39,84,
1639,629,46,40,86,
1640,603,46,30,76,
1641,604,34,43,77,
1642,602,54,35,89,
1643,619,36,34,70,
1644,635,40,32,72,
1645,598,42,28,70,
1646,654,47,34,81,
1647,586,36,36,72,
1648,619,45,33,78,
1649,606,30,34,64,
1650,638,55,42,97,
1651,568,39,26,65,
1652,624,48,38,86,
1653,630,43,37,80,
1654,602,41,29,70,
1655,660,48,39,87,
1656,617,55,27,82,
1657,559,34,34,68,
1658,645,54,35,89,
1659,601,39,37,76,
1660,568,36,37,73,
1661,658,57,45,102,
1662,611,37,24,61,
1663,619,46,36,82,
1664,618,38,29,67,
1665,614,51,33,84,
1666,590,38,38,76,
1667,639,51,39,90,
1668,600,26,37,63,
1669,623,37,30,67,
1670,646,52,29,81,
1671,632,37,38,75,
1672,617,36,39,75,
1673,602,49,42,91,
1674,622,36,35,71,
1675,646,47,36,83,
1676,604,38,34,72,
1677,624,34,32,66,
1678,660,49,47,96,
1679,639,45,45,90,
1680,639,42,40,82,
1681,615,38,35,73,
1682,626,34,35,69,
1683,628,38,36,74,
1684,582,49,37,86,
1685,628,46,34,80,
1686,632,56,38,94,
1687,582,45,30,75,
1688,661,54,41,95,
1689,632,55,32,87,
1690,625,34,41,75,
1691,640,50,38,88,
1692,625,48,27,75,
1693,654,63,34,97,
1694,599,34,37,71,
1695,626,53,32,85,
1696,641,50,37,87,
1697,647,55,36,91,
1698,601,36,32,68,
1699,586,41,32,73,
1700,593,36,31,67,
1701,633,34,42,76,
1702,625,36,34,70,
1703,566,53,28,81,
1704,650,36,39,75,
1705,604,38,42,80,
1706,643,33,36,69,
1707,591,48,25,73,
1708,572,36,31,67,
1709,606,52,27,79,
1710,598,43,34,77,
1711,554,37,45,82,
1712,627,48,35,83,
1713,615,45,35,80,
1714,645,45,37,82,
1715,615,53,40,93,
1716,644,50,33,83,
1717,632,44,42,86,
1718,581,53,41,94,
1719,607,38,29,67,
1720,588,49,40,89,
1721,624,56,44,100,
1722,623,51,32,83,
1723,613,44,30,74,
1724,558,41,25,66,
1725,612,48,35,83,
1726,603,58,30,88,
1727,598,42,36,78,
1728,619,41,41,82,
1729,681,61,31,92,
1730,598,42,36,78,
1731,585,44,31,75,
1732,641,42,36,78,
1733,616,48,33,81,
1734,589,49,39,88,
1735,631,64,34,98,
1736,622,43,45,88,
1737,664,41,48,89,
1738,642,51,38,89,
1739,625,43,30,73,
1740,606,50,39,89,
1741,626,43,23,66,
1742,609,40,38,78,
1743,606,45,28,73,
1744,626,32,43,75,
1745,596,53,32,85,
1746,614,39,40,79,
1747,602,40,36,76,
1748,651,47,37,84,
1749,599,47,40,87,
1750,615,38,38,76,
1751,609,52,28,80,
1752,618,45,33,78,
1753,618,39,32,71,
1754,611,50,49,99,
1755,615,61,44,105,
1756,601,35,40,75,
1757,623,42,26,68,
1758,615,37,35,72,
1759,622,41,37,78,
1760,635,43,50,93,
1761,615,56,36,92,
1762,618,36,44,80,
1763,642,30,31,61,
1764,645,51,57,108,
1765,619,45,34,79,
1766,642,36,28,64,
1767,590,37,34,71,
1768,572,41,33,74,
1769,595,48,41,89,
1770,599,41,37,78,
1771,628,43,30,73,
1772,609,44,35,79,
1773,608,48,34,82,
1774,604,28,41,69,
1775,624,54,32,86,
1776,675,47,34,81,
1777,623,41,33,74,
1778,643,46,35,81,
1779,612,41,48,89,
1780,642,45,32,77,
1781,618,47,38,85,
1782,647,43,43,86,
1783,661,55,31,86,
1784,621,38,29,67,
1785,646,57,41,98,
1786,586,57,35,92,
1787,660,53,38,91,
1788,632,41,43,84,
1789,652,52,34,86,
1790,630,45,49,94,
1791,625,49,35,84,
1792,639,44,37,81,
1793,620,46,35,81,
1794,634,39,31,70,
1795,626,41,32,73,
1796,576,41,29,70,
1797,637,38,44,82,
1798,614,37,45,82,
1799,632,53,25,78,
1800,644,45,36,81,
1801,599,49,25,74,
1802,613,49,39,88,
1803,620,43,33,76,
1804,640,39,33,72,
1805,645,53,33,86,
1806,623,40,26,66,
1807,623,44,36,80,
1808,627,48,37,85,
1809,593,41,34,75,
1810,622,41,38,79,
1811,605,45,41,86,
1812,608,44,38,82,
1813,573,38,35,73,
1814,627,55,36,91,
1815,600,45,31,76,
1816,600,51,39,90,
1817,586,36,30,66,
1818,604,54,43,97,
1819,619,46,48,94,
1820,622,41,41,82,
1821,604,46,33,79,
1822,626,48,23,71,
1823,653,49,45,94,
1824,632,49,45,94,
1825,649,43,37,80,
1826,614,48,39,87,
1827,642,47,34,81,
1828,606,36,41,77,
1829,625,54,47,101,
1830,609,35,26,61,
1831,641,45,35,80,
1832,597,48,34,82,
1833,637,47,42,89,
1834,632,36,45,81,
1835,604,50,32,82,
1836,614,47,26,73,
1837,617,39,46,85,
1838,634,60,36,96,
1839,607,40,31,71,
1840,638,43,31,74,
1841,671,50,39,89,
1842,656,47,37,84,
1843,603,43,28,71,
1844,626,50,34,84,
1845,621,56,26,82,
1846,577,38,40,78,
1847,627,33,42,75,
1848,595,47,38,85,
1849,648,53,33,86,
1850,619,51,41,92,
1851,635,46,38,84,
1852,624,43,35,78,
1853,621,45,43,88,
1854,603,41,48,89,
1855,640,58,38,96,
1856,650,52,45,97,
1857,639,61,38,99,
1858,669,56,33,89,
1859,613,46,36,82,
1860,602,47,28,75,
1861,636,41,40,81,
1862,615,35,37,72,
1863,569,51,33,84,
1864,588,53,37,90,
1865,612,50,30,80,
1866,649,49,31,80,
1867,598,34,29,63,
1868,621,38,42,80,
1869,598,49,38,87,
1870,593,39,35,74,
1871,629,52,35,87,
1872,577,43,28,71,
1873,608,44,37,81,
1874,650,52,41,93,
1875,619,45,35,80,
1876,625,44,26,70,
1877,628,49,31,80,
1878,637,36,43,79,
1879,629,43,44,87,
1880,637,50,33,83,
1881,631,52,30,82,
1882,613,47,27,74,
1883,624,41,43,84,
1884,653,50,44,94,
1885,651,41,44,85,
1886,589,27,32,59,
1887,607,58,31,89,
1888,613,48,32,80,
1889,587,40,31,71,
1890,609,38,32,70,
1891,534,37,26,63,
1892,634,49,41,90,
1893,617,55,30,85,
1894,613,46,39,85,
1895,669,49,37,86,
1896,580,47,31,78,
1897,655,32,41,73,
1898,639,45,37,82,
1899,601,38,28,66,
1900,595,43,37,80,
1901,623,54,27,81,
1902,578,33,38,71,
1903,673,50,29,79,
1904,598,45,24,69,
1905,575,44,40,84,
1906,576,38,35,73,
1907,583,32,26,58,
1908,616,33,39,72,
1909,648,35,35,70,
1910,585,39,29,68,
1911,656,38,32,70,
1912,602,47,34,81,
1913,626,50,30,80,
1914,615,38,39,77,
1915,624,47,39,86,
1916,602,47,37,84,
1917,640,45,35,80,
1918,620,45,36,81,
1919,599,58,27,85,
1920,575,49,39,88,
1921,619,41,28,69,
1922,660,34,39,73,
1923,607,43,33,76,
1924,579,44,40,84,
1925,639,41,31,72,
1926,639,63,39,102,
1927,570,50,20,70,
1928,624,49,30,79,
1929,660,44,27,71,
1930,619,48,44,92,
1931,619,45,39,84,
1932,638,40,40,80,
1933,573,44,31,75,
1934,620,45,35,80,
1935,638,40,39,79,
1936,668,52,32,84,
1937,630,40,34,74,
1938,618,39,39,78,
1939,597,52,31,83,
1940,638,45,35,80,
1941,610,39,48,87,
1942,612,43,34,77,
1943,595,42,39,81,
1944,597,52,39,91,
1945,581,32,49,81,
1946,622,47,42,89,
1947,599,34,37,71,
1948,616,35,38,73,
1949,611,42,40,82,
1950,607,51,38,89,
1951,600,47,24,71,
1952,621,46,28,74,
1953,644,35,28,63,
1954,590,32,41,73,
1955,626,47,34,81,
1956,596,47,32,79,
1957,589,44,40,84,
1958,635,46,40,86,
1959,649,50,35,85,
1960,611,36,47,83,
1961,631,47,24,71,
1962,597,43,24,67,
1963,643,43,34,77,
1964,603,53,25,78,
1965,631,46,32,78,
1966,593,43,32,75,
1967,655,50,42,92,
1968,621,41,32,73,
1969,617,47,36,83,
1970,601,49,36,85,
1971,723,53,35,88,
1972,671,49,27,76,
1973,648,49,49,98,
1974,617,34,44,78,
1975,656,50,31,81,
1976,621,40,37,77,
1977,612,43,38,81,
1978,658,46,35,81,
1979,603,45,24,69,
1980,636,45,36,81,
1981,598,44,38,82,
1982,554,36,30,66,
1983,584,31,31,62,
1984,618,44,29,73,
1985,622,42,33,75,
1986,654,41,25,66,
1987,612,52,36,88,
1988,618,44,37,81,
1989,681,44,35,79,
1990,636,50,46,96,
1991,590,53,48,101,
1992,682,38,46,84,
1993,650,47,31,78,
1994,639,55,35,90,
1995,592,54,28,82,
1996,623,44,38,82,
1997,632,50,30,80,
1998,622,57,36,93,
1999,592,41,27,68,
2000,625,56,42,98,
2001,639,48,37,85,
2002,598,47,36,83,
2003,616,40,33,73,
2004,650,62,39,101,
2005,637,39,30,69,
2006,644,51,33,84,
2007,613,43,33,76,
2008,650,48,43,91,
2009,634,50,37,87,
2010,603,42,38,80,
2011,619,51,32,83,
2012,708,61,46,107,
2013,638,46,31,77,
2014,680,58,45,103,
2015,586,49,38,87,
2016,577,40,31,71,
2017,621,41,31,72,
2018,578,45,34,79,
2019,707,38,25,63,
2020,651,49,42,91,
2021,623,44,28,72,
2022,611,36,32,68,
2023,625,59,23,82,
2024,635,48,39,87,
2025,633,45,31,76,
2026,639,58,31,89,
2027,679,55,28,83,
2028,638,37,28,65,
2029,589,45,22,67,
2030,618,43,35,78,
2031,592,38,36,74,
2032,675,50,40,90,
2033,590,55,28,83,
2034,655,37,36,73,
2035,608,49,31,80,
2036,592,38,25,63,
2037,655,38,39,77,
2038,635,53,39,92,
2039,617,50,47,97,
2040,571,43,36,79,
2041,634,54,27,81,
2042,638,54,35,89,
2043,565,43,36,79,
2044,577,42,27,69,
2045,597,45,30,75,
2046,579,33,34,67,
2047,585,41,32,73,
2048,635,33,43,76,
2049,605,46,37,83,
2050,583,47,31,78,
2051,585,42,33,75,
2052,647,34,36,70,
2053,603,41,45,86,
2054,648,53,51,104,
2055,585,41,34,75,
2056,641,44,34,78,
2057,632,50,39,89,
2058,634,37,48,85,
2059,578,47,37,84,
2060,611,41,24,65,
2061,602,33,33,66,
2062,657,42,26,68,
2063,654,48,33,81,
2064,584,27,32,59,
2065,661,46,42,88,
2066,621,41,28,69,
2067,611,54,31,85,
2068,624,47,38,85,
2069,575,39,31,70,
2070,619,45,48,93,
2071,591,53,33,86,
2072,645,59,32,91,
2073,653,51,33,84,
2074,584,39,27,66,
2075,639,41,38,79,
2076,658,45,46,91,
2077,609,55,34,89,
2078,589,61,31,92,
2079,611,48,26,74,
2080,635,46,36,82,
2081,629,34,44,78,
2082,590,48,28,76,
2083,610,42,45,87,
2084,644,52,35,87,
2085,634,62,44,106,
2086,558,35,38,73,
2087,573,35,25,60,
2088,657,49,34,83,
2089,564,51,28,79,
2090,606,52,32,84,
2091,633,45,48,93,
2092,604,49,29,78,
2093,604,40,28,68,
2094,594,36,26,62,
2095,630,35,33,68,
2096,625,54,40,94,
2097,625,40,26,66,
2098,622,35,46,81,
2099,614,43,30,73,
2100,612,48,36,84,
2101,619,57,28,85,
2102,604,42,34,76,
2103,608,45,37,82,
2104,630,51,36,87,
2105,674,42,47,89,
2106,629,52,34,86,
2107,606,37,38,75,
2108,630,43,26,69,
2109,609,43,35,78,
2110,652,44,39,83,
2111,604,51,36,87,
2112,587,39,27,66,
2113,684,51,49,100,
2114,588,50,34,84,
2115,645,60,39,99,
2116,565,48,35,83,
2117,603,41,38,79,
2118,590,29,33,62,
2119,633,53,31,84,
2120,620,47,29,76,
2121,565,42,27,69,
2122,584,49,45,94,
2123,662,36,32,68,
2124,671,54,38,92,
2125,647,36,38,74,
2126,595,52,33,85,
2127,626,43,38,81,
2128,646,46,38,84,
2129,599,52,24,76,
2130,658,63,45,108,
2131,639,48,31,79,
2132,615,39,27,66,
2133,625,42,41,83,
2134,653,51,34,85,
2135,676,42,38,80,
2136,643,54,32,86,
2137,564,44,30,74,
2138,611,56,35,91,
2139,682,49,33,82,
2140,591,45,32,77,
2141,573,36,38,74,
2142,675,61,31,92,
2143,656,44,35,79,
2144,642,45,39,84,
2145,635,41,32,73,
2146,634,49,40,89,
2147,657,41,39,80,
2148,673,53,39,92,
2149,625,49,42,91,
2150,573,50,40,90,
2151,606,45,34,79,
2152,625,43,34,77,
2153,619,50,21,71,
2154,642,47,37,84,
2155,619,42,35,77,
2156,620,51,45,96,
2157,595,46,27,73,
2158,640,40,32,72,
2159,621,44,30,74,
2160,586,40,32,72,
2161,658,40,32,72,
2162,626,45,41,86,
2163,624,43,30,73,
2164,627,44,29,73,
2165,580,46,25,71,
2166,600,40,29,69,
2167,642,46,30,76,
2168,633,55,44,99,
2169,588,46,36,82,
2170,605,39,29,68,
2171,610,40,29,69,
2172,584,46,40,86,
2173,656,46,32,78,
2174,597,41,37,78,
2175,606,34,27,61,
2176,567,45,21,66,
2177,630,66,46,112,
2178,577,53,25,78,
2179,619,61,44,105,
2180,602,44,31,75,
2181,607,47,34,81,
2182,615,44,38,82,
2183,637,35,36,71,
2184,662,38,39,77,
2185,615,34,34,68,
2186,639,50,37,87,
2187,592,33,28,61,
2188,633,59,38,97,
2189,629,45,36,81,
2190,645,35,41,76,
2191,626,42,45,87,
2192,641,59,36,95,
2193,570,50,38,88,
2194,558,43,31,74,
2195,638,37,37,74,
2196,608,38,40,78,
2197,632,41,38,79,
2198,650,36,36,72,
2199,629,46,31,77,
2200,614,40,25,65,
2201,653,38,33,71,
2202,578,40,36,76,
2203,620,52,44,96,
2204,628,40,31,71,
2205,684,50,44,94,
2206,656,38,35,73,
2207,660,54,33,87,
2208,632,58,30,88,
2209,581,46,33,79,
2210,619,45,31,76,
2211,652,45,29,74,
2212,677,58,39,97,
2213,621,51,38,89,
2214,674,40,47,87,
2215,598,41,36,77,
2216,612,47,30,77,
2217,598,52,31,83,
2218,605,44,33,77,
2219,619,38,26,64,
2220,625,33,37,70,
2221,670,41,35,76,
2222,621,44,32,76,
2223,644,49,33,82,
2224,610,43,30,73,
2225,678,47,43,90,
2226,643,51,34,85,
2227,670,47,35,82,
2228,650,40,37,77,
2229,659,48,43,91,
2230,604,46,30,76,
2231,635,66,35,101,
2232,600,51,37,88,
2233,644,42,36,78,
2234,585,45,26,71,
2235,630,53,36,89,
2236,621,42,43,85,
2237,650,62,36,98,
2238,610,50,39,89,
2239,588,41,30,71,
2240,597,50,39,89,
2241,606,44,41,85,
2242,578,27,35,62,
2243,648,53,38,91,
2244,607,37,35,72,
2245,637,36,49,85,
2246,627,51,42,93,
2247,595,38,30,68,
2248,626,45,47,92,
2249,576,40,29,69,
2250,639,55,29,84,
2251,619,45,37,82,
2252,667,48,46,94,
2253,601,42,34,76,
2254,639,48,34,82,
2255,649,53,34,87,
2256,636,42,28,70,
2257,603,38,34,72,
2258,608,42,32,74,
2259,583,40,32,72,
2260,601,39,38,77,
2261,607,48,34,82,
2262,647,45,34,79,
2263,561,40,32,72,
2264,625,34,35,69,
2265,546,34,29,63,
2266,608,42,50,92,
2267,608,43,37,80,
2268,587,44,37,81,
2269,669,47,34,81,
2270,675,47,23,70,
2271,635,47,44,91,
2272,612,43,34,77,
2273,699,53,37,90,
2274,624,47,38,85,
2275,597,47,34,81,
2276,618,50,33,83,
2277,588,40,36,76,
2278,622,43,45,88,
2279,636,49,46,95,
2280,602,38,33,71,
2281,645,51,29,80,
2282,594,42,33,75,
2283,619,42,35,77,
2284,565,42,30,72,
2285,629,48,27,75,
2286,577,31,39,70,
2287,614,42,36,78,
2288,640,51,47,98,
2289,612,51,34,85,
2290,652,53,42,95,
2291,580,45,37,82,
2292,620,37,33,70,
2293,644,49,35,84,
2294,610,43,34,77,
2295,606,45,37,82,
2296,587,49,33,82,
2297,663,51,36,87,
2298,633,42,43,85,
2299,581,41,30,71,
2300,615,45,32,77,
2301,587,36,28,64,
2302,668,51,43,94,
2303,644,33,32,65,
2304,627,48,30,78,
2305,637,44,49,93,
2306,605,43,38,81,
2307,580,38,30,68,
2308,606,38,38,76,
2309,624,43,45,88,
2310,602,41,31,72,
2311,637,40,42,82,
2312,624,47,36,83,
2313,599,46,32,78,
2314,603,42,37,79,
2315,595,36,26,62,
2316,601,51,47,98,
2317,611,40,29,69,
2318,642,49,31,80,
2319,659,49,34,83,
2320,593,43,22,65,
2321,644,45,27,72,
2322,629,40,38,78,
2323,642,52,38,90,
2324,588,34,26,60,
2325,635,42,31,73,
2326,637,41,42,83,
2327,586,49,40,89,
2328,604,36,35,71,
2329,627,45,33,78,
2330,595,52,28,80,
2331,606,46,36,82,
2332,568,44,38,82,
2333,609,51,36,87,
2334,591,42,40,82,
2335,585,54,35,89,
2336,576,45,23,68,
2337,605,48,27,75,
2338,637,64,35,99,
2339,598,45,36,81,
2340,617,45,38,83,
2341,624,55,49,104,
2342,638,47,37,84,
2343,609,39,39,78,
2344,592,39,37,76,
2345,619,39,32,71,
2346,616,48,25,73,
2347,644,57,25,82,
2348,590,53,25,78,
2349,572,29,26,55,
2350,604,49,30,79,
2351,597,46,34,80,
2352,589,30,38,68,
2353,644,57,33,90,
2354,612,48,33,81,
2355,605,45,42,87,
2356,621,48,33,81,
2357,612,43,37,80,
2358,618,44,45,89,
2359,654,46,47,93,
2360,639,48,40,88,
2361,682,42,33,75,
2362,652,46,39,85,
2363,607,45,30,75,
2364,645,46,36,82,
2365,651,48,37,85,
2366,579,34,41,75,
2367,632,52,36,88,
2368,600,46,35,81,
2369,623,49,27,76,
2370,605,48,25,73,
2371,642,50,29,79,
2372,636,47,40,87,
2373,648,53,35,88,
2374,651,56,40,96,
2375,634,64,30,94,
2376,606,48,29,77,
2377,621,43,41,84,
2378,610,38,35,73,
2379,596,40,29,69,
2380,620,44,38,82,
2381,587,43,39,82,
2382,629,41,37,78,
2383,615,41,32,73,
2384,625,47,37,84,
2385,593,34,34,68,
2386,630,61,34,95,
2387,553,36,29,65,
2388,678,46,47,93,
2389,599,46,38,84,
2390,606,39,36,75,
2391,633,35,33,68,
2392,577,47,28,75,
2393,657,49,41,90,
2394,619,38,30,68,
2395,592,37,36,73,
2396,616,43,27,70,
2397,615,49,43,92,
2398,615,43,36,79,
2399,613,34,40,74,
2400,595,46,29,75,
2401,602,41,33,74,
2402,560,38,30,68,
2403,684,44,49,93,
2404,642,31,44,75,
2405,578,58,38,96,
2406,637,47,40,87,
2407,641,51,55,106,
2408,631,34,39,73,
2409,613,39,28,67,
2410,590,37,31,68,
2411,636,45,43,88,
2412,588,45,43,88,
2413,626,43,45,88,
2414,633,40,34,74,
2415,624,60,32,92,
2416,590,37,34,71,
2417,603,45,37,82,
2418,622,52,45,97,
2419,619,38,25,63,
2420,621,52,36,88,
2421,615,53,27,80,
2422,578,36,31,67,
2423,613,45,38,83,
2424,603,39,38,77,
2425,665,47,38,85,
2426,587,38,29,67,
2427,631,52,33,85,
2428,613,49,30,79,
2429,652,46,41,87,
2430,624,44,37,81,
2431,634,56,37,93,
2432,622,48,40,88,
2433,586,37,28,65,
2434,584,42,38,80,
2435,596,43,28,71,
2436,609,52,38,90,
2437,621,49,35,84,
2438,611,41,35,76,
2439,598,39,36,75,
2440,609,47,40,87,
2441,603,45,43,88,
2442,677,43,46,89,
2443,587,35,35,70,
2444,621,33,38,71,
2445,572,50,31,81,
2446,580,40,37,77,
2447,632,40,35,75,
2448,608,46,30,76,
2449,613,46,38,84,
2450,651,52,35,87,
2451,633,46,32,78,
2452,612,51,36,87,
2453,648,47,45,92,
2454,587,43,37,80,
2455,634,55,32,87,
2456,653,55,29,84,
2457,642,40,38,78,
2458,610,43,35,78,
2459,640,45,41,86,
2460,627,45,41,86,
2461,626,49,45,94,
2462,646,36,46,82,
2463,625,45,28,73,
2464,634,35,36,71,
2465,624,41,42,83,
2466,652,42,32,74,
2467,628,42,28,70,
2468,613,56,27,83,
2469,605,38,36,74,
2470,599,57,29,86,
2471,667,42,35,77,
2472,614,61,36,97,
2473,618,45,42,87,
2474,636,55,31,86,
2475,602,47,29,76,
2476,633,50,50,100,
2477,624,50,31,81,
2478,616,47,29,76,
2479,633,44,36,80,
2480,620,48,31,79,
2481,602,51,31,82,
2482,612,41,27,68,
2483,556,42,17,59,
2484,579,38,27,65,
2485,580,44,32,76,
2486,584,49,29,78,
2487,565,46,25,71,
2488,632,37,41,78,
2489,657,42,36,78,
2490,594,46,26,72,
2491,613,54,36,90,
2492,617,41,24,65,
2493,593,39,35,74,
2494,598,45,31,76,
2495,577,46,36,82,
2496,675,58,37,95,
2497,686,54,45,99,
2498,611,40,30,70,
2499,586,46,28,74,
2500,667,41,37,78,
2501,584,40,29,69,
2502,587,48,30,78,
2503,621,43,35,78,
2504,633,54,32,86,
2505,634,40,32,72,
2506,642,48,38,86,
2507,636,46,38,84,
2508,603,38,35,73,
2509,634,48,31,79,
2510,597,54,40,94,
2511,614,50,32,82,
2512,627,43,45,88,
2513,621,42,34,76,
2514,652,41,43,84,
2515,632,52,42,94,
2516,595,45,38,83,
2517,606,39,27,66,
2518,664,38,39,77,
2519,609,38,29,67,
2520,584,42,36,78,
2521,629,43,32,75,
2522,613,48,34,82,
2523,618,52,36,88,
2524,578,45,26,71,
2525,619,41,31,72,
2526,633,49,26,75,
2527,561,38,35,73,
2528,611,41,46,87,
2529,606,33,41,74,
2530,645,45,39,84,
2531,637,48,39,87,
2532,589,51,40,91,
2533,650,51,30,81,
2534,599,46,29,75,
2535,645,51,48,99,
2536,650,36,55,91,
2537,660,51,34,85,
2538,638,43,34,77,
2539,595,40,36,76,
2540,620,59,38,97,
2541,625,53,35,88,
2542,620,44,44,88,
2543,616,47,20,67,
2544,555,41,27,68,
2545,592,38,36,74,
2546,617,44,31,75,
2547,631,41,38,79,
2548,681,44,42,86,
2549,636,52,42,94,
2550,587,45,42,87,
2551,629,47,34,81,
2552,575,45,32,77,
2553,590,49,34,83,
2554,633,34,47,81,
2555,628,48,33,81,
2556,619,43,31,74,
2557,605,44,39,83,
2558,613,49,49,98,
2559,618,44,43,87,
2560,597,38,39,77,
2561,566,53,33,86,
2562,636,44,42,86,
2563,627,53,41,94,
2564,637,45,41,86,
2565,606,45,29,74,
2566,612,43,30,73,
2567,602,44,32,76,
2568,633,42,38,80,
2569,636,41,39,80,
2570,616,46,31,77,
2571,610,47,40,87,
2572,597,37,30,67,
2573,637,60,27,87,
2574,618,47,38,85,
2575,653,45,38,83,
2576,633,50,42,92,
2577,631,47,36,83,
2578,585,38,42,80,
2579,594,49,30,79,
2580,624,45,39,84,
2581,621,45,26,71,
2582,608,36,36,72,
2583,585,44,33,77,
2584,666,43,41,84,
2585,607,38,28,66,
2586,619,47,40,87,
2587,648,54,46,100,
2588,622,41,42,83,
2589,580,49,26,75,
2590,624,45,40,85,
2591,604,33,30,63,
2592,598,48,33,81,
2593,608,45,36,81,
2594,643,57,38,95,
2595,622,38,24,62,
2596,627,54,29,83,
2597,587,49,29,78,
2598,596,46,47,93,
2599,603,36,29,65,
2600,598,52,37,89,
2601,608,43,37,80,
2602,610,42,38,80,
2603,629,54,40,94,
2604,595,41,35,76,
2605,603,43,37,80,
2606,611,40,44,84,
2607,609,30,31,61,
2608,592,40,38,78,
2609,669,55,42,97,
2610,618,48,31,79,
2611,637,48,29,77,
2612,634,55,36,91,
2613,659,45,40,85,
2614,602,31,27,58,
2615,613,43,22,65,
2616,548,37,18,55,
2617,584,48,39,87,
2618,626,43,38,81,
2619,644,55,45,100,
2620,609,45,47,92,
2621,594,43,33,76,
2622,597,40,34,74,
2623,634,40,36,76,
2624,634,38,36,74,
2625,641,50,43,93,
2626,605,47,24,71,
2627,575,40,33,73,
2628,629,51,36,87,
2629,615,59,45,104,
2630,609,37,46,83,
2631,644,33,33,66,
2632,598,39,44,83,
2633,632,44,33,77,
2634,593,38,34,72,
2635,688,69,40,109,
2636,639,33,23,56,
2637,610,46,30,76,
2638,615,45,36,81,
2639,633,45,46,91,
2640,608,45,32,77,
2641,620,41,32,73,
2642,613,51,31,82,
2643,618,43,35,78,
2644,609,44,42,86,
2645,646,50,30,80,
2646,637,44,44,88,
2647,663,47,45,92,
2648,635,52,36,88,
2649,596,43,36,79,
2650,580,35,27,62,
2651,601,46,32,78,
2652,604,50,36,86,
2653,615,32,39,71,
2654,583,45,32,77,
2655,628,44,43,87,
2656,618,45,43,88,
2657,597,51,37,88,
2658,613,47,36,83,
2659,606,57,26,83,
2660,613,36,27,63,
2661,617,56,24,80,
2662,662,40,37,77,
2663,634,44,33,77,
2664,604,45,41,86,
2665,617,49,39,88,
2666,654,55,37,92,
2667,576,37,33,70,
2668,600,43,30,73,
2669,617,54,27,81,
2670,635,43,33,76,
2671,620,50,38,88,
2672,641,61,37,98,
2673,624,49,34,83,
2674,628,50,29,79,
2675,621,55,31,86,
2676,632,40,32,72,
2677,605,36,32,68,
2678,590,44,33,77,
2679,650,47,34,81,
2680,589,33,34,67,
2681,616,52,32,84,
2682,628,48,30,78,
2683,621,48,45,93,
2684,624,45,27,72,
2685,579,38,26,64,
2686,619,37,46,83,
2687,612,44,45,89,
2688,631,51,28,79,
2689,624,45,46,91,
2690,562,44,24,68,
2691,578,46,39,85,
2692,585,49,34,83,
2693,600,42,39,81,
2694,644,45,38,83,
2695,653,41,27,68,
2696,615,44,31,75,
2697,589,45,30,75,
2698,634,41,34,75,
2699,612,44,31,75,
2700,610,42,43,85,
2701,644,53,25,78,
2702,637,53,29,82,
2703,653,48,31,79,
2704,632,33,32,65,
2705,670,50,33,83,
2706,570,43,37,80,
2707,636,44,33,77,
2708,625,47,31,78,
2709,646,43,45,88,
2710,608,43,29,72,
2711,652,55,33,88,
2712,627,61,42,103,
2713,599,52,49,101,
2714,628,35,35,70,
2715,671,47,42,89,
2716,661,62,39,101,
2717,607,42,46,88,
2718,610,51,41,92,
2719,640,34,34,68,
2720,612,52,27,79,
2721,647,57,29,86,
2722,677,47,33,80,
2723,648,37,47,84,
2724,616,45,35,80,
2725,623,46,29,75,
2726,646,46,31,77,
2727,689,47,45,92,
2728,651,42,30,72,
2729,631,66,29,95,
2730,615,56,25,81,
2731,611,33,34,67,
2732,593,38,27,65,
2733,658,40,44,84,
2734,595,43,27,70,
2735,616,48,32,80,
2736,591,35,29,64,
2737,615,37,37,74,
2738,641,40,41,81,
2739,591,49,30,79,
2740,695,38,34,72,
2741,573,38,28,66,
2742,586,39,31,70,
2743,567,45,32,77,
2744,576,35,38,73,
2745,633,57,35,92,
2746,582,47,33,80,
2747,632,57,33,90,
2748,650,48,38,86,
2749,630,40,42,82,
2750,617,39,32,71,
2751,593,44,35,79,
2752,660,52,45,97,
2753,607,40,31,71,
2754,644,52,42,94,
2755,632,52,30,82,
2756,626,43,50,93,
2757,626,50,47,97,
2758,632,46,29,75,
2759,628,36,38,74,
2760,623,45,25,70,
2761,595,58,27,85,
2762,641,42,29,71,
2763,621,36,30,66,
2764,637,61,46,107,
2765,630,41,35,76,
2766,648,37,37,74,
2767,644,48,45,93,
2768,604,45,41,86,
2769,626,58,36,94,
2770,666,57,42,99,
2771,606,52,31,83,
2772,624,40,40,80,
2773,602,39,38,77,
2774,597,35,38,73,
2775,631,38,32,70,
2776,621,37,39,76,
2777,644,59,40,99,
2778,625,51,37,88,
2779,586,39,36,75,
2780,649,39,44,83,
2781,677,40,35,75,
2782,609,47,28,75,
2783,624,43,37,80,
2784,646,44,45,89,
2785,624,59,37,96,
2786,611,44,27,71,
2787,595,55,27,82,
2788,607,52,26,78,
2789,630,49,29,78,
2790,671,43,38,81,
2791,604,45,33,78,
2792,645,43,33,76,
2793,599,51,31,82,
2794,612,38,42,80,
2795,681,47,42,89,
2796,626,44,38,82,
2797,605,47,42,89,
2798,617,46,37,83,
2799,581,47,19,66,
2800,590,45,41,86,
2801,665,56,33,89,
2802,595,41,34,75,
2803,615,42,40,82,
2804,639,32,39,71,
2805,597,48,33,81,
2806,638,59,17,76,
2807,633,44,52,96,
2808,558,46,31,77,
2809,626,41,42,83,
2810,614,36,25,61,
2811,643,46,37,83,
2812,647,49,38,87,
2813,567,38,33,71,
2814,630,40,34,74,
2815,604,36,31,67,
2816,596,50,50,100,
2817,640,47,37,84,
2818,634,36,42,78,
2819,661,57,42,99,
2820,594,40,37,77,
2821,647,49,27,76,
2822,594,44,26,70,
2823,581,27,32,59,
2824,650,56,34,90,
2825,602,32,39,71,
2826,597,46,35,81,
2827,638,48,46,94,
2828,630,54,29,83,
2829,598,44,36,80,
2830,594,41,29,70,
2831,584,45,32,77,
2832,642,35,40,75,
2833,620,30,36,66,
2834,618,45,39,84,
2835,636,33,35,68,
2836,581,36,29,65,
2837,585,46,42,88,
2838,644,43,41,84,
2839,612,43,32,75,
2840,627,40,29,69,
2841,601,48,32,80,
2842,590,36,30,66,
2843,677,48,45,93,
2844,632,41,35,76,
2845,626,45,39,84,
2846,650,42,51,93,
2847,632,48,40,88,
2848,637,57,43,100,
2849,628,42,36,78,
2850,666,54,37,91,
2851,614,43,36,79,
2852,642,43,34,77,
2853,617,42,31,73,
2854,634,38,34,72,
2855,637,44,36,80,
2856,666,44,35,79,
2857,614,37,42,79,
2858,622,51,34,85,
2859,647,48,34,82,
2860,610,36,40,76,
2861,602,48,28,76,
2862,660,59,31,90,
2863,640,45,36,81,
2864,653,49,38,87,
2865,631,47,34,81,
2866,608,40,40,80,
2867,618,36,39,75,
2868,601,36,40,76,
2869,665,50,43,93,
2870,596,45,37,82,
2871,640,53,42,95,
2872,596,41,27,68,
2873,597,40,44,84,
2874,617,55,42,97,
2875,602,47,38,85,
2876,579,40,33,73,
2877,645,42,36,78,
2878,605,50,34,84,
2879,582,46,32,78,
2880,598,34,26,60,
2881,587,43,35,78,
2882,638,49,44,93,
2883,601,43,25,68,
2884,595,32,34,66,
2885,656,55,36,91,
2886,644,49,37,86,
2887,628,41,35,76,
2888,611,44,33,77,
2889,607,41,36,77,
2890,590,51,33,84,
2891,595,49,29,78,
2892,633,49,25,74,
2893,600,54,30,84,
2894,644,43,43,86,
2895,657,42,39,81,
2896,625,50,38,88,
2897,625,44,47,91,
2898,630,56,27,83,
2899,628,57,33,90,
2900,647,51,40,91,
2901,640,50,47,97,
2902,582,40,33,73,
2903,595,54,30,84,
2904,657,52,37,89,
2905,618,41,39,80,
2906,593,34,41,75,
2907,571,47,27,74,
2908,582,44,28,72,
2909,608,46,48,94,
2910,631,38,42,80,
2911,616,38,36,74,
2912,632,44,43,87,
2913,650,41,45,86,
2914,613,49,32,81,
2915,609,52,36,88,
2916,608,59,39,98,
2917,609,41,35,76,
2918,607,38,33,71,
2919,618,39,37,76,
2920,624,52,21,73,
2921,629,56,26,82,
2922,604,39,37,76,
2923,694,43,42,85,
2924,588,45,35,80,
2925,635,43,42,85,
2926,653,59,34,93,
2927,615,46,32,78,
2928,635,46,45,91,
2929,606,57,34,91,
2930,608,43,36,79,
2931,646,58,36,94,
2932,583,43,31,74,
2933,661,54,48,102,
2934,661,46,50,96,
2935,608,53,29,82,
2936,628,49,35,84,
2937,663,60,32,92,
2938,621,46,39,85,
2939,611,39,30,69,
2940,627,36,43,79,
2941,586,48,33,81,
2942,659,46,41,87,
2943,608,53,40,93,
2944,610,42,33,75,
2945,631,53,37,90,
2946,626,47,30,77,
2947,625,51,35,86,
2948,623,38,31,69,
2949,629,61,38,99,
2950,654,37,39,76,
2951,653,58,32,90,
2952,585,51,41,92,
2953,594,36,36,72,
2954,598,52,29,81,
2955,621,47,33,80,
2956,595,42,37,79,
2957,591,45,34,79,
2958,623,51,44,95,
2959,615,51,42,93,
2960,645,58,35,93,
2961,584,41,27,68,
2962,654,52,31,83,
2963,624,41,33,74,
2964,654,60,36,96,
2965,644,39,38,77,
2966,666,27,30,57,
2967,587,30,30,60,
2968,594,40,34,74,
2969,618,38,30,68,
2970,658,45,25,70,
2971,681,56,39,95,
2972,625,43,39,82,
2973,599,46,34,80,
2974,651,40,38,78,
2975,606,54,25,79,
2976,622,48,35,83,
2977,621,47,31,78,
2978,646,52,33,85,
2979,630,46,46,92,
2980,601,39,41,80,
2981,605,45,30,75,
2982,649,39,40,79,
2983,590,34,31,65,
2984,599,53,31,84,
2985,618,31,37,68,
2986,608,49,26,75,
2987,601,37,39,76,
2988,621,42,37,79,
2989,689,48,48,96,
2990,606,41,33,74,
2991,618,56,35,91,
2992,617,41,29,70,
2993,631,43,32,75,
2994,593,34,36,70,
2995,635,52,43,95,
2996,614,46,33,79,
2997,608,50,34,84,
2998,604,42,27,69,
2999,597,37,32,69,
3000,622,55,41,96,
3001,632,43,48,91,
3002,561,35,29,64,
3003,622,50,45,95,
3004,605,41,38,79,
3005,616,48,33,81,
3006,620,50,26,76,
3007,574,40,25,65,
3008,675,44,34,78,
3009,601,44,32,76,
3010,622,39,34,73,
3011,613,37,30,67,
3012,633,41,33,74,
3013,639,41,40,81,
3014,633,47,22,69,
3015,652,37,31,68,
3016,610,53,38,91,
3017,650,52,32,84,
3018,630,46,39,85,
3019,602,45,31,76,
3020,561,36,42,78,
3021,589,48,27,75,
3022,592,54,41,95,
3023,630,51,34,85,
3024,629,65,40,105,
3025,697,40,34,74,
3026,613,56,35,91,
3027,617,47,39,86,
3028,647,53,34,87,
3029,669,48,42,90,
3030,599,43,35,78,
3031,621,43,37,80,
3032,619,60,28,88,
3033,637,44,45,89,
3034,585,41,37,78,
3035,625,40,39,79,
3036,607,47,32,79,
3037,617,51,40,91,
3038,579,33,37,70,
3039,600,38,36,74,
3040,648,57,35,92,
3041,576,44,24,68,
3042,648,50,29,79,
3043,603,41,37,78,
3044,618,38,38,76,
3045,615,45,44,89,
3046,655,47,41,88,
3047,585,43,21,64,
3048,573,46,21,67,
3049,591,33,42,75,
3050,682,60,34,94,
3051,627,42,40,82,
3052,646,51,31,82,
3053,622,51,46,97,
3054,657,45,40,85,
3055,606,56,37,93,
3056,679,47,40,87,
3057,609,42,32,74,
3058,644,38,28,66,
3059,660,52,40,92,
3060,604,46,30,76,
3061,630,45,31,76,
3062,599,54,38,92,
3063,617,55,38,93,
3064,565,47,31,78,
3065,656,46,43,89,
3066,648,42,46,88,
3067,622,50,36,86,
3068,642,54,38,92,
3069,636,42,36,78,
3070,608,52,30,82,
3071,614,45,38,83,
3072,616,40,37,77,
3073,613,47,36,83,
3074,647,48,29,77,
3075,665,34,30,64,
3076,646,39,36,75,
3077,569,45,32,77,
3078,598,43,32,75,
3079,595,47,31,78,
3080,652,53,37,90,
3081,644,58,41,99,
3082,620,46,38,84,
3083,586,51,36,87,
3084,617,49,32,81,
3085,640,49,29,78,
3086,621,35,34,69,
3087,613,40,35,75,
3088,628,46,37,83,
3089,639,60,43,103,
3090,555,40,22,62,
3091,630,52,34,86,
3092,624,37,36,73,
3093,595,47,33,80,
3094,623,40,34,74,
3095,620,46,39,85,
3096,612,41,46,87,
3097,662,55,28,83,
3098,596,31,31,62,
3099,585,37,28,65,
3100,583,41,31,72,
3101,609,51,24,75,
3102,616,41,37,78,
3103,623,40,29,69,
3104,621,37,34,71,
3105,623,50,39,89,
3106,622,39,39,78,
3107,598,49,31,80,
3108,601,40,33,73,
3109,620,46,23,69,
3110,679,51,43,94,
3111,621,47,37,84,
3112,633,39,32,71,
3113,623,48,39,87,
3114,630,40,30,70,
3115,628,50,36,86,
3116,616,46,39,85,
3117,610,39,36,75,
3118,652,42,34,76,
3119,683,57,38,95,
3120,554,50,32,82,
3121,587,39,32,71,
3122,680,46,31,77,
3123,623,44,23,67,
3124,651,43,37,80,
3125,631,31,39,70,
3126,657,46,45,91,
3127,621,50,36,86,
3128,605,43,37,80,
3129,606,51,37,88,
3130,603,55,26,81,
3131,627,35,38,73,
3132,597,38,25,63,
3133,654,57,35,92,
3134,666,53,49,102,
3135,647,38,50,88,
3136,583,41,36,77,
3137,619,51,38,89,
3138,591,43,31,74,
3139,589,48,18,66,
3140,608,31,27,58,
3141,566,37,28,65,
3142,620,52,27,79,
3143,570,37,31,68,
3144,629,53,35,88,
3145,588,42,35,77,
3146,612,44,44,88,
3147,639,45,39,84,
3148,532,26,24,50,
3149,651,58,38,96,
3150,628,44,39,83,
3151,607,39,45,84,
3152,606,50,29,79,
3153,561,36,29,65,
3154,623,41,43,84,
3155,614,47,40,87,
3156,631,36,40,76,
3157,606,51,41,92,
3158,594,40,33,73,
3159,660,44,32,76,
3160,611,29,36,65,
3161,652,42,29,71,
3162,664,42,42,84,
3163,608,48,26,74,
3164,658,60,33,93,
3165,686,49,32,81,
3166,628,45,25,70,
3167,572,44,30,74,
3168,592,50,31,81,
3169,643,49,42,91,
3170,638,60,28,88,
3171,640,42,35,77,
3172,638,43,35,78,
3173,608,51,40,91,
3174,624,32,33,65,
3175,630,42,41,83,
3176,640,49,42,91,
3177,641,57,36,93,
3178,675,47,32,79,
3179,620,51,32,83,
3180,600,52,42,94,
3181,603,45,30,75,
3182,597,68,25,93,
3183,581,32,32,64,
3184,602,52,29,81,
3185,612,41,40,81,
3186,641,44,35,79,
3187,652,44,27,71,
3188,649,38,36,74,
3189,606,41,27,68,
3190,647,53,33,86,
3191,574,45,41,86,
3192,578,39,39,78,
3193,623,49,32,81,
3194,604,30,44,74,
3195,609,48,34,82,
3196,578,44,28,72,
3197,628,48,30,78,
3198,603,43,35,78,
3199,612,43,27,70,
3200,656,44,30,74,
3201,629,54,33,87,
3202,596,31,40,71,
3203,656,39,50,89,
3204,658,51,33,84,
3205,608,40,24,64,
3206,614,38,41,79,
3207,599,43,26,69,
3208,600,52,41,93,
3209,605,54,27,81,
3210,616,38,31,69,
3211,618,58,36,94,
3212,594,51,42,93,
3213,656,41,37,78,
3214,613,48,29,77,
3215,603,41,32,73,
3216,623,43,35,78,
3217,629,35,47,82,
3218,602,49,32,81,
3219,573,51,27,78,
3220,622,39,33,72,
3221,651,47,40,87,
3222,624,54,35,89,
3223,650,57,32,89,
3224,641,46,50,96,
3225,636,43,30,73,
3226,636,53,39,92,
3227,596,40,30,70,
3228,633,45,29,74,
3229,596,38,36,74,
3230,579,52,33,85,
3231,628,38,33,71,
3232,604,36,35,71,
3233,607,38,34,72,
3234,608,41,24,65,
3235,633,44,28,72,
3236,613,31,34,65,
3237,672,42,36,78,
3238,616,50,38,88,
3239,648,64,37,101,
3240,619,38,49,87,
3241,611,49,36,85,
3242,631,55,35,90,
3243,627,43,42,85,
3244,583,48,33,81,
3245,609,34,37,71,
3246,614,46,26,72,
3247,701,55,47,102,
3248,616,40,37,77,
3249,628,46,31,77,
3250,590,46,33,79,
3251,634,51,43,94,
3252,651,40,38,78,
3253,608,50,33,83,
3254,640,53,33,86,
3255,638,47,51,98,
3256,610,44,35,79,
3257,648,47,44,91,
3258,618,45,34,79,
3259,641,43,39,82,
3260,650,52,38,90,
3261,571,40,29,69,
3262,594,36,35,71,
3263,630,44,27,71,
3264,609,40,29,69,
3265,574,22,33,55,
3266,641,53,41,94,
3267,644,43,37,80,
3268,585,41,32,73,
3269,610,43,35,78,
3270,569,32,27,59,
3271,610,47,37,84,
3272,611,44,39,83,
3273,615,43,31,74,
3274,581,37,30,67,
3275,604,38,39,77,
3276,636,38,38,76,
3277,608,51,28,79,
3278,661,49,36,85,
3279,612,47,43,90,
3280,589,47,37,84,
3281,617,40,56,96,
3282,619,48,40,88,
3283,597,41,32,73,
3284,564,39,35,74,
3285,614,41,27,68,
3286,572,45,29,74,
3287,685,66,49,115,
3288,681,59,48,107,
3289,631,47,33,80,
3290,607,41,35,76,
3291,624,35,37,72,
3292,647,36,50,86,
3293,617,41,40,81,
3294,623,46,44,90,
3295,619,36,41,77,
3296,576,47,30,77,
3297,632,44,32,76,
3298,590,46,39,85,
3299,614,31,41,72,
3300,618,39,32,71,
3301,604,39,37,76,
3302,609,44,21,65,
3303,631,37,32,69,
3304,606,43,34,77,
3305,628,44,33,77,
3306,618,56,40,96,
3307,661,48,40,88,
3308,566,35,33,68,
3309,635,54,41,95,
3310,627,34,38,72,
3311,612,50,40,90,
3312,613,56,35,91,
3313,641,49,19,68,
3314,550,40,27,67,
3315,625,41,39,80,
3316,699,42,32,74,
3317,569,44,34,78,
3318,564,41,33,74,
3319,647,42,37,79,
3320,637,37,39,76,
3321,627,66,32,98,
3322,630,43,47,90,
3323,646,49,43,92,
3324,623,46,39,85,
3325,595,50,36,86,
3326,639,47,33,80,
3327,631,49,31,80,
3328,643,44,31,75,
3329,647,33,34,67,
3330,620,61,29,90,
3331,614,42,38,80,
3332,593,52,37,89,
3333,628,37,37,74,
3334,580,48,32,80,
3335,619,51,33,84,
3336,603,57,31,88,
3337,635,44,28,72,
3338,621,43,36,79,
3339,607,44,42,86,
3340,629,40,28,68,
3341,661,31,41,72,
3342,586,37,26,63,
3343,659,53,42,95,
3344,607,44,42,86,
3345,614,50,48,98,
3346,605,39,34,73,
3347,619,37,44,81,
3348,591,50,36,86,
3349,614,28,50,78,
3350,651,53,45,98,
3351,646,42,36,78,
3352,638,63,37,100,
3353,640,46,33,79,
3354,598,43,30,73,
3355,616,41,41,82,
3356,649,50,38,88,
3357,613,48,34,82,
3358,652,46,43,89,
3359,629,50,28,78,
3360,621,48,23,71,
3361,649,42,39,81,
3362,628,36,46,82,
3363,617,46,30,76,
3364,633,37,37,74,
3365,577,43,27,70,
3366,598,46,29,75,
3367,611,32,38,70,
3368,633,36,48,84,
3369,602,51,28,79,
3370,634,43,38,81,
3371,610,46,37,83,
3372,614,45,28,73,
3373,635,38,31,69,
3374,602,46,33,79,
3375,637,52,37,89,
3376,620,48,30,78,
3377,587,32,39,71,
3378,587,40,24,64,
3379,561,38,26,64,
3380,597,34,38,72,
3381,607,46,54,100,
3382,632,54,46,100,
3383,591,43,26,69,
3384,633,47,30,77,
3385,605,38,34,72,
3386,612,38,34,72,
3387,623,53,39,92,
3388,630,49,31,80,
3389,646,44,41,85,
3390,570,51,30,81,
3391,635,46,39,85,
3392,571,39,31,70,
3393,596,36,33,69,
3394,631,50,36,86,
3395,674,41,39,80,
3396,617,41,44,85,
3397,652,49,34,83,
3398,663,57,40,97,
3399,593,50,38,88,
3400,591,48,36,84,
3401,582,47,35,82,
3402,592,48,24,72,
3403,596,33,33,66,
3404,601,43,35,78,
3405,570,43,33,76,
3406,616,48,39,87,
3407,573,48,30,78,
3408,597,37,33,70,
3409,620,55,23,78,
3410,584,32,23,55,
3411,605,57,34,91,
3412,571,38,30,68,
3413,621,39,36,75,
3414,604,53,28,81,
3415,604,38,37,75,
3416,654,44,37,81,
3417,671,50,47,97,
3418,641,45,33,78,
3419,603,44,30,74,
3420,634,42,45,87,
3421,599,30,44,74,
3422,601,43,42,85,
3423,605,48,31,79,
3424,557,39,37,76,
3425,634,52,24,76,
3426,620,34,39,73,
3427,598,50,43,93,
3428,622,45,35,80,
3429,624,53,35,88,
3430,566,26,29,55,
3431,592,41,36,77,
3432,608,41,29,70,
3433,643,45,32,77,
3434,625,39,28,67,
3435,663,62,40,102,
3436,587,41,33,74,
3437,631,42,39,81,
3438,610,39,41,80,
3439,602,35,39,74,
3440,588,44,33,77,
3441,641,43,43,86,
3442,625,32,32,64,
3443,599,35,29,64,
3444,590,33,34,67,
3445,612,42,36,78,
3446,634,33,38,71,
3447,641,58,32,90,
3448,562,39,30,69,
3449,665,48,44,92,
3450,606,51,38,89,
3451,614,54,33,87,
3452,646,59,33,92,
3453,655,59,31,90,
3454,595,34,37,71,
3455,631,47,26,73,
3456,605,40,29,69,
3457,631,47,31,78,
3458,577,47,29,76,
3459,626,43,43,86,
3460,593,32,25,57,
3461,614,52,25,77,
3462,625,41,38,79,
3463,607,46,27,73,
3464,611,54,38,92,
3465,640,47,34,81,
3466,580,40,33,73,
3467,582,42,29,71,
3468,584,38,33,71,
3469,635,35,27,62,
3470,627,36,40,76,
3471,654,53,33,86,
3472,634,36,35,71,
3473,600,49,24,73,
3474,623,43,32,75,
3475,575,38,33,71,
3476,642,50,33,83,
3477,625,37,40,77,
3478,609,40,38,78,
3479,646,41,43,84,
3480,603,46,34,80,
3481,620,36,38,74,
3482,617,45,33,78,
3483,603,46,31,77,
3484,627,52,27,79,
3485,628,46,41,87,
3486,642,38,33,71,
3487,586,39,27,66,
3488,604,47,38,85,
3489,622,51,37,88,
3490,656,52,39,91,
3491,659,50,45,95,
3492,654,43,41,84,
3493,608,52,37,89,
3494,633,35,43,78,
3495,637,44,46,90,
3496,589,40,40,80,
3497,599,45,30,75,
3498,625,51,36,87,
3499,634,46,41,87,
3500,607,36,36,72,
3501,637,56,36,92,
3502,652,58,48,106,
3503,617,45,31,76,
3504,634,50,35,85,
3505,610,52,38,90,
3506,597,39,30,69,
3507,618,43,34,77,
3508,588,43,37,80,
3509,596,39,34,73,
3510,637,46,36,82,
3511,601,45,21,66,
3512,613,36,38,74,
3513,639,43,40,83,
3514,590,34,35,69,
3515,623,41,31,72,
3516,615,52,32,84,
3517,571,27,26,53,
3518,611,52,34,86,
3519,633,45,46,91,
3520,650,53,41,94,
3521,673,46,49,95,
3522,635,51,36,87,
3523,612,44,31,75,
3524,603,49,34,83,
3525,605,43,32,75,
3526,647,41,44,85,
3527,597,40,36,76,
3528,611,49,33,82,
3529,625,52,33,85,
3530,656,43,39,82,
3531,603,49,33,82,
3532,670,42,30,72,
3533,586,34,40,74,
3534,609,55,40,95,
3535,591,44,27,71,
3536,667,47,44,91,
3537,665,52,38,90,
3538,563,39,29,68,
3539,578,37,30,67,
3540,593,48,36,84,
3541,606,33,38,71,
3542,609,49,34,83,
3543,672,47,41,88,
3544,661,40,32,72,
3545,626,36,44,80,
3546,635,40,32,72,
3547,609,42,24,66,
3548,588,36,34,70,
3549,623,38,40,78,
3550,638,37,37,74,
3551,630,51,36,87,
3552,602,35,28,63,
3553,626,46,34,80,
3554,636,48,40,88,
3555,605,45,33,78,
3556,636,47,35,82,
3557,618,52,40,92,
3558,591,38,31,69,
3559,613,49,48,97,
3560,673,50,31,81,
3561,567,47,30,77,
3562,657,53,40,93,
3563,604,47,30,77,
3564,601,39,32,71,
3565,634,50,33,83,
3566,620,34,35,69,
3567,616,41,44,85,
3568,627,44,32,76,
3569,653,38,35,73,
3570,598,57,31,88,
3571,656,49,33,82,
3572,600,37,30,67,
3573,616,54,33,87,
3574,649,45,40,85,
3575,599,44,39,83,
3576,618,46,38,84,
3577,675,52,40,92,
3578,608,37,29,66,
3579,581,26,39,65,
3580,640,46,33,79,
3581,610,42,36,78,
3582,581,41,23,64,
3583,619,44,26,70,
3584,631,38,38,76,
3585,618,46,32,78,
3586,636,53,39,92,
3587,655,44,34,78,
3588,553,43,44,87,
3589,643,36,30,66,
3590,645,56,39,95,
3591,544,41,32,73,
3592,604,51,31,82,
3593,620,55,30,85,
3594,578,40,31,71,
3595,589,48,30,78,
3596,606,45,31,76,
3597,665,45,39,84,
3598,615,48,39,87,
3599,611,48,31,79,
3600,616,45,35,80,
3601,659,43,36,79,
3602,650,44,55,99,
3603,630,55,39,94,
3604,634,43,35,78,
3605,614,42,38,80,
3606,566,37,30,67,
3607,669,37,42,79,
3608,623,39,37,76,
3609,613,46,37,83,
3610,640,37,28,65,
3611,630,45,26,71,
3612,595,39,33,72,
3613,603,48,31,79,
3614,637,47,44,91,
3615,681,59,48,107,
3616,601,48,32,80,
3617,624,47,37,84,
3618,620,51,37,88,
3619,606,41,36,77,
3620,595,45,37,82,
3621,681,53,45,98,
3622,644,56,40,96,
3623,605,45,28,73,
3624,638,44,37,81,
3625,653,34,33,67,
3626,630,47,40,87,
3627,643,52,40,92,
3628,644,45,46,91,
3629,578,43,26,69,
3630,700,54,33,87,
3631,624,46,32,78,
3632,553,46,36,82,
3633,667,31,52,83,
3634,635,43,31,74,
3635,602,47,25,72,
3636,633,45,42,87,
3637,623,44,38,82,
3638,605,34,29,63,
3639,658,40,48,88,
3640,694,41,47,88,
3641,664,45,47,92,
3642,611,38,25,63,
3643,618,46,35,81,
3644,635,52,22,74,
3645,631,45,37,82,
3646,623,50,33,83,
3647,617,38,39,77,
3648,592,33,46,79,
3649,606,36,36,72,
3650,648,50,39,89,
3651,677,52,40,92,
3652,589,39,29,68,
3653,573,48,37,85,
3654,639,38,23,61,
3655,609,38,40,78,
3656,627,48,35,83,
3657,628,38,42,80,
3658,651,48,29,77,
3659,647,52,27,79,
3660,630,44,41,85,
3661,583,41,44,85,
3662,597,52,38,90,
3663,582,45,39,84,
3664,561,44,32,76,
3665,628,41,37,78,
3666,609,43,29,72,
3667,638,41,49,90,
3668,613,39,25,64,
3669,601,38,31,69,
3670,605,47,36,83,
3671,628,50,41,91,
3672,618,53,35,88,
3673,640,43,34,77,
3674,625,48,49,97,
3675,614,42,32,74,
3676,606,42,40,82,
3677,631,53,27,80,
3678,648,59,40,99,
3679,633,48,39,87,
3680,588,42,35,77,
3681,670,50,35,85,
3682,631,43,46,89,
3683,650,54,35,89,
3684,657,54,37,91,
3685,616,45,29,74,
3686,632,41,40,81,
3687,605,52,43,95,
3688,597,51,26,77,
3689,654,52,36,88,
3690,609,37,31,68,
3691,632,45,40,85,
3692,603,58,31,89,
3693,612,36,38,74,
3694,650,51,26,77,
3695,640,44,32,76,
3696,591,51,36,87,
3697,639,52,33,85,
3698,601,40,34,74,
3699,609,44,32,76,
3700,613,47,29,76,
3701,661,49,39,88,
3702,579,30,34,64,
3703,592,28,34,62,
3704,634,54,36,90,
3705,642,45,37,82,
3706,655,51,40,91,
3707,633,51,39,90,
3708,678,54,45,99,
3709,623,47,30,77,
3710,636,38,36,74,
3711,649,40,29,69,
3712,642,43,47,90,
3713,661,52,36,88,
3714,652,43,31,74,
3715,641,52,37,89,
3716,614,44,31,75,
3717,595,43,32,75,
3718,636,36,27,63,
3719,639,39,42,81,
3720,601,44,34,78,
3721,652,37,25,62,
3722,635,45,41,86,
3723,620,48,43,91,
3724,589,45,31,76,
3725,645,53,46,99,
3726,642,46,31,77,
3727,636,54,38,92,
3728,590,47,32,79,
3729,643,40,34,74,
3730,627,55,42,97,
3731,608,45,34,79,
3732,661,59,27,86,
3733,589,44,40,84,
3734,623,48,40,88,
3735,621,46,31,77,
3736,643,34,44,78,
3737,664,59,36,95,
3738,603,36,32,68,
3739,627,55,33,88,
3740,608,44,48,92,
3741,605,36,33,69,
3742,568,38,37,75,
3743,642,36,32,68,
3744,623,47,34,81,
3745,621,47,34,81,
3746,634,55,40,95,
3747,603,40,38,78,
3748,607,50,32,82,
3749,664,55,41,96,
3750,618,42,39,81,
3751,614,33,38,71,
3752,658,51,33,84,
3753,597,46,32,78,
3754,619,44,34,78,
3755,616,51,41,92,
3756,589,50,33,83,
3757,571,33,28,61,
3758,597,44,24,68,
3759,648,43,39,82,
3760,576,31,30,61,
3761,618,32,47,79,
3762,644,50,30,80,
3763,657,35,43,78,
3764,645,47,36,83,
3765,620,50,41,91,
3766,617,54,37,91,
3767,590,39,37,76,
3768,596,34,30,64,
3769,666,42,31,73,
3770,659,45,40,85,
3771,618,55,26,81,
3772,639,47,46,93,
3773,594,43,33,76,
3774,592,43,35,78,
3775,628,46,33,79,
3776,652,54,41,95,
3777,636,45,35,80,
3778,606,39,42,81,
3779,684,54,32,86,
3780,608,37,39,76,
3781,597,49,25,74,
3782,610,50,34,84,
3783,679,40,32,72,
3784,625,42,41,83,
3785,668,54,33,87,
3786,648,37,31,68,
3787,623,37,36,73,
3788,601,45,24,69,
3789,631,38,32,70,
3790,558,43,31,74,
3791,614,46,40,86,
3792,567,36,33,69,
3793,629,48,38,86,
3794,618,43,36,79,
3795,637,49,38,87,
3796,592,45,30,75,
3797,653,39,36,75,
3798,649,48,35,83,
3799,613,44,39,83,
3800,625,42,34,76,
3801,619,40,21,61,
3802,651,43,41,84,
3803,643,46,39,85,
3804,610,46,36,82,
3805,666,48,44,92,
3806,585,36,35,71,
3807,614,47,44,91,
3808,661,45,34,79,
3809,617,46,48,94,
3810,606,49,30,79,
3811,603,44,31,75,
3812,686,50,36,86,
3813,601,34,33,67,
3814,638,50,27,77,
3815,567,36,28,64,
3816,578,42,28,70,
3817,640,48,37,85,
3818,590,44,31,75,
3819,602,44,29,73,
3820,606,39,31,70,
3821,587,56,32,88,
3822,625,53,31,84,
3823,629,49,33,82,
3824,597,43,24,67,
3825,606,47,38,85,
3826,596,41,33,74,
3827,573,50,34,84,
3828,605,47,33,80,
3829,595,52,36,88,
3830,640,46,38,84,
3831,604,31,34,65,
3832,651,56,35,91,
3833,614,45,26,71,
3834,602,41,32,73,
3835,614,39,36,75,
3836,579,39,29,68,
3837,620,37,38,75,
3838,578,47,27,74,
3839,574,44,28,72,
3840,667,46,32,78,
3841,646,39,39,78,
3842,613,58,33,91,
3843,594,47,35,82,
3844,607,44,32,76,
3845,588,37,31,68,
3846,613,59,29,88,
3847,645,47,34,81,
3848,639,31,30,61,
3849,665,50,31,81,
3850,619,45,37,82,
3851,581,48,31,79,
3852,621,45,32,77,
3853,620,40,33,73,
3854,583,36,39,75,
3855,669,45,30,75,
3856,622,39,30,69,
3857,627,45,28,73,
3858,639,49,28,77,
3859,590,43,24,67,
3860,674,49,42,91,
3861,659,48,36,84,
3862,613,45,20,65,
3863,663,37,38,75,
3864,608,47,30,77,
3865,573,60,21,81,
3866,628,35,30,65,
3867,659,46,36,82,
3868,604,40,23,63,
3869,638,45,34,79,
3870,637,48,31,79,
3871,618,43,37,80,
3872,585,35,45,80,
3873,644,33,36,69,
3874,617,33,36,69,
3875,632,47,27,74,
3876,606,55,31,86,
3877,608,45,35,80,
3878,614,55,26,81,
3879,654,35,34,69,
3880,608,46,35,81,
3881,639,44,47,91,
3882,658,42,43,85,
3883,623,40,29,69,
3884,581,43,37,80,
3885,655,53,33,86,
3886,612,42,23,65,
3887,617,43,33,76,
3888,667,52,45,97,
3889,601,38,37,75,
3890,635,52,32,84,
3891,608,35,29,64,
3892,584,49,40,89,
3893,628,54,28,82,
3894,623,54,43,97,
3895,636,42,45,87,
3896,597,47,32,79,
3897,641,39,32,71,
3898,617,44,38,82,
3899,619,44,49,93,
3900,615,41,28,69,
3901,607,42,39,81,
3902,619,50,36,86,
3903,614,45,29,74,
3904,586,42,36,78,
3905,598,43,43,86,
3906,659,43,45,88,
3907,603,48,31,79,
3908,626,54,27,81,
3909,603,35,40,75,
3910,632,42,37,79,
3911,566,42,30,72,
3912,605,53,28,81,
3913,593,41,23,64,
3914,619,51,43,94,
3915,603,43,32,75,
3916,632,47,39,86,
3917,602,41,30,71,
3918,573,46,32,78,
3919,618,51,36,87,
3920,649,37,41,78,
3921,638,34,50,84,
3922,623,34,37,71,
3923,613,54,36,90,
3924,612,46,44,90,
3925,590,47,40,87,
3926,655,48,38,86,
3927,649,41,47,88,
3928,621,42,33,75,
3929,620,51,36,87,
3930,618,41,38,79,
3931,646,52,45,97,
3932,626,41,43,84,
3933,587,45,36,81,
3934,597,41,37,78,
3935,612,37,37,74,
3936,638,50,34,84,
3937,600,58,33,91,
3938,631,45,40,85,
3939,610,51,33,84,
3940,611,42,43,85,
3941,648,45,42,87,
3942,615,47,30,77,
3943,595,46,25,71,
3944,605,35,40,75,
3945,584,53,36,89,
3946,606,38,43,81,
3947,649,42,39,81,
3948,580,39,16,55,
3949,625,58,38,96,
3950,584,47,26,73,
3951,656,57,36,93,
3952,658,48,41,89,
3953,597,38,31,69,
3954,598,42,37,79,
3955,618,42,39,81,
3956,589,39,26,65,
3957,627,49,38,87,
3958,606,45,29,74,
3959,627,40,38,78,
3960,657,38,34,72,
3961,641,31,35,66,
3962,565,41,24,65,
3963,610,36,31,67,
3964,603,36,41,77,
3965,613,49,37,86,
3966,633,66,37,103,
3967,602,38,30,68,
3968,642,43,33,76,
3969,633,38,45,83,
3970,646,40,33,73,
3971,606,48,33,81,
3972,633,41,46,87,
3973,619,38,26,64,
3974,675,53,49,102,
3975,683,44,28,72,
3976,627,39,33,72,
3977,603,46,34,80,
3978,595,44,30,74,
3979,687,51,37,88,
3980,635,40,53,93,
3981,649,57,37,94,
3982,640,49,45,94,
3983,588,46,39,85,
3984,605,42,36,78,
3985,679,37,33,70,
3986,654,55,38,93,
3987,624,47,32,79,
3988,696,49,37,86,
3989,625,62,41,103,
3990,635,45,39,84,
3991,593,56,32,88,
3992,579,32,32,64,
3993,613,44,35,79,
3994,588,43,29,72,
3995,594,57,40,97,
3996,609,36,26,62,
3997,617,51,37,88,
3998,653,45,32,77,
3999,591,53,35,88,
4000,574,37,35,72,
4001,618,43,41,84,
4002,575,36,35,71,
4003,645,46,34,80,
4004,650,50,34,84,
4005,616,58,36,94,
4006,638,46,40,86,
4007,636,49,31,80,
4008,594,43,41,84,
4009,572,40,41,81,
4010,624,42,43,85,
4011,612,49,29,78,
4012,613,45,45,90,
4013,614,40,29,69,
4014,652,47,34,81,
4015,660,40,43,83,
4016,617,45,34,79,
4017,623,60,35,95,
4018,589,47,27,74,
4019,619,57,35,92,
4020,596,45,23,68,
4021,645,41,51,92,
4022,624,41,31,72,
4023,634,43,36,79,
4024,597,29,40,69,
4025,573,39,35,74,
4026,664,38,44,82,
4027,631,38,31,69,
4028,590,49,39,88,
4029,617,40,37,77,
4030,593,43,31,74,
4031,625,42,33,75,
4032,574,48,27,75,
4033,646,37,44,81,
4034,614,42,35,77,
4035,644,48,32,80,
4036,641,37,42,79,
4037,647,57,36,93,
4038,603,55,38,93,
4039,641,47,36,83,
4040,583,44,33,77,
4041,622,49,42,91,
4042,586,40,38,78,
4043,589,38,36,74,
4044,571,40,33,73,
4045,584,38,28,66,
4046,626,39,41,80,
4047,628,44,43,87,
4048,648,44,36,80,
4049,642,51,39,90,
4050,591,35,30,65,
4051,601,34,33,67,
4052,619,43,41,84,
4053,602,52,34,86,
4054,622,39,37,76,
4055,621,56,32,88,
4056,537,36,35,71,
4057,605,41,35,76,
4058,596,35,30,65,
4059,639,39,32,71,
4060,629,56,42,98,
4061,623,43,30,73,
4062,649,48,38,86,
4063,592,47,24,71,
4064,629,43,40,83,
4065,627,50,38,88,
4066,642,44,37,81,
4067,642,45,42,87,
4068,611,42,40,82,
4069,625,43,35,78,
4070,654,41,45,86,
4071,633,42,33,75,
4072,645,50,36,86,
4073,691,54,42,96,
4074,605,48,38,86,
4075,590,49,40,89,
4076,628,53,28,81,
4077,616,48,37,85,
4078,614,43,31,74,
4079,581,36,37,73,
4080,656,37,50,87,
4081,624,41,32,73,
4082,623,54,44,98,
4083,600,32,30,62,
4084,636,41,34,75,
4085,579,42,30,72,
4086,620,50,36,86,
4087,652,48,30,78,
4088,648,46,38,84,
4089,609,57,35,92,
4090,617,43,24,67,
4091,634,38,52,90,
4092,646,45,50,95,
4093,652,63,35,98,
4094,619,45,46,91,
4095,654,52,28,80,
4096,630,52,38,90,
4097,631,49,38,87,
4098,679,48,37,85,
4099,647,44,40,84,
4100,602,47,34,81,
4101,615,39,38,77,
4102,628,38,45,83,
4103,626,44,30,74,
4104,628,42,35,77,
4105,631,40,42,82,
4106,638,37,42,79,
4107,599,52,30,82,
4108,611,41,38,79,
4109,616,44,45,89,
4110,593,38,31,69,
4111,691,57,40,97,
4112,620,49,32,81,
4113,621,40,38,78,
4114,606,38,45,83,
4115,623,28,34,62,
4116,570,32,41,73,
4117,646,34,35,69,
4118,615,40,39,79,
4119,664,58,35,93,
4120,627,48,33,81,
4121,686,65,33,98,
4122,596,36,42,78,
4123,609,54,43,97,
4124,656,59,46,105,
4125,594,45,32,77,
4126,606,39,28,67,
4127,626,47,38,85,
4128,647,51,26,77,
4129,581,53,34,87,
4130,629,43,36,79,
4131,615,47,35,82,
4132,638,51,54,105,
4133,652,49,33,82,
4134,563,40,34,74,
4135,585,49,36,85,
4136,634,46,35,81,
4137,663,54,27,81,
4138,613,38,26,64,
4139,658,42,37,79,
4140,623,45,47,92,
4141,605,43,40,83,
4142,593,45,35,80,
4143,662,39,35,74,
4144,608,38,38,76,
4145,589,36,18,54,
4146,578,42,32,74,
4147,617,55,39,94,
4148,578,57,29,86,
4149,612,54,34,88,
4150,630,42,27,69,
4151,632,64,27,91,
4152,629,56,32,88,
4153,620,50,40,90,
4154,627,47,34,81,
4155,633,42,28,70,
4156,615,48,39,87,
4157,619,56,30,86,
4158,626,44,35,79,
4159,595,38,32,70,
4160,631,50,37,87,
4161,588,39,31,70,
4162,630,49,35,84,
4163,636,44,46,90,
4164,607,50,30,80,
4165,600,45,27,72,
4166,625,39,35,74,
4167,604,36,45,81,
4168,603,42,28,70,
4169,642,46,45,91,
4170,632,52,34,86,
4171,615,43,29,72,
4172,632,49,34,83,
4173,627,43,34,77,
4174,629,35,32,67,
4175,616,43,36,79,
4176,642,48,39,87,
4177,622,51,18,69,
4178,596,37,34,71,
4179,633,40,43,83,
4180,640,33,42,75,
4181,640,45,27,72,
4182,592,44,39,83,
4183,623,41,31,72,
4184,599,43,37,80,
4185,620,52,41,93,
4186,641,58,31,89,
4187,632,48,37,85,
4188,630,55,48,103,
4189,633,42,30,72,
4190,605,42,23,65,
4191,609,58,28,86,
4192,626,46,22,68,
4193,637,43,28,71,
4194,596,43,28,71,
4195,618,39,39,78,
4196,647,49,32,81,
4197,647,47,43,90,
4198,634,50,41,91,
4199,613,46,31,77,
4200,637,36,26,62,
4201,615,37,33,70,
4202,603,45,30,75,
4203,595,34,40,74,
4204,609,41,29,70,
4205,592,36,33,69,
4206,624,49,37,86,
4207,615,53,30,83,
4208,637,42,44,86,
4209,635,50,42,92,
4210,603,45,36,81,
4211,634,48,32,80,
4212,599,41,29,70,
4213,569,43,31,74,
4214,608,53,40,93,
4215,666,43,32,75,
4216,629,47,29,76,
4217,641,41,34,75,
4218,629,42,31,73,
4219,609,62,34,96,
4220,644,41,36,77,
4221,543,41,28,69,
4222,673,54,41,95,
4223,578,48,34,82,
4224,610,54,37,91,
4225,613,46,35,81,
4226,617,42,32,74,
4227,583,48,31,79,
4228,597,46,32,78,
4229,620,39,28,67,
4230,666,48,44,92,
4231,603,60,29,89,
4232,643,45,38,83,
4233,616,54,32,86,
4234,597,45,32,77,
4235,638,52,30,82,
4236,581,43,46,89,
4237,575,37,36,73,
4238,639,49,34,83,
4239,592,39,36,75,
4240,677,48,21,69,
4241,617,41,41,82,
4242,596,44,35,79,
4243,599,40,43,83,
4244,645,55,35,90,
4245,602,43,35,78,
4246,615,42,31,73,
4247,625,47,38,85,
4248,597,46,41,87,
4249,595,42,34,76,
4250,620,48,32,80,
4251,578,43,30,73,
4252,680,42,32,74,
4253,636,54,38,92,
4254,646,41,44,85,
4255,607,41,29,70,
4256,587,42,32,74,
4257,630,48,37,85,
4258,632,36,27,63,
4259,618,44,33,77,
4260,625,45,39,84,
4261,604,48,29,77,
4262,638,58,37,95,
4263,667,53,44,97,
4264,626,46,44,90,
4265,621,49,38,87,
4266,614,48,26,74,
4267,584,47,48,95,
4268,606,32,31,63,
4269,617,39,35,74,
4270,632,38,42,80,
4271,637,46,35,81,
4272,601,37,39,76,
4273,574,43,25,68,
4274,632,63,31,94,
4275,567,53,30,83,
4276,639,46,47,93,
4277,597,58,46,104,
4278,654,51,44,95,
4279,598,31,36,67,
4280,625,50,34,84,
4281,615,47,35,82,
4282,599,42,39,81,
4283,590,32,33,65,
4284,590,49,34,83,
4285,590,51,34,85,
4286,608,43,39,82,
4287,640,42,33,75,
4288,631,47,30,77,
4289,586,42,33,75,
4290,650,42,47,89,
4291,623,45,31,76,
4292,610,62,32,94,
4293,555,41,34,75,
4294,624,35,30,65,
4295,561,42,28,70,
4296,593,45,39,84,
4297,596,55,33,88,
4298,610,47,40,87,
4299,585,32,25,57,
4300,592,49,34,83,
4301,602,46,23,69,
4302,647,41,45,86,
4303,572,41,34,75,
4304,589,43,42,85,
4305,597,48,33,81,
4306,639,37,32,69,
4307,601,41,32,73,
4308,597,35,37,72,
4309,641,46,36,82,
4310,641,57,36,93,
4311,601,55,20,75,
4312,613,39,32,71,
4313,617,42,43,85,
4314,588,35,37,72,
4315,616,35,51,86,
4316,642,37,44,81,
4317,621,47,33,80,
4318,631,42,32,74,
4319,581,48,37,85,
4320,597,35,38,73,
4321,648,54,31,85,
4322,614,45,36,81,
4323,640,55,35,90,
4324,618,57,33,90,
4325,636,51,35,86,
4326,583,40,37,77,
4327,611,41,33,74,
4328,605,54,28,82,
4329,659,48,32,80,
4330,688,47,43,90,
4331,653,50,31,81,
4332,654,47,30,77,
4333,666,55,46,101,
4334,645,55,42,97,
4335,617,45,37,82,
4336,635,54,36,90,
4337,685,44,40,84,
4338,652,43,32,75,
4339,638,37,30,67,
4340,637,40,42,82,
4341,635,53,24,77,
4342,567,37,30,67,
4343,601,39,27,66,
4344,644,47,34,81,
4345,604,49,38,87,
4346,662,41,37,78,
4347,615,36,34,70,
4348,620,37,34,71,
4349,625,48,39,87,
4350,604,47,29,76,
4351,609,44,43,87,
4352,594,47,38,85,
4353,615,47,33,80,
4354,551,34,39,73,
4355,593,43,28,71,
4356,596,45,44,89,
4357,590,51,27,78,
4358,641,34,37,71,
4359,620,49,43,92,
4360,624,49,34,83,
4361,617,46,46,92,
4362,574,42,40,82,
4363,581,47,37,84,
4364,623,51,46,97,
4365,672,48,43,91,
4366,639,50,32,82,
4367,582,39,36,75,
4368,621,54,37,91,
4369,655,58,44,102,
4370,643,47,34,81,
4371,646,49,42,91,
4372,599,47,32,79,
4373,549,44,27,71,
4374,596,47,27,74,
4375,603,42,29,71,
4376,588,36,38,74,
4377,629,47,35,82,
4378,633,43,24,67,
4379,615,45,36,81,
4380,642,35,42,77,
4381,643,43,38,81,
4382,611,52,44,96,
4383,623,47,38,85,
4384,585,41,29,70,
4385,635,49,36,85,
4386,604,48,37,85,
4387,637,45,41,86,
4388,606,39,29,68,
4389,648,46,40,86,
4390,606,47,46,93,
4391,573,42,40,82,
4392,655,54,37,91,
4393,625,36,41,77,
4394,649,41,30,71,
4395,573,42,31,73,
4396,651,34,36,70,
4397,607,46,33,79,
4398,677,52,35,87,
4399,673,43,34,77,
4400,621,42,34,76,
4401,609,42,33,75,
4402,594,43,38,81,
4403,629,46,34,80,
4404,664,43,36,79,
4405,605,47,34,81,
4406,560,38,37,75,
4407,656,55,36,91,
4408,612,47,31,78,
4409,635,44,39,83,
4410,635,42,47,89,
4411,575,44,31,75,
4412,611,43,36,79,
4413,609,39,34,73,
4414,613,43,35,78,
4415,624,36,29,65,
4416,618,40,38,78,
4417,656,38,37,75,
4418,613,50,39,89,
4419,604,48,29,77,
4420,614,32,38,70,
4421,609,48,34,82,
4422,607,39,40,79,
4423,622,46,30,76,
4424,614,43,37,80,
4425,623,44,35,79,
4426,630,49,37,86,
4427,630,53,42,95,
4428,555,47,22,69,
4429,603,47,34,81,
4430,654,57,45,102,
4431,596,34,40,74,
4432,559,30,39,69,
4433,586,43,28,71,
4434,608,38,35,73,
4435,635,42,48,90,
4436,604,38,33,71,
4437,633,46,41,87,
4438,588,47,25,72,
4439,602,31,38,69,
4440,610,44,34,78,
4441,604,46,35,81,
4442,683,61,38,99,
4443,689,52,52,104,
4444,649,48,38,86,
4445,691,49,45,94,
4446,606,38,32,70,
4447,599,49,34,83,
4448,603,42,38,80,
4449,640,52,38,90,
4450,615,55,38,93,
4451,583,38,23,61,
4452,616,44,38,82,
4453,594,40,25,65,
4454,648,47,31,78,
4455,609,47,22,69,
4456,633,38,34,72,
4457,606,48,30,78,
4458,670,44,34,78,
4459,608,38,36,74,
4460,665,54,41,95,
4461,630,54,36,90,
4462,624,34,27,61,
4463,608,45,41,86,
4464,638,43,36,79,
4465,612,44,48,92,
4466,662,40,37,77,
4467,599,43,29,72,
4468,582,32,26,58,
4469,635,54,35,89,
4470,650,59,42,101,
4471,612,36,39,75,
4472,614,40,37,77,
4473,653,51,38,89,
4474,634,45,32,77,
4475,589,41,41,82,
4476,587,54,28,82,
4477,607,38,34,72,
4478,597,43,31,74,
4479,608,40,38,78,
4480,593,39,39,78,
4481,633,50,36,86,
4482,634,39,35,74,
4483,598,40,41,81,
4484,615,37,38,75,
4485,633,61,35,96,
4486,612,50,32,82,
4487,659,42,37,79,
4488,615,39,41,80,
4489,587,43,31,74,
4490,582,44,40,84,
4491,582,32,40,72,
4492,626,44,28,72,
4493,589,34,35,69,
4494,590,41,35,76,
4495,642,48,36,84,
4496,622,39,32,71,
4497,578,38,42,80,
4498,608,46,35,81,
4499,546,53,35,88,
4500,638,46,46,92,
4501,666,42,41,83,
4502,622,37,27,64,
4503,592,48,30,78,
4504,665,48,46,94,
4505,602,45,32,77,
4506,616,42,44,86,
4507,614,44,27,71,
4508,589,40,41,81,
4509,609,43,34,77,
4510,570,47,39,86,
4511,573,42,33,75,
4512,623,48,39,87,
4513,601,60,36,96,
4514,629,45,30,75,
4515,619,43,37,80,
4516,596,39,26,65,
4517,616,41,41,82,
4518,616,51,42,93,
4519,651,50,28,78,
4520,566,44,30,74,
4521,579,43,31,74,
4522,664,42,45,87,
4523,616,51,41,92,
4524,650,50,36,86,
4525,618,42,28,70,
4526,640,59,47,106,
4527,612,41,35,76,
4528,635,41,31,72,
4529,606,45,40,85,
4530,611,44,22,66,
4531,606,50,46,96,
4532,629,49,35,84,
4533,713,50,52,102,
4534,634,37,32,69,
4535,612,48,40,88,
4536,622,40,41,81,
4537,586,54,33,87,
4538,642,44,35,79,
4539,620,56,38,94,
4540,586,44,38,82,
4541,592,44,32,76,
4542,626,46,40,86,
4543,572,46,31,77,
4544,581,43,37,80,
4545,603,42,39,81,
4546,594,45,34,79,
4547,611,53,25,78,
4548,593,36,39,75,
4549,671,51,30,81,
4550,626,42,37,79,
4551,669,46,39,85,
4552,622,36,32,68,
4553,624,41,46,87,
4554,582,35,35,70,
4555,576,48,30,78,
4556,648,43,40,83,
4557,631,51,40,91,
4558,579,40,27,67,
4559,640,43,39,82,
4560,623,52,42,94,
4561,648,40,38,78,
4562,591,40,40,80,
4563,641,40,33,73,
4564,593,43,39,82,
4565,648,55,48,103,
4566,623,54,32,86,
4567,649,51,26,77,
4568,624,45,36,81,
4569,583,44,31,75,
4570,577,31,35,66,
4571,604,45,36,81,
4572,601,50,26,76,
4573,623,55,31,86,
4574,592,43,29,72,
4575,625,45,31,76,
4576,587,40,27,67,
4577,612,46,34,80,
4578,585,51,36,87,
4579,621,49,37,86,
4580,642,55,35,90,
4581,630,37,36,73,
4582,637,53,34,87,
4583,611,41,29,70,
4584,658,42,40,82,
4585,640,49,39,88,
4586,655,44,38,82,
4587,603,44,26,70,
4588,628,43,38,81,
4589,602,45,42,87,
4590,633,40,35,75,
4591,596,42,24,66,
4592,641,40,34,74,
4593,596,48,34,82,
4594,596,42,35,77,
4595,612,46,36,82,
4596,614,50,37,87,
4597,644,59,28,87,
4598,638,57,44,101,
4599,655,49,36,85,
4600,668,57,36,93,
4601,632,52,35,87,
4602,639,50,48,98,
4603,598,53,40,93,
4604,654,39,40,79,
4605,598,50,23,73,
4606,623,42,45,87,
4607,665,50,36,86,
4608,608,43,41,84,
4609,617,32,36,68,
4610,597,45,32,77,
4611,595,39,32,71,
4612,643,52,32,84,
4613,609,44,39,83,
4614,608,38,40,78,
4615,610,46,31,77,
4616,590,55,19,74,
4617,575,34,34,68,
4618,611,35,34,69,
4619,592,37,38,75,
4620,621,45,33,78,
4621,653,45,52,97,
4622,606,52,35,87,
4623,574,36,36,72,
4624,559,45,34,79,
4625,646,36,39,75,
4626,625,32,37,69,
4627,584,45,33,78,
4628,651,55,39,94,
4629,583,43,39,82,
4630,668,47,41,88,
4631,641,40,31,71,
4632,613,43,35,78,
4633,619,37,42,79,
4634,597,46,37,83,
4635,615,47,27,74,
4636,607,40,42,82,
4637,610,44,42,86,
4638,602,42,28,70,
4639,600,45,31,76,
4640,628,44,28,72,
4641,635,44,39,83,
4642,657,37,42,79,
4643,565,43,35,78,
4644,599,34,39,73,
4645,603,44,42,86,
4646,585,33,37,70,
4647,627,61,38,99,
4648,644,52,38,90,
4649,646,31,37,68,
4650,628,43,30,73,
4651,576,48,19,67,
4652,592,34,31,65,
4653,617,48,41,89,
4654,639,49,44,93,
4655,602,44,37,81,
4656,575,42,33,75,
4657,640,44,43,87,
4658,617,47,43,90,
4659,592,43,28,71,
4660,637,44,34,78,
4661,565,48,25,73,
4662,644,36,30,66,
4663,604,43,30,73,
4664,634,51,30,81,
4665,609,37,22,59,
4666,672,46,38,84,
4667,624,48,40,88,
4668,678,47,43,90,
4669,636,43,34,77,
4670,642,43,40,83,
4671,586,46,29,75,
4672,570,39,28,67,
4673,632,45,27,72,
4674,624,50,31,81,
4675,639,45,37,82,
4676,626,49,37,86,
4677,612,48,31,79,
4678,604,43,36,79,
4679,609,48,33,81,
4680,633,42,42,84,
4681,578,48,30,78,
4682,629,55,31,86,
4683,616,39,38,77,
4684,607,51,41,92,
4685,612,38,40,78,
4686,613,56,29,85,
4687,640,43,45,88,
4688,626,38,40,78,
4689,617,45,38,83,
4690,641,34,49,83,
4691,611,41,33,74,
4692,659,41,33,74,
4693,684,53,39,92,
4694,618,50,31,81,
4695,580,42,39,81,
4696,602,41,27,68,
4697,630,60,32,92,
4698,672,35,41,76,
4699,602,48,29,77,
4700,656,39,38,77,
4701,601,36,40,76,
4702,583,42,28,70,
4703,620,46,30,76,
4704,635,51,42,93,
4705,643,57,31,88,
4706,608,51,34,85,
4707,607,43,29,72,
4708,624,51,31,82,
4709,655,44,27,71,
4710,606,37,35,72,
4711,605,52,36,88,
4712,669,43,40,83,
4713,601,49,25,74,
4714,580,44,39,83,
4715,638,39,31,70,
4716,589,44,39,83,
4717,614,37,38,75,
4718,591,44,31,75,
4719,640,39,38,77,
4720,668,43,42,85,
4721,613,47,37,84,
4722,630,41,44,85,
4723,641,39,34,73,
4724,655,59,34,93,
4725,591,33,31,64,
4726,677,46,35,81,
4727,632,38,33,71,
4728,582,46,31,77,
4729,637,42,30,72,
4730,619,57,44,101,
4731,631,53,31,84,
4732,670,45,37,82,
4733,608,42,36,78,
4734,645,45,41,86,
4735,592,42,33,75,
4736,631,44,36,80,
4737,606,38,37,75,
4738,589,47,44,91,
4739,615,47,33,80,
4740,641,52,35,87,
4741,593,44,36,80,
4742,651,54,33,87,
4743,660,39,39,78,
4744,615,50,32,82,
4745,608,30,30,60,
4746,582,40,42,82,
4747,640,43,38,81,
4748,635,43,32,75,
4749,628,57,32,89,
4750,616,50,38,88,
4751,652,38,32,70,
4752,652,41,42,83,
4753,633,34,42,76,
4754,665,33,37,70,
4755,619,40,32,72,
4756,610,50,31,81,
4757,609,52,33,85,
4758,671,43,39,82,
4759,594,45,34,79,
4760,571,37,55,92,
4761,609,39,29,68,
4762,613,31,28,59,
4763,656,57,42,99,
4764,638,48,40,88,
4765,604,37,29,66,
4766,627,45,37,82,
4767,632,39,44,83,
4768,625,45,30,75,
4769,621,44,44,88,
4770,596,43,30,73,
4771,602,50,48,98,
4772,607,55,28,83,
4773,596,39,32,71,
4774,612,42,28,70,
4775,621,40,27,67,
4776,600,51,32,83,
4777,592,50,30,80,
4778,596,37,40,77,
4779,597,44,29,73,
4780,654,47,42,89,
4781,594,38,21,59,
4782,628,44,40,84,
4783,626,40,39,79,
4784,631,46,40,86,
4785,620,57,26,83,
4786,605,39,32,71,
4787,588,56,24,80,
4788,606,48,35,83,
4789,646,45,38,83,
4790,647,55,40,95,
4791,599,61,26,87,
4792,608,35,37,72,
4793,627,44,39,83,
4794,609,44,42,86,
4795,597,44,31,75,
4796,663,38,42,80,
4797,624,44,35,79,
4798,596,45,35,80,
4799,597,48,35,83,
4800,649,35,36,71,
4801,640,46,32,78,
4802,660,38,37,75,
4803,678,53,29,82,
4804,654,38,36,74,
4805,624,40,38,78,
4806,630,53,42,95,
4807,656,52,38,90,
4808,605,46,43,89,
4809,595,48,38,86,
4810,623,39,40,79,
4811,635,43,45,88,
4812,655,59,39,98,
4813,615,49,24,73,
4814,570,33,39,72,
4815,613,46,34,80,
4816,643,35,32,67,
4817,601,44,33,77,
4818,678,45,40,85,
4819,575,33,31,64,
4820,596,37,35,72,
4821,609,47,27,74,
4822,589,41,34,75,
4823,638,49,38,87,
4824,602,47,41,88,
4825,659,55,32,87,
4826,629,46,38,84,
4827,612,31,33,64,
4828,639,44,26,70,
4829,598,38,40,78,
4830,619,51,38,89,
4831,602,43,42,85,
4832,650,41,29,70,
4833,618,43,29,72,
4834,589,52,34,86,
4835,615,47,36,83,
4836,637,53,39,92,
4837,620,47,36,83,
4838,599,49,31,80,
4839,571,43,27,70,
4840,640,50,46,96,
4841,637,48,29,77,
4842,645,43,38,81,
4843,639,48,33,81,
4844,602,61,32,93,
4845,623,55,41,96,
4846,634,47,36,83,
4847,592,38,30,68,
4848,638,53,35,88,
4849,618,37,34,71,
4850,640,47,29,76,
4851,674,42,35,77,
4852,621,44,38,82,
4853,594,43,31,74,
4854,644,53,43,96,
4855,578,50,27,77,
4856,589,41,30,71,
4857,642,49,37,86,
4858,618,47,34,81,
4859,589,51,47,98,
4860,603,39,33,72,
4861,612,47,28,75,
4862,613,42,33,75,
4863,630,50,42,92,
4864,612,56,34,90,
4865,589,51,30,81,
4866,595,42,34,76,
4867,606,44,47,91,
4868,591,44,35,79,
4869,646,64,26,90,
4870,613,46,36,82,
4871,594,46,33,79,
4872,649,51,35,86,
4873,619,47,39,86,
4874,590,44,33,77,
4875,612,39,36,75,
4876,621,49,33,82,
4877,631,34,37,71,
4878,623,43,36,79,
4879,599,40,26,66,
4880,612,42,26,68,
4881,645,54,28,82,
4882,628,60,35,95,
4883,622,46,29,75,
4884,605,46,38,84,
4885,656,46,29,75,
4886,661,40,39,79,
4887,634,42,32,74,
4888,604,50,36,86,
4889,645,39,45,84,
4890,612,52,41,93,
4891,596,49,31,80,
4892,601,46,41,87,
4893,570,31,35,66,
4894,582,40,27,67,
4895,617,44,30,74,
4896,601,41,32,73,
4897,598,41,29,70,
4898,604,36,43,79,
4899,645,37,30,67,
4900,622,38,34,72,
4901,619,36,39,75,
4902,647,38,42,80,
4903,624,35,37,72,
4904,641,31,36,67,
4905,617,38,31,69,
4906,637,56,30,86,
4907,613,42,30,72,
4908,660,54,37,91,
4909,631,39,32,71,
4910,613,40,40,80,
4911,596,57,25,82,
4912,613,45,38,83,
4913,645,43,31,74,
4914,593,37,33,70,
4915,589,32,42,74,
4916,616,49,44,93,
4917,616,43,27,70,
4918,616,41,36,77,
4919,581,51,38,89,
4920,597,36,34,70,
4921,606,38,43,81,
4922,612,50,39,89,
4923,583,38,34,72,
4924,645,46,44,90,
4925,639,60,38,98,
4926,629,45,41,86,
4927,621,46,37,83,
4928,594,53,39,92,
4929,634,41,33,74,
4930,615,48,32,80,
4931,648,39,28,67,
4932,622,50,39,89,
4933,603,48,26,74,
4934,634,31,39,70,
4935,610,30,30,60,
4936,626,35,33,68,
4937,679,49,47,96,
4938,671,45,38,83,
4939,628,46,29,75,
4940,638,51,34,85,
4941,639,39,44,83,
4942,633,50,31,81,
4943,625,44,27,71,
4944,612,50,27,77,
4945,692,57,37,94,
4946,599,43,32,75,
4947,602,52,35,87,
4948,632,48,37,85,
4949,630,43,36,79,
4950,638,41,39,80,
4951,636,46,37,83,
4952,635,53,30,83,
4953,616,51,38,89,
4954,590,59,35,94,
4955,611,35,34,69,
4956,628,54,40,94,
4957,654,46,50,96,
4958,624,39,32,71,
4959,603,49,38,87,
4960,615,48,31,79,
4961,644,31,33,64,
4962,643,52,32,84,
4963,609,39,30,69,
4964,565,35,33,68,
4965,642,44,31,75,
4966,624,47,40,87,
4967,617,34,38,72,
4968,615,42,39,81,
4969,640,47,32,79,
4970,671,48,29,77,
4971,622,47,36,83,
4972,633,60,41,101,
4973,620,55,31,86,
4974,619,44,41,85,
4975,657,52,29,81,
4976,623,44,41,85,
4977,621,38,26,64,
4978,606,45,30,75,
4979,623,44,34,78,
4980,643,39,37,76,
4981,601,35,34,69,
4982,654,43,44,87,
4983,575,34,28,62,
4984,609,43,30,73,
4985,598,47,25,72,
4986,653,41,29,70,
4987,609,49,31,80,
4988,641,60,43,103,
4989,621,48,34,82,
4990,658,43,41,84,
4991,655,47,30,77,
4992,590,40,33,73,
4993,585,36,36,72,
4994,594,38,46,84,
4995,602,54,31,85,
4996,625,52,34,86,
4997,645,56,38,94,
4998,632,48,28,76,
4999,625,39,23,62,
5000,571,39,46,85,
5001,619,41,27,68,
5002,661,43,41,84,
5003,607,46,39,85,
5004,627,41,34,75,
5005,618,47,23,70,
5006,632,51,36,87,
5007,622,58,33,91,
5008,653,51,45,96,
5009,611,34,34,68,
5010,616,48,29,77,
5011,610,55,32,87,
5012,635,46,33,79,
5013,593,56,31,87,
5014,620,49,30,79,
5015,635,48,40,88,
5016,631,48,37,85,
5017,625,50,37,87,
5018,664,48,37,85,
5019,634,58,36,94,
5020,614,45,28,73,
5021,582,26,26,52,
5022,591,48,28,76,
5023,645,47,40,87,
5024,620,43,49,92,
5025,627,40,62,102,
5026,654,54,43,97,
5027,634,47,45,92,
5028,604,41,22,63,
5029,641,49,40,89,
5030,626,54,23,77,
5031,635,52,33,85,
5032,597,39,33,72,
5033,613,43,40,83,
5034,632,54,34,88,
5035,599,45,31,76,
5036,636,50,42,92,
5037,616,47,36,83,
5038,646,46,39,85,
5039,636,47,47,94,
5040,637,49,33,82,
5041,687,42,51,93,
5042,590,46,32,78,
5043,629,30,36,66,
5044,574,35,27,62,
5045,589,40,31,71,
5046,620,51,34,85,
5047,583,42,35,77,
5048,593,51,30,81,
5049,630,39,30,69,
5050,658,45,38,83,
5051,648,54,37,91,
5052,627,38,33,71,
5053,563,43,34,77,
5054,625,48,35,83,
5055,616,47,30,77,
5056,607,35,37,72,
5057,613,51,37,88,
5058,639,54,23,77,
5059,634,46,42,88,
5060,631,47,39,86,
5061,634,52,42,94,
5062,620,39,41,80,
5063,654,47,39,86,
5064,641,26,48,74,
5065,615,42,40,82,
5066,604,41,45,86,
5067,618,43,27,70,
5068,610,45,40,85,
5069,639,46,23,69,
5070,619,50,33,83,
5071,599,46,18,64,
5072,614,43,26,69,
5073,625,46,25,71,
5074,611,55,30,85,
5075,602,38,29,67,
5076,650,44,31,75,
5077,590,42,25,67,
5078,550,37,29,66,
5079,607,40,35,75,
5080,602,49,34,83,
5081,659,56,37,93,
5082,638,44,45,89,
5083,597,40,51,91,
5084,663,58,38,96,
5085,599,45,42,87,
5086,608,34,37,71,
5087,598,47,27,74,
5088,601,37,31,68,
5089,584,39,36,75,
5090,638,53,33,86,
5091,637,44,29,73,
5092,649,49,38,87,
5093,598,44,39,83,
5094,626,45,43,88,
5095,646,56,33,89,
5096,622,49,38,87,
5097,579,42,30,72,
5098,610,51,28,79,
5099,642,52,34,86,
5100,630,41,40,81,
5101,617,49,31,80,
5102,619,46,29,75,
5103,618,33,47,80,
5104,643,41,43,84,
5105,643,49,34,83,
5106,616,42,30,72,
5107,596,37,37,74,
5108,678,43,44,87,
5109,632,46,26,72,
5110,609,53,37,90,
5111,640,51,34,85,
5112,603,48,34,82,
5113,590,42,41,83,
5114,602,45,17,62,
5115,644,48,24,72,
5116,630,49,30,79,
5117,622,47,42,89,
5118,644,50,38,88,
5119,591,42,31,73,
5120,583,54,42,96,
5121,612,53,40,93,
5122,600,51,27,78,
5123,592,31,31,62,
5124,571,30,27,57,
5125,657,54,34,88,
5126,627,31,38,69,
5127,631,42,37,79,
5128,594,47,40,87,
5129,619,40,35,75,
5130,603,33,40,73,
5131,617,41,26,67,
5132,586,42,42,84,
5133,598,49,34,83,
5134,632,52,35,87,
5135,645,42,32,74,
5136,611,41,42,83,
5137,651,49,44,93,
5138,619,48,33,81,
5139,598,38,28,66,
5140,580,41,32,73,
5141,631,47,24,71,
5142,663,46,42,88,
5143,600,50,36,86,
5144,577,51,31,82,
5145,560,41,30,71,
5146,609,47,35,82,
5147,588,50,24,74,
5148,651,46,39,85,
5149,618,50,32,82,
5150,607,37,36,73,
5151,585,35,27,62,
5152,619,44,22,66,
5153,629,42,39,81,
5154,644,44,41,85,
5155,625,50,28,78,
5156,599,35,30,65,
5157,618,37,42,79,
5158,602,45,27,72,
5159,625,47,35,82,
5160,582,40,29,69,
5161,596,35,41,76,
5162,627,44,37,81,
5163,625,42,29,71,
5164,610,42,40,82,
5165,607,51,43,94,
5166,673,38,46,84,
5167,651,52,41,93,
5168,623,59,40,99,
5169,593,51,35,86,
5170,630,44,40,84,
5171,654,48,28,76,
5172,655,55,38,93,
5173,625,45,36,81,
5174,633,49,38,87,
5175,582,51,35,86,
5176,617,47,31,78,
5177,643,48,33,81,
5178,672,43,45,88,
5179,645,47,35,82,
5180,601,54,34,88,
5181,616,39,31,70,
5182,594,44,27,71,
5183,616,47,29,76,
5184,609,44,34,78,
5185,651,58,41,99,
5186,593,48,31,79,
5187,715,53,36,89,
5188,590,43,38,81,
5189,614,32,43,75,
5190,619,44,31,75,
5191,587,37,53,90,
5192,663,60,39,99,
5193,646,54,27,81,
5194,630,48,36,84,
5195,639,48,33,81,
5196,643,61,31,92,
5197,628,49,27,76,
5198,639,48,29,77,
5199,609,56,30,86,
5200,599,44,34,78,
5201,578,47,36,83,
5202,634,48,34,82,
5203,585,42,29,71,
5204,636,54,38,92,
5205,612,48,38,86,
5206,630,40,35,75,
5207,647,59,36,95,
5208,643,50,25,75,
5209,643,34,48,82,
5210,634,53,39,92,
5211,613,52,36,88,
5212,594,63,27,90,
5213,617,42,42,84,
5214,580,42,31,73,
5215,618,43,29,72,
5216,629,44,26,70,
5217,612,43,40,83,
5218,648,38,42,80,
5219,631,45,32,77,
5220,590,39,32,71,
5221,619,42,34,76,
5222,647,48,39,87,
5223,645,38,27,65,
5224,661,47,42,89,
5225,604,42,32,74,
5226,651,60,44,104,
5227,620,35,38,73,
5228,616,40,31,71,
5229,586,48,31,79,
5230,691,51,42,93,
5231,626,46,24,70,
5232,638,49,32,81,
5233,665,43,45,88,
5234,642,43,28,71,
5235,567,35,44,79,
5236,576,31,42,73,
5237,599,39,32,71,
5238,605,39,39,78,
5239,571,34,21,55,
5240,604,47,31,78,
5241,630,49,35,84,
5242,689,45,44,89,
5243,640,41,28,69,
5244,603,41,39,80,
5245,606,47,29,76,
5246,627,42,37,79,
5247,632,50,40,90,
5248,638,46,34,80,
5249,622,44,32,76,
5250,649,42,53,95,
5251,615,48,33,81,
5252,595,44,20,64,
5253,595,48,27,75,
5254,629,49,35,84,
5255,654,46,32,78,
5256,600,49,37,86,
5257,628,52,38,90,
5258,618,48,38,86,
5259,610,47,30,77,
5260,611,54,24,78,
5261,660,47,35,82,
5262,576,52,31,83,
5263,583,38,38,76,
5264,618,49,31,80,
5265,657,38,43,81,
5266,631,54,36,90,
5267,629,41,37,78,
5268,648,41,31,72,
5269,628,36,40,76,
5270,632,42,39,81,
5271,611,42,40,82,
5272,625,48,33,81,
5273,611,41,47,88,
5274,558,39,27,66,
5275,587,41,36,77,
5276,607,37,38,75,
5277,570,42,32,74,
5278,644,59,32,91,
5279,628,35,41,76,
5280,616,45,36,81,
5281,606,48,34,82,
5282,602,38,39,77,
5283,617,47,36,83,
5284,634,54,33,87,
5285,623,49,42,91,
5286,625,49,34,83,
5287,622,54,29,83,
5288,614,49,26,75,
5289,609,47,38,85,
5290,664,44,48,92,
5291,624,53,30,83,
5292,673,53,42,95,
5293,605,38,41,79,
5294,564,43,28,71,
5295,664,47,37,84,
5296,629,53,39,92,
5297,634,43,37,80,
5298,596,36,42,78,
5299,641,42,38,80,
5300,648,45,39,84,
5301,581,35,24,59,
5302,641,47,39,86,
5303,641,47,49,96,
5304,622,48,37,85,
5305,639,58,32,90,
5306,607,51,43,94,
5307,639,55,44,99,
5308,582,54,34,88,
5309,626,51,32,83,
5310,602,38,32,70,
5311,599,40,30,70,
5312,616,47,28,75,
5313,628,59,33,92,
5314,637,60,33,93,
5315,619,51,46,97,
5316,647,45,34,79,
5317,602,44,36,80,
5318,638,49,32,81,
5319,581,42,32,74,
5320,597,29,34,63,
5321,591,50,25,75,
5322,616,46,34,80,
5323,652,45,39,84,
5324,628,38,41,79,
5325,555,46,41,87,
5326,706,51,46,97,
5327,644,47,43,90,
5328,653,59,52,111,
5329,646,50,40,90,
5330,586,65,25,90,
5331,677,41,51,92,
5332,618,43,42,85,
5333,575,53,36,89,
5334,590,36,34,70,
5335,625,37,28,65,
5336,626,48,34,82,
5337,636,60,40,100,
5338,598,39,32,71,
5339,603,40,31,71,
5340,602,45,30,75,
5341,598,38,34,72,
5342,624,35,36,71,
5343,603,45,40,85,
5344,653,56,33,89,
5345,620,39,34,73,
5346,639,43,30,73,
5347,612,43,20,63,
5348,612,53,27,80,
5349,588,55,28,83,
5350,586,42,33,75,
5351,590,46,21,67,
5352,589,36,35,71,
5353,627,32,27,59,
5354,668,55,32,87,
5355,606,33,38,71,
5356,604,59,36,95,
5357,596,38,38,76,
5358,610,45,35,80,
5359,622,61,29,90,
5360,643,49,34,83,
5361,591,44,29,73,
5362,591,37,35,72,
5363,630,44,29,73,
5364,612,40,30,70,
5365,711,56,47,103,
5366,678,45,44,89,
5367,703,42,39,81,
5368,637,47,36,83,
5369,580,36,45,81,
5370,618,50,33,83,
5371,619,55,38,93,
5372,617,43,33,76,
5373,581,42,31,73,
5374,608,40,32,72,
5375,618,54,27,81,
5376,603,44,25,69,
5377,599,40,33,73,
5378,600,28,30,58,
5379,664,35,42,77,
5380,617,47,43,90,
5381,681,50,28,78,
5382,629,39,40,79,
5383,646,44,36,80,
5384,584,42,43,85,
5385,621,44,33,77,
5386,602,44,41,85,
5387,639,47,26,73,
5388,668,42,38,80,
5389,622,51,42,93,
5390,609,47,29,76,
5391,652,45,31,76,
5392,640,56,36,92,
5393,621,43,38,81,
5394,630,50,32,82,
5395,659,47,38,85,
5396,643,50,33,83,
5397,591,47,35,82,
5398,566,48,36,84,
5399,583,32,28,60,
5400,612,46,34,80,
5401,616,39,30,69,
5402,663,47,42,89,
5403,613,43,32,75,
5404,618,40,38,78,
5405,632,45,39,84,
5406,630,48,39,87,
5407,631,43,29,72,
5408,624,43,38,81,
5409,647,41,29,70,
5410,612,41,34,75,
5411,593,31,39,70,
5412,639,52,35,87,
5413,626,60,30,90,
5414,639,47,39,86,
5415,625,45,31,76,
5416,619,45,38,83,
5417,666,44,45,89,
5418,654,36,44,80,
5419,624,56,32,88,
5420,670,54,34,88,
5421,578,40,31,71,
5422,629,42,40,82,
5423,619,44,27,71,
5424,595,45,30,75,
5425,642,47,32,79,
5426,603,51,34,85,
5427,646,56,29,85,
5428,637,40,39,79,
5429,596,35,29,64,
5430,626,44,45,89,
5431,656,59,39,98,
5432,597,36,30,66,
5433,626,56,37,93,
5434,629,57,42,99,
5435,630,39,36,75,
5436,588,54,24,78,
5437,594,43,30,73,
5438,632,34,42,76,
5439,602,53,44,97,
5440,632,36,31,67,
5441,627,47,41,88,
5442,592,48,26,74,
5443,618,44,31,75,
5444,622,45,39,84,
5445,651,52,38,90,
5446,622,44,40,84,
5447,606,44,43,87,
5448,613,46,31,77,
5449,631,43,45,88,
5450,624,44,28,72,
5451,618,41,45,86,
5452,622,27,37,64,
5453,635,52,37,89,
5454,628,39,37,76,
5455,623,44,30,74,
5456,589,41,29,70,
5457,605,28,39,67,
5458,619,49,25,74,
5459,552,30,32,62,
5460,647,58,35,93,
5461,610,42,41,83,
5462,606,50,20,70,
5463,614,42,36,78,
5464,649,52,32,84,
5465,652,46,30,76,
5466,593,29,48,77,
5467,618,44,31,75,
5468,601,48,35,83,
5469,639,42,39,81,
5470,612,46,37,83,
5471,650,45,37,82,
5472,632,42,40,82,
5473,619,48,42,90,
5474,584,42,42,84,
5475,664,48,30,78,
5476,624,44,31,75,
5477,609,38,33,71,
5478,563,38,36,74,
5479,563,37,25,62,
5480,643,42,42,84,
5481,623,47,27,74,
5482,646,35,35,70,
5483,640,52,38,90,
5484,625,43,32,75,
5485,636,44,38,82,
5486,596,45,29,74,
5487,621,41,31,72,
5488,572,30,29,59,
5489,626,45,28,73,
5490,633,40,33,73,
5491,615,44,40,84,
5492,694,54,41,95,
5493,610,43,35,78,
5494,627,44,31,75,
5495,615,48,38,86,
5496,614,47,32,79,
5497,605,53,40,93,
5498,649,46,36,82,
5499,628,56,37,93,
5500,608,58,29,87,
5501,650,55,45,100,
5502,631,43,34,77,
5503,675,49,39,88,
5504,648,54,36,90,
5505,617,47,43,90,
5506,607,44,43,87,
5507,646,42,40,82,
5508,624,44,32,76,
5509,619,50,38,88,
5510,641,43,49,92,
5511,695,46,38,84,
5512,630,57,38,95,
5513,641,47,34,81,
5514,645,49,36,85,
5515,608,43,32,75,
5516,597,49,38,87,
5517,605,53,40,93,
5518,580,39,33,72,
5519,645,46,41,87,
5520,577,37,36,73,
5521,626,48,29,77,
5522,638,38,41,79,
5523,667,50,46,96,
5524,643,56,36,92,
5525,615,46,38,84,
5526,585,44,41,85,
5527,589,39,27,66,
5528,614,45,28,73,
5529,629,38,35,73,
5530,619,38,31,69,
5531,584,44,25,69,
5532,662,50,31,81,
5533,601,41,38,79,
5534,610,53,35,88,
5535,598,39,28,67,
5536,590,39,37,76,
5537,593,39,26,65,
5538,660,46,39,85,
5539,624,36,40,76,
5540,562,47,26,73,
5541,590,40,32,72,
5542,644,54,40,94,
5543,614,45,34,79,
5544,609,48,47,95,
5545,636,44,43,87,
5546,581,36,36,72,
5547,593,40,31,71,
5548,588,43,43,86,
5549,563,26,35,61,
5550,606,38,41,79,
5551,614,39,46,85,
5552,651,36,41,77,
5553,657,46,51,97,
5554,642,44,42,86,
5555,652,50,36,86,
5556,621,51,32,83,
5557,650,55,28,83,
5558,630,41,30,71,
5559,612,47,32,79,
5560,645,49,40,89,
5561,607,44,34,78,
5562,673,46,32,78,
5563,641,41,36,77,
5564,627,56,37,93,
5565,596,35,25,60,
5566,633,35,41,76,
5567,606,42,47,89,
5568,625,38,34,72,
5569,658,47,31,78,
5570,609,31,30,61,
5571,624,43,43,86,
5572,621,41,28,69,
5573,622,49,32,81,
5574,592,37,38,75,
5575,620,41,41,82,
5576,542,20,30,50,
5577,631,46,41,87,
5578,646,50,32,82,
5579,641,49,33,82,
5580,664,40,51,91,
5581,607,48,30,78,
5582,656,50,21,71,
5583,589,37,35,72,
5584,623,43,30,73,
5585,609,46,36,82,
5586,635,53,40,93,
5587,611,43,40,83,
5588,626,41,41,82,
5589,626,37,39,76,
5590,603,35,39,74,
5591,608,44,41,85,
5592,641,46,27,73,
5593,658,51,31,82,
5594,603,36,36,72,
5595,629,33,38,71,
5596,615,36,27,63,
5597,612,41,41,82,
5598,599,34,34,68,
5599,643,44,41,85,
5600,592,51,29,80,
5601,610,44,37,81,
5602,557,42,24,66,
5603,609,48,37,85,
5604,625,50,39,89,
5605,612,52,28,80,
5606,675,43,37,80,
5607,625,50,37,87,
5608,650,43,38,81,
5609,629,37,32,69,
5610,644,49,37,86,
5611,605,38,35,73,
5612,649,36,39,75,
5613,655,42,40,82,
5614,664,54,41,95,
5615,625,47,37,84,
5616,610,52,33,85,
5617,627,48,36,84,
5618,674,49,33,82,
5619,626,50,28,78,
5620,634,42,33,75,
5621,616,45,17,62,
5622,617,51,36,87,
5623,610,49,39,88,
5624,637,44,35,79,
5625,597,34,25,59,
5626,649,42,25,67,
5627,650,59,40,99,
5628,627,36,31,67,
5629,625,49,28,77,
5630,626,43,58,101,
5631,618,67,26,93,
5632,622,49,36,85,
5633,650,44,42,86,
5634,632,39,41,80,
5635,621,44,34,78,
5636,597,42,26,68,
5637,602,50,30,80,
5638,625,44,41,85,
5639,591,42,30,72,
5640,616,45,30,75,
5641,613,47,37,84,
5642,625,54,22,76,
5643,627,43,44,87,
5644,597,46,31,77,
5645,632,52,21,73,
5646,633,49,31,80,
5647,573,32,29,61,
5648,633,43,38,81,
5649,636,37,55,92,
5650,667,50,33,83,
5651,621,50,35,85,
5652,586,51,34,85,
5653,614,34,38,72,
5654,637,40,32,72,
5655,597,47,30,77,
5656,587,36,30,66,
5657,587,47,32,79,
5658,666,63,36,99,
5659,624,36,44,80,
5660,614,39,29,68,
5661,626,38,38,76,
5662,611,41,32,73,
5663,581,41,32,73,
5664,629,46,41,87,
5665,620,41,34,75,
5666,650,45,34,79,
5667,638,40,39,79,
5668,619,34,33,67,
5669,606,38,39,77,
5670,626,40,35,75,
5671,604,54,22,76,
5672,645,53,38,91,
5673,672,50,32,82,
5674,588,46,31,77,
5675,640,29,52,81,
5676,629,49,28,77,
5677,585,42,32,74,
5678,610,45,33,78,
5679,612,45,39,84,
5680,602,38,32,70,
5681,598,37,36,73,
5682,582,35,39,74,
5683,580,43,41,84,
5684,600,55,35,90,
5685,626,52,38,90,
5686,635,40,38,78,
5687,664,47,31,78,
5688,583,44,35,79,
5689,621,50,42,92,
5690,625,41,34,75,
5691,563,33,30,63,
5692,603,43,32,75,
5693,581,51,42,93,
5694,617,32,37,69,
5695,631,43,37,80,
5696,650,43,32,75,
5697,662,50,48,98,
5698,613,43,46,89,
5699,583,51,27,78,
5700,626,44,50,94,
5701,652,41,38,79,
5702,632,38,38,76,
5703,605,52,32,84,
5704,625,52,36,88,
5705,609,46,40,86,
5706,603,39,31,70,
5707,611,28,30,58,
5708,607,39,33,72,
5709,580,44,31,75,
5710,591,46,31,77,
5711,644,44,34,78,
5712,645,65,26,91,
5713,596,45,23,68,
5714,594,58,36,94,
5715,566,34,34,68,
5716,602,41,34,75,
5717,669,52,34,86,
5718,607,54,26,80,
5719,606,57,33,90,
5720,617,55,31,86,
5721,580,49,25,74,
5722,697,44,37,81,
5723,602,32,41,73,
5724,668,39,47,86,
5725,716,55,33,88,
5726,653,46,41,87,
5727,607,46,32,78,
5728,601,43,44,87,
5729,624,57,27,84,
5730,593,49,42,91,
5731,578,44,29,73,
5732,619,42,28,70,
5733,658,46,35,81,
5734,630,55,37,92,
5735,631,41,48,89,
5736,606,44,32,76,
5737,564,51,25,76,
5738,651,53,34,87,
5739,628,54,44,98,
5740,619,42,40,82,
5741,581,34,35,69,
5742,614,42,31,73,
5743,646,50,30,80,
5744,651,55,33,88,
5745,658,50,28,78,
5746,667,46,43,89,
5747,633,50,31,81,
5748,642,37,36,73,
5749,635,60,47,107,
5750,615,53,30,83,
5751,603,29,34,63,
5752,578,44,17,61,
5753,632,41,38,79,
5754,629,42,36,78,
5755,603,43,30,73,
5756,643,47,29,76,
5757,600,51,39,90,
5758,575,44,36,80,
5759,618,38,42,80,
5760,591,47,37,84,
5761,603,50,26,76,
5762,617,35,39,74,
5763,594,38,27,65,
5764,568,35,41,76,
5765,548,39,39,78,
5766,621,52,44,96,
5767,608,43,27,70,
5768,617,49,38,87,
5769,594,46,41,87,
5770,669,51,40,91,
5771,621,50,40,90,
5772,580,37,31,68,
5773,651,54,39,93,
5774,656,47,35,82,
5775,623,48,33,81,
5776,606,41,43,84,
5777,651,56,44,100,
5778,633,48,32,80,
5779,636,54,40,94,
5780,624,44,21,65,
5781,612,40,33,73,
5782,566,35,29,64,
5783,651,42,37,79,
5784,645,45,33,78,
5785,622,49,30,79,
5786,595,43,30,73,
5787,643,52,41,93,
5788,604,49,28,77,
5789,577,52,43,95,
5790,647,45,38,83,
5791,654,47,48,95,
5792,604,37,32,69,
5793,650,41,34,75,
5794,617,44,31,75,
5795,610,47,26,73,
5796,609,50,36,86,
5797,664,41,35,76,
5798,610,46,29,75,
5799,652,43,47,90,
5800,606,44,38,82,
5801,615,38,39,77,
5802,646,53,36,89,
5803,653,46,36,82,
5804,607,57,29,86,
5805,553,42,36,78,
5806,611,46,31,77,
5807,592,46,23,69,
5808,642,48,36,84,
5809,579,42,39,81,
5810,589,47,34,81,
5811,585,53,30,83,
5812,664,55,30,85,
5813,684,57,41,98,
5814,620,48,37,85,
5815,581,45,28,73,
5816,629,45,43,88,
5817,638,39,37,76,
5818,630,36,48,84,
5819,633,43,39,82,
5820,617,40,40,80,
5821,651,49,42,91,
5822,580,46,35,81,
5823,629,53,42,95,
5824,609,40,35,75,
5825,641,49,38,87,
5826,628,44,46,90,
5827,622,54,32,86,
5828,662,49,32,81,
5829,657,46,35,81,
5830,604,49,40,89,
5831,601,53,36,89,
5832,663,66,39,105,
5833,635,50,29,79,
5834,653,48,38,86,
5835,609,49,27,76,
5836,622,37,42,79,
5837,641,49,35,84,
5838,675,45,42,87,
5839,611,40,36,76,
5840,624,46,30,76,
5841,625,52,41,93,
5842,619,43,24,67,
5843,622,54,34,88,
5844,627,39,34,73,
5845,623,39,30,69,
5846,629,52,40,92,
5847,660,38,36,74,
5848,604,46,37,83,
5849,639,56,36,92,
5850,624,43,40,83,
5851,598,60,26,86,
5852,640,53,20,73,
5853,574,36,45,81,
5854,604,40,33,73,
5855,641,49,35,84,
5856,671,48,34,82,
5857,576,38,28,66,
5858,600,35,34,69,
5859,640,50,45,95,
5860,635,40,35,75,
5861,623,46,31,77,
5862,643,38,36,74,
5863,666,47,42,89,
5864,629,43,44,87,
5865,606,45,28,73,
5866,604,38,32,70,
5867,600,48,37,85,
5868,632,55,29,84,
5869,643,44,30,74,
5870,619,57,33,90,
5871,642,48,33,81,
5872,595,39,37,76,
5873,585,40,47,87,
5874,627,58,46,104,
5875,632,47,33,80,
5876,625,43,39,82,
5877,593,39,29,68,
5878,617,52,35,87,
5879,610,52,24,76,
5880,630,35,32,67,
5881,593,54,30,84,
5882,663,53,49,102,
5883,620,48,32,80,
5884,580,50,30,80,
5885,631,50,30,80,
5886,595,44,36,80,
5887,629,43,34,77,
5888,626,39,38,77,
5889,653,54,42,96,
5890,611,49,23,72,
5891,704,59,41,100,
5892,633,55,44,99,
5893,649,47,39,86,
5894,603,37,40,77,
5895,609,51,42,93,
5896,633,43,32,75,
5897,576,33,37,70,
5898,596,34,25,59,
5899,620,44,28,72,
5900,622,46,38,84,
5901,633,45,58,103,
5902,627,46,28,74,
5903,666,44,34,78,
5904,575,36,36,72,
5905,607,43,40,83,
5906,629,48,50,98,
5907,640,41,32,73,
5908,639,42,35,77,
5909,622,46,41,87,
5910,602,43,25,68,
5911,659,38,39,77,
5912,621,50,36,86,
5913,604,33,34,67,
5914,596,44,36,80,
5915,601,44,27,71,
5916,608,50,38,88,
5917,631,56,42,98,
5918,648,37,37,74,
5919,634,43,39,82,
5920,608,41,34,75,
5921,621,54,39,93,
5922,608,49,36,85,
5923,620,49,34,83,
5924,685,47,36,83,
5925,603,46,40,86,
5926,629,41,37,78,
5927,618,50,41,91,
5928,563,36,29,65,
5929,637,49,32,81,
5930,565,34,31,65,
5931,580,41,35,76,
5932,663,45,34,79,
5933,672,50,36,86,
5934,619,45,35,80,
5935,631,45,44,89,
5936,583,45,29,74,
5937,611,38,28,66,
5938,582,56,35,91,
5939,576,39,44,83,
5940,593,47,33,80,
5941,623,53,36,89,
5942,636,37,37,74,
5943,618,53,36,89,
5944,634,39,35,74,
5945,596,36,28,64,
5946,624,35,38,73,
5947,610,54,36,90,
5948,631,58,47,105,
5949,640,54,41,95,
5950,631,42,37,79,
5951,601,42,38,80,
5952,574,37,27,64,
5953,595,43,26,69,
5954,622,35,38,73,
5955,613,64,40,104,
5956,597,45,36,81,
5957,598,49,28,77,
5958,618,36,25,61,
5959,629,38,31,69,
5960,646,46,29,75,
5961,621,45,29,74,
5962,604,48,36,84,
5963,598,48,36,84,
5964,593,51,31,82,
5965,572,35,27,62,
5966,570,50,37,87,
5967,625,32,40,72,
5968,600,44,29,73,
5969,585,36,34,70,
5970,641,39,33,72,
5971,598,42,35,77,
5972,585,48,35,83,
5973,610,49,39,88,
5974,606,43,38,81,
5975,623,40,28,68,
5976,636,43,36,79,
5977,646,47,35,82,
5978,626,37,37,74,
5979,624,45,31,76,
5980,674,49,40,89,
5981,607,35,23,58,
5982,598,40,38,78,
5983,597,53,34,87,
5984,581,48,39,87,
5985,595,44,32,76,
5986,629,46,35,81,
5987,629,48,26,74,
5988,635,45,26,71,
5989,592,40,41,81,
5990,608,48,38,86,
5991,646,43,37,80,
5992,644,41,45,86,
5993,603,43,40,83,
5994,626,49,41,90,
5995,668,44,38,82,
5996,602,35,32,67,
5997,654,56,35,91,
5998,583,44,26,70,
5999,624,44,37,81,
6000,639,42,36,78,
6001,626,40,42,82,
6002,642,45,52,97,
6003,652,53,36,89,
6004,595,55,32,87,
6005,593,36,30,66,
6006,628,39,44,83,
6007,587,37,36,73,
6008,642,50,24,74,
6009,605,48,24,72,
6010,678,50,34,84,
6011,639,41,36,77,
6012,571,38,36,74,
6013,670,48,43,91,
6014,656,41,35,76,
6015,618,35,37,72,
6016,635,41,29,70,
6017,633,46,30,76,
6018,630,36,33,69,
6019,648,39,37,76,
6020,637,42,40,82,
6021,607,41,24,65,
6022,588,46,32,78,
6023,612,46,33,79,
6024,631,53,37,90,
6025,586,42,31,73,
6026,625,48,37,85,
6027,575,40,39,79,
6028,587,27,33,60,
6029,638,49,38,87,
6030,638,41,33,74,
6031,628,49,37,86,
6032,607,43,32,75,
6033,644,42,36,78,
6034,599,38,33,71,
6035,638,40,43,83,
6036,585,47,38,85,
6037,616,40,41,81,
6038,571,39,31,70,
6039,620,38,36,74,
6040,624,38,26,64,
6041,598,42,27,69,
6042,574,32,34,66,
6043,577,47,36,83,
6044,596,36,36,72,
6045,602,41,23,64,
6046,625,53,33,86,
6047,644,49,36,85,
6048,611,57,32,89,
6049,638,44,39,83,
6050,661,43,45,88,
6051,634,39,30,69,
6052,709,55,43,98,
6053,636,56,41,97,
6054,644,49,41,90,
6055,625,49,43,92,
6056,571,36,26,62,
6057,614,41,37,78,
6058,623,46,27,73,
6059,609,47,35,82,
6060,629,55,32,87,
6061,649,54,35,89,
6062,600,40,36,76,
6063,622,51,37,88,
6064,592,42,40,82,
6065,615,51,30,81,
6066,655,53,30,83,
6067,591,34,40,74,
6068,606,32,34,66,
6069,612,44,52,96,
6070,601,31,20,51,
6071,604,38,40,78,
6072,633,41,33,74,
6073,641,47,29,76,
6074,624,38,34,72,
6075,636,52,41,93,
6076,669,54,41,95,
6077,662,55,46,101,
6078,632,42,28,70,
6079,634,58,37,95,
6080,612,49,35,84,
6081,599,29,27,56,
6082,607,57,34,91,
6083,667,51,45,96,
6084,654,56,35,91,
6085,621,41,42,83,
6086,663,40,44,84,
6087,628,49,42,91,
6088,560,45,33,78,
6089,594,41,22,63,
6090,647,60,34,94,
6091,631,46,28,74,
6092,637,36,37,73,
6093,617,46,32,78,
6094,616,42,44,86,
6095,637,40,32,72,
6096,584,50,34,84,
6097,605,40,39,79,
6098,612,42,39,81,
6099,623,38,29,67,
6100,620,66,39,105,
6101,564,41,34,75,
6102,646,48,34,82,
6103,629,47,31,78,
6104,658,43,35,78,
6105,622,44,35,79,
6106,598,46,27,73,
6107,673,48,36,84,
6108,606,37,32,69,
6109,643,44,40,84,
6110,571,45,30,75,
6111,624,41,33,74,
6112,615,55,41,96,
6113,616,58,35,93,
6114,627,52,34,86,
6115,589,44,41,85,
6116,611,48,35,83,
6117,649,43,42,85,
6118,629,54,40,94,
6119,641,43,45,88,
6120,619,35,43,78,
6121,579,38,38,76,
6122,588,37,31,68,
6123,639,50,32,82,
6124,624,51,34,85,
6125,596,47,36,83,
6126,618,60,30,90,
6127,617,33,35,68,
6128,610,41,40,81,
6129,600,45,42,87,
6130,621,39,40,79,
6131,620,37,44,81,
6132,644,47,34,81,
6133,558,36,27,63,
6134,625,46,29,75,
6135,642,42,37,79,
6136,615,39,35,74,
6137,621,42,33,75,
6138,620,49,47,96,
6139,613,50,39,89,
6140,643,47,27,74,
6141,621,49,30,79,
6142,636,50,44,94,
6143,657,37,36,73,
6144,589,45,27,72,
6145,573,43,28,71,
6146,599,36,31,67,
6147,649,49,45,94,
6148,575,50,40,90,
6149,634,33,35,68,
6150,616,36,31,67,
6151,623,37,36,73,
6152,592,40,37,77,
6153,610,37,32,69,
6154,600,44,35,79,
6155,584,40,36,76,
6156,609,29,37,66,
6157,675,56,38,94,
6158,603,44,35,79,
6159,603,41,40,81,
6160,631,54,36,90,
6161,634,53,42,95,
6162,659,50,33,83,
6163,628,42,36,78,
6164,608,34,33,67,
6165,595,46,31,77,
6166,626,48,36,84,
6167,577,41,45,86,
6168,646,45,33,78,
6169,602,49,28,77,
6170,576,49,35,84,
6171,626,34,32,66,
6172,619,56,33,89,
6173,607,52,24,76,
6174,623,51,44,95,
6175,623,48,32,80,
6176,600,44,33,77,
6177,570,39,30,69,
6178,596,44,31,75,
6179,603,37,33,70,
6180,608,46,33,79,
6181,602,29,36,65,
6182,601,50,36,86,
6183,617,45,41,86,
6184,647,49,36,85,
6185,634,43,34,77,
6186,609,56,35,91,
6187,595,36,37,73,
6188,584,39,46,85,
6189,655,56,31,87,
6190,575,34,32,66,
6191,595,41,41,82,
6192,580,49,23,72,
6193,621,34,42,76,
6194,647,50,24,74,
6195,650,47,30,77,
6196,648,39,31,70,
6197,656,56,37,93,
6198,615,49,32,81,
6199,593,45,36,81,
6200,634,44,43,87,
6201,554,42,25,67,
6202,624,48,26,74,
6203,628,49,43,92,
6204,657,43,45,88,
6205,630,38,44,82,
6206,610,41,40,81,
6207,665,46,39,85,
6208,670,46,34,80,
6209,637,38,38,76,
6210,585,27,31,58,
6211,593,49,37,86,
6212,653,50,37,87,
6213,634,50,33,83,
6214,605,36,33,69,
6215,633,52,36,88,
6216,595,37,33,70,
6217,643,63,33,96,
6218,636,43,32,75,
6219,607,48,44,92,
6220,630,46,43,89,
6221,638,50,35,85,
6222,623,49,22,71,
6223,613,47,34,81,
6224,644,58,50,108,
6225,602,51,30,81,
6226,654,46,32,78,
6227,615,54,30,84,
6228,614,56,42,98,
6229,621,45,37,82,
6230,605,32,37,69,
6231,589,50,35,85,
6232,598,34,34,68,
6233,641,45,34,79,
6234,600,43,36,79,
6235,575,38,27,65,
6236,612,46,38,84,
6237,599,38,38,76,
6238,564,38,35,73,
6239,606,51,28,79,
6240,634,57,27,84,
6241,621,36,29,65,
6242,632,45,24,69,
6243,611,47,38,85,
6244,633,49,36,85,
6245,630,46,31,77,
6246,623,35,39,74,
6247,613,50,26,76,
6248,613,41,35,76,
6249,614,39,39,78,
6250,658,46,30,76,
6251,641,55,40,95,
6252,563,35,38,73,
6253,652,39,37,76,
6254,601,44,29,73,
6255,617,47,31,78,
6256,635,52,36,88,
6257,567,39,21,60,
6258,639,41,30,71,
6259,636,51,31,82,
6260,621,56,32,88,
6261,550,35,30,65,
6262,720,56,46,102,
6263,614,36,41,77,
6264,627,44,30,74,
6265,623,46,29,75,
6266,611,37,34,71,
6267,647,61,30,91,
6268,587,49,28,77,
6269,612,56,33,89,
6270,605,49,29,78,
6271,621,56,27,83,
6272,623,48,51,99,
6273,613,45,31,76,
6274,659,49,34,83,
6275,578,40,31,71,
6276,604,42,31,73,
6277,678,49,43,92,
6278,627,65,37,102,
6279,589,48,31,79,
6280,614,36,37,73,
6281,633,48,35,83,
6282,622,58,34,92,
6283,628,37,31,68,
6284,611,52,37,89,
6285,605,37,34,71,
6286,617,52,32,84,
6287,596,40,27,67,
6288,653,49,39,88,
6289,656,47,37,84,
6290,624,48,39,87,
6291,649,37,42,79,
6292,638,44,43,87,
6293,575,60,28,88,
6294,606,41,38,79,
6295,641,48,32,80,
6296,633,37,29,66,
6297,599,37,27,64,
6298,622,41,41,82,
6299,652,56,35,91,
6300,595,39,39,78,
6301,604,43,25,68,
6302,606,44,30,74,
6303,679,48,50,98,
6304,671,61,45,106,
6305,620,44,34,78,
6306,640,48,36,84,
6307,596,59,39,98,
6308,614,39,43,82,
6309,587,39,38,77,
6310,626,38,28,66,
6311,623,54,36,90,
6312,610,42,40,82,
6313,576,47,33,80,
6314,665,50,42,92,
6315,608,45,35,80,
6316,609,38,43,81,
6317,589,44,29,73,
6318,597,27,31,58,
6319,622,51,29,80,
6320,684,38,45,83,
6321,598,46,48,94,
6322,600,42,42,84,
6323,610,42,29,71,
6324,635,45,33,78,
6325,588,46,29,75,
6326,611,46,35,81,
6327,630,46,32,78,
6328,625,40,41,81,
6329,666,45,43,88,
6330,595,51,22,73,
6331,647,43,29,72,
6332,637,49,25,74,
6333,567,38,25,63,
6334,632,45,28,73,
6335,616,46,35,81,
6336,611,57,33,90,
6337,642,51,33,84,
6338,635,47,29,76,
6339,606,39,24,63,
6340,629,50,35,85,
6341,672,49,34,83,
6342,638,34,46,80,
6343,628,52,37,89,
6344,604,40,32,72,
6345,649,46,42,88,
6346,641,51,32,83,
6347,588,44,46,90,
6348,683,56,52,108,
6349,646,58,41,99,
6350,626,57,39,96,
6351,620,53,34,87,
6352,595,44,33,77,
6353,602,51,28,79,
6354,606,41,25,66,
6355,617,44,40,84,
6356,641,44,39,83,
6357,630,42,32,74,
6358,582,50,32,82,
6359,633,55,23,78,
6360,690,53,44,97,
6361,591,43,40,83,
6362,665,49,40,89,
6363,608,40,38,78,
6364,609,54,41,95,
6365,634,51,29,80,
6366,610,41,34,75,
6367,631,56,37,93,
6368,607,53,25,78,
6369,632,53,39,92,
6370,664,40,34,74,
6371,599,32,42,74,
6372,622,43,30,73,
6373,604,50,32,82,
6374,626,44,32,76,
6375,620,40,39,79,
6376,609,29,31,60,
6377,646,39,43,82,
6378,642,51,45,96,
6379,599,38,39,77,
6380,610,56,23,79,
6381,612,55,33,88,
6382,586,38,38,76,
6383,590,37,42,79,
6384,646,49,37,86,
6385,645,47,39,86,
6386,611,47,32,79,
6387,582,37,32,69,
6388,578,39,39,78,
6389,616,40,39,79,
6390,609,48,34,82,
6391,630,55,32,87,
6392,626,47,44,91,
6393,616,49,32,81,
6394,581,27,37,64,
6395,561,45,29,74,
6396,600,40,35,75,
6397,632,47,56,103,
6398,634,44,47,91,
6399,596,36,36,72,
6400,582,38,37,75,
6401,644,45,27,72,
6402,570,46,40,86,
6403,619,43,26,69,
6404,656,49,51,100,
6405,596,48,31,79,
6406,666,62,41,103,
6407,671,58,35,93,
6408,625,33,46,79,
6409,608,43,42,85,
6410,614,44,34,78,
6411,642,42,49,91,
6412,636,43,44,87,
6413,591,50,40,90,
6414,583,50,41,91,
6415,555,51,22,73,
6416,614,33,34,67,
6417,599,52,27,79,
6418,621,35,44,79,
6419,628,41,40,81,
6420,642,47,43,90,
6421,631,41,39,80,
6422,596,52,37,89,
6423,639,35,36,71,
6424,615,44,29,73,
6425,649,31,25,56,
6426,625,58,40,98,
6427,625,55,37,92,
6428,678,55,37,92,
6429,622,45,35,80,
6430,613,53,37,90,
6431,630,54,38,92,
6432,619,42,30,72,
6433,634,56,29,85,
6434,652,45,38,83,
6435,646,35,52,87,
6436,611,52,32,84,
6437,590,41,23,64,
6438,616,44,28,72,
6439,585,46,35,81,
6440,638,49,38,87,
6441,620,46,26,72,
6442,627,53,38,91,
6443,577,41,38,79,
6444,589,49,36,85,
6445,642,47,46,93,
6446,659,55,33,88,
6447,647,41,43,84,
6448,634,48,44,92,
6449,627,47,23,70,
6450,639,42,37,79,
6451,606,48,44,92,
6452,601,46,33,79,
6453,579,43,28,71,
6454,601,40,29,69,
6455,600,37,30,67,
6456,640,47,46,93,
6457,661,48,46,94,
6458,622,47,43,90,
6459,622,43,30,73,
6460,602,52,41,93,
6461,588,40,31,71,
6462,647,47,50,97,
6463,633,42,39,81,
6464,615,46,32,78,
6465,671,57,35,92,
6466,602,44,23,67,
6467,637,52,35,87,
6468,615,41,49,90,
6469,654,40,37,77,
6470,626,44,32,76,
6471,651,49,38,87,
6472,578,43,33,76,
6473,644,39,28,67,
6474,614,56,37,93,
6475,592,47,37,84,
6476,675,57,43,100,
6477,619,44,32,76,
6478,590,44,27,71,
6479,614,58,35,93,
6480,640,50,44,94,
6481,612,43,53,96,
6482,615,42,39,81,
6483,627,47,33,80,
6484,618,48,42,90,
6485,605,36,33,69,
6486,610,49,35,84,
6487,654,48,35,83,
6488,615,43,36,79,
6489,611,48,32,80,
6490,588,42,37,79,
6491,618,49,41,90,
6492,637,45,35,80,
6493,661,51,34,85,
6494,630,42,37,79,
6495,589,44,32,76,
6496,615,45,34,79,
6497,589,37,37,74,
6498,613,49,30,79,
6499,633,41,22,63,
6500,582,43,33,76,
6501,636,52,32,84,
6502,635,42,42,84,
6503,654,58,44,102,
6504,636,48,44,92,
6505,626,48,29,77,
6506,603,44,34,78,
6507,597,38,35,73,
6508,586,38,26,64,
6509,644,44,44,88,
6510,595,41,30,71,
6511,641,52,56,108,
6512,639,36,41,77,
6513,574,40,40,80,
6514,646,35,38,73,
6515,617,49,28,77,
6516,609,51,34,85,
6517,620,45,37,82,
6518,614,45,23,68,
6519,576,44,33,77,
6520,625,44,28,72,
6521,609,38,43,81,
6522,657,47,37,84,
6523,606,35,41,76,
6524,620,45,37,82,
6525,636,42,44,86,
6526,655,45,33,78,
6527,617,39,33,72,
6528,598,45,34,79,
6529,648,54,27,81,
6530,624,47,35,82,
6531,668,46,34,80,
6532,620,48,42,90,
6533,683,54,38,92,
6534,633,40,38,78,
6535,640,61,33,94,
6536,611,44,30,74,
6537,614,37,40,77,
6538,595,58,30,88,
6539,624,49,37,86,
6540,613,40,44,84,
6541,644,37,35,72,
6542,590,32,31,63,
6543,634,41,33,74,
6544,624,54,29,83,
6545,639,34,32,66,
6546,627,47,31,78,
6547,612,42,23,65,
6548,616,42,29,71,
6549,620,52,23,75,
6550,654,48,36,84,
6551,661,49,35,84,
6552,631,41,21,62,
6553,616,37,39,76,
6554,622,42,34,76,
6555,621,43,33,76,
6556,666,65,31,96,
6557,641,44,36,80,
6558,654,54,39,93,
6559,630,56,45,101,
6560,605,45,31,76,
6561,578,51,36,87,
6562,601,28,40,68,
6563,647,43,30,73,
6564,576,40,30,70,
6565,665,48,39,87,
6566,611,49,36,85,
6567,626,37,45,82,
6568,602,53,33,86,
6569,632,46,36,82,
6570,600,38,45,83,
6571,615,52,34,86,
6572,610,48,29,77,
6573,601,45,28,73,
6574,651,53,42,95,
6575,647,38,46,84,
6576,630,48,43,91,
6577,606,48,43,91,
6578,632,43,31,74,
6579,609,51,49,100,
6580,618,46,32,78,
6581,643,50,35,85,
6582,590,32,46,78,
6583,630,49,45,94,
6584,636,42,46,88,
6585,666,46,45,91,
6586,636,55,36,91,
6587,627,50,37,87,
6588,603,53,40,93,
6589,560,36,28,64,
6590,584,38,38,76,
6591,632,31,31,62,
6592,631,41,41,82,
6593,601,40,37,77,
6594,611,40,29,69,
6595,651,43,35,78,
6596,613,52,28,80,
6597,594,50,24,74,
6598,574,42,26,68,
6599,571,41,46,87,
6600,619,42,32,74,
6601,594,37,41,78,
6602,550,45,30,75,
6603,622,46,39,85,
6604,587,39,25,64,
6605,590,47,40,87,
6606,646,59,31,90,
6607,667,45,36,81,
6608,618,37,27,64,
6609,590,49,28,77,
6610,585,41,35,76,
6611,635,36,33,69,
6612,649,57,30,87,
6613,603,53,29,82,
6614,621,48,29,77,
6615,613,66,38,104,
6616,639,48,39,87,
6617,619,49,38,87,
6618,590,37,23,60,
6619,587,40,34,74,
6620,637,48,45,93,
6621,589,47,32,79,
6622,620,46,35,81,
6623,652,49,39,88,
6624,614,50,42,92,
6625,591,57,31,88,
6626,668,47,55,102,
6627,623,55,41,96,
6628,665,50,38,88,
6629,636,50,34,84,
6630,633,45,34,79,
6631,622,44,27,71,
6632,640,29,23,52,
6633,619,50,39,89,
6634,603,44,37,81,
6635,608,31,48,79,
6636,664,31,38,69,
6637,611,38,53,91,
6638,637,37,31,68,
6639,574,29,40,69,
6640,670,52,38,90,
6641,625,50,31,81,
6642,609,37,28,65,
6643,625,53,38,91,
6644,618,38,33,71,
6645,616,44,31,75,
6646,606,39,25,64,
6647,579,47,39,86,
6648,582,34,30,64,
6649,611,48,30,78,
6650,605,36,33,69,
6651,608,44,31,75,
6652,580,36,34,70,
6653,653,65,25,90,
6654,658,47,38,85,
6655,600,37,34,71,
6656,585,43,31,74,
6657,588,40,22,62,
6658,616,43,41,84,
6659,666,53,35,88,
6660,672,46,40,86,
6661,640,42,31,73,
6662,648,38,44,82,
6663,610,48,36,84,
6664,588,51,30,81,
6665,605,52,32,84,
6666,675,53,39,92,
6667,630,60,41,101,
6668,587,39,32,71,
6669,542,39,34,73,
6670,613,49,35,84,
6671,632,50,38,88,
6672,570,31,32,63,
6673,592,33,39,72,
6674,644,45,26,71,
6675,551,38,33,71,
6676,636,50,35,85,
6677,640,44,34,78,
6678,647,53,31,84,
6679,646,36,37,73,
6680,585,36,37,73,
6681,650,74,36,110,
6682,644,43,41,84,
6683,620,46,36,82,
6684,602,43,33,76,
6685,596,47,38,85,
6686,633,45,42,87,
6687,608,52,33,85,
6688,654,56,44,100,
6689,619,52,42,94,
6690,639,54,39,93,
6691,622,51,43,94,
6692,607,41,29,70,
6693,636,42,33,75,
6694,605,29,29,58,
6695,609,37,31,68,
6696,613,50,37,87,
6697,630,51,36,87,
6698,584,43,33,76,
6699,622,35,29,64,
6700,681,48,40,88,
6701,652,39,38,77,
6702,680,48,38,86,
6703,588,39,40,79,
6704,618,54,43,97,
6705,578,28,29,57,
6706,600,51,43,94,
6707,604,41,34,75,
6708,585,35,28,63,
6709,613,38,42,80,
6710,650,43,40,83,
6711,623,53,34,87,
6712,605,37,38,75,
6713,583,41,32,73,
6714,605,30,40,70,
6715,583,53,33,86,
6716,628,40,36,76,
6717,602,37,36,73,
6718,572,42,32,74,
6719,600,46,43,89,
6720,618,50,32,82,
6721,647,50,34,84,
6722,619,42,35,77,
6723,648,52,27,79,
6724,598,45,34,79,
6725,605,40,53,93,
6726,568,43,29,72,
6727,603,49,31,80,
6728,616,50,32,82,
6729,588,34,41,75,
6730,673,43,40,83,
6731,601,46,37,83,
6732,614,46,31,77,
6733,619,56,35,91,
6734,622,54,28,82,
6735,615,38,34,72,
6736,637,35,32,67,
6737,685,50,32,82,
6738,615,48,34,82,
6739,651,58,49,107,
6740,581,44,28,72,
6741,684,50,41,91,
6742,605,38,31,69,
6743,609,40,33,73,
6744,618,31,48,79,
6745,601,42,32,74,
6746,678,50,34,84,
6747,576,51,39,90,
6748,610,46,37,83,
6749,613,40,24,64,
6750,636,53,41,94,
6751,581,44,37,81,
6752,621,46,28,74,
6753,599,63,30,93,
6754,617,47,35,82,
6755,632,55,35,90,
6756,631,48,28,76,
6757,621,48,35,83,
6758,653,35,47,82,
6759,599,39,35,74,
6760,604,54,35,89,
6761,639,48,45,93,
6762,615,44,33,77,
6763,649,49,39,88,
6764,567,36,28,64,
6765,652,51,31,82,
6766,645,52,26,78,
6767,615,40,33,73,
6768,642,43,41,84,
6769,619,62,34,96,
6770,621,52,32,84,
6771,566,40,27,67,
6772,651,52,42,94,
6773,643,47,34,81,
6774,611,32,32,64,
6775,574,49,33,82,
6776,625,42,34,76,
6777,595,46,30,76,
6778,612,47,38,85,
6779,639,42,39,81,
6780,602,45,14,59,
6781,644,50,30,80,
6782,601,33,31,64,
6783,615,41,28,69,
6784,542,39,33,72,
6785,587,46,37,83,
6786,614,43,33,76,
6787,590,44,28,72,
6788,599,54,36,90,
6789,580,47,30,77,
6790,606,38,28,66,
6791,637,42,36,78,
6792,674,62,36,98,
6793,645,41,34,75,
6794,617,56,35,91,
6795,601,38,36,74,
6796,633,46,35,81,
6797,638,49,36,85,
6798,582,37,21,58,
6799,596,49,33,82,
6800,564,47,33,80,
6801,603,44,20,64,
6802,600,52,31,83,
6803,590,46,35,81,
6804,606,50,30,80,
6805,590,41,36,77,
6806,591,50,29,79,
6807,669,52,36,88,
6808,569,41,38,79,
6809,570,46,27,73,
6810,631,42,33,75,
6811,610,47,25,72,
6812,613,51,25,76,
6813,630,53,30,83,
6814,592,29,38,67,
6815,677,39,37,76,
6816,621,42,33,75,
6817,624,44,44,88,
6818,621,51,37,88,
6819,599,41,37,78,
6820,581,50,24,74,
6821,623,45,31,76,
6822,566,47,22,69,
6823,599,50,34,84,
6824,611,37,40,77,
6825,600,44,33,77,
6826,597,43,28,71,
6827,656,61,46,107,
6828,642,44,38,82,
6829,587,40,39,79,
6830,568,37,35,72,
6831,649,44,30,74,
6832,634,47,43,90,
6833,593,38,33,71,
6834,629,49,44,93,
6835,631,43,41,84,
6836,596,37,47,84,
6837,617,46,32,78,
6838,667,50,45,95,
6839,598,31,42,73,
6840,627,48,28,76,
6841,620,35,33,68,
6842,585,39,41,80,
6843,639,40,43,83,
6844,599,44,43,87,
6845,627,49,32,81,
6846,640,63,44,107,
6847,647,47,41,88,
6848,642,42,35,77,
6849,654,51,41,92,
6850,620,40,42,82,
6851,594,49,33,82,
6852,636,44,33,77,
6853,656,46,35,81,
6854,663,40,43,83,
6855,596,35,35,70,
6856,627,34,36,70,
6857,613,41,43,84,
6858,661,47,25,72,
6859,593,47,27,74,
6860,602,33,36,69,
6861,600,42,25,67,
6862,619,47,37,84,
6863,587,35,38,73,
6864,632,43,35,78,
6865,606,48,31,79,
6866,639,47,32,79,
6867,662,48,38,86,
6868,640,36,48,84,
6869,571,38,30,68,
6870,640,50,31,81,
6871,603,47,23,70,
6872,643,44,34,78,
6873,617,49,32,81,
6874,649,50,41,91,
6875,613,49,35,84,
6876,585,50,38,88,
6877,664,46,39,85,
6878,582,43,35,78,
6879,640,45,37,82,
6880,574,40,34,74,
6881,578,49,49,98,
6882,649,46,44,90,
6883,652,61,33,94,
6884,603,52,26,78,
6885,627,52,32,84,
6886,556,49,27,76,
6887,593,42,36,78,
6888,586,45,28,73,
6889,610,38,47,85,
6890,628,43,29,72,
6891,609,45,32,77,
6892,666,58,43,101,
6893,601,47,31,78,
6894,601,51,31,82,
6895,636,33,34,67,
6896,614,38,32,70,
6897,639,43,38,81,
6898,583,47,27,74,
6899,565,38,30,68,
6900,595,37,33,70,
6901,589,43,45,88,
6902,589,40,28,68,
6903,632,45,41,86,
6904,639,43,33,76,
6905,598,41,34,75,
6906,639,53,33,86,
6907,653,55,28,83,
6908,607,28,35,63,
6909,613,51,34,85,
6910,606,38,36,74,
6911,610,37,47,84,
6912,579,38,29,67,
6913,607,44,38,82,
6914,573,40,38,78,
6915,603,53,34,87,
6916,612,35,40,75,
6917,595,46,38,84,
6918,568,47,39,86,
6919,629,43,36,79,
6920,599,43,29,72,
6921,637,55,32,87,
6922,614,65,35,100,
6923,674,55,41,96,
6924,580,52,29,81,
6925,627,52,38,90,
6926,619,33,44,77,
6927,605,38,24,62,
6928,679,51,37,88,
6929,631,35,33,68,
6930,613,45,36,81,
6931,636,53,27,80,
6932,597,51,37,88,
6933,622,50,26,76,
6934,607,59,39,98,
6935,592,48,27,75,
6936,619,34,26,60,
6937,635,47,47,94,
6938,641,51,48,99,
6939,629,40,33,73,
6940,585,51,29,80,
6941,660,40,38,78,
6942,602,48,50,98,
6943,673,52,43,95,
6944,576,51,35,86,
6945,612,35,27,62,
6946,627,59,34,93,
6947,622,51,37,88,
6948,670,51,46,97,
6949,595,43,47,90,
6950,640,43,42,85,
6951,627,49,33,82,
6952,622,47,26,73,
6953,614,46,21,67,
6954,601,42,34,76,
6955,631,39,35,74,
6956,592,36,35,71,
6957,636,46,50,96,
6958,662,49,26,75,
6959,658,47,31,78,
6960,595,48,35,83,
6961,622,52,45,97,
6962,601,50,28,78,
6963,651,53,35,88,
6964,665,48,25,73,
6965,618,42,42,84,
6966,602,32,26,58,
6967,534,44,19,63,
6968,649,41,28,69,
6969,604,39,41,80,
6970,592,47,31,78,
6971,612,33,32,65,
6972,601,42,45,87,
6973,602,35,32,67,
6974,610,41,34,75,
6975,552,44,21,65,
6976,617,47,35,82,
6977,575,41,44,85,
6978,589,46,29,75,
6979,622,47,21,68,
6980,614,43,39,82,
6981,617,53,31,84,
6982,607,51,41,92,
6983,622,45,20,65,
6984,582,43,33,76,
6985,613,42,46,88,
6986,588,51,37,88,
6987,655,42,38,80,
6988,634,48,42,90,
6989,611,35,36,71,
6990,599,46,29,75,
6991,632,46,29,75,
6992,642,43,34,77,
6993,610,50,32,82,
6994,640,47,45,92,
6995,575,37,33,70,
6996,587,44,32,76,
6997,621,43,39,82,
6998,615,44,30,74,
6999,593,40,38,78,
7000,607,42,33,75,
7001,588,45,34,79,
7002,659,49,29,78,
7003,611,36,39,75,
7004,586,40,32,72,
7005,629,42,28,70,
7006,618,50,32,82,
7007,629,53,43,96,
7008,640,55,24,79,
7009,587,50,41,91,
7010,593,31,38,69,
7011,597,41,34,75,
7012,618,39,40,79,
7013,585,47,31,78,
7014,662,46,36,82,
7015,575,45,38,83,
7016,606,49,32,81,
7017,645,47,39,86,
7018,632,45,40,85,
7019,617,49,40,89,
7020,639,46,43,89,
7021,618,31,31,62,
7022,617,43,32,75,
7023,614,44,28,72,
7024,605,40,32,72,
7025,632,46,39,85,
7026,642,61,30,91,
7027,598,42,31,73,
7028,645,42,36,78,
7029,662,43,34,77,
7030,597,50,34,84,
7031,637,39,36,75,
7032,608,47,44,91,
7033,658,44,25,69,
7034,644,50,38,88,
7035,609,49,26,75,
7036,663,44,37,81,
7037,648,49,50,99,
7038,629,38,34,72,
7039,654,41,39,80,
7040,600,40,32,72,
7041,621,49,24,73,
7042,615,46,24,70,
7043,555,44,22,66,
7044,600,48,39,87,
7045,581,43,37,80,
7046,626,49,39,88,
7047,610,40,29,69,
7048,646,47,38,85,
7049,644,40,35,75,
7050,594,52,26,78,
7051,605,34,41,75,
7052,577,45,25,70,
7053,623,43,38,81,
7054,678,41,36,77,
7055,600,52,31,83,
7056,676,47,32,79,
7057,611,44,29,73,
7058,613,57,24,81,
7059,649,45,44,89,
7060,584,40,37,77,
7061,638,48,36,84,
7062,601,54,37,91,
7063,635,62,40,102,
7064,594,36,33,69,
7065,632,48,35,83,
7066,646,48,49,97,
7067,644,56,45,101,
7068,628,42,44,86,
7069,618,58,33,91,
7070,596,44,32,76,
7071,650,47,39,86,
7072,647,45,30,75,
7073,658,42,40,82,
7074,597,36,32,68,
7075,622,46,30,76,
7076,663,52,36,88,
7077,591,37,33,70,
7078,607,53,32,85,
7079,585,33,35,68,
7080,591,39,32,71,
7081,623,47,35,82,
7082,621,40,35,75,
7083,612,32,36,68,
7084,602,38,39,77,
7085,616,48,30,78,
7086,622,45,32,77,
7087,626,42,35,77,
7088,610,47,20,67,
7089,640,48,35,83,
7090,634,48,40,88,
7091,581,56,34,90,
7092,631,41,37,78,
7093,617,48,46,94,
7094,634,41,50,91,
7095,663,54,42,96,
7096,641,46,37,83,
7097,700,42,44,86,
7098,628,41,45,86,
7099,638,44,40,84,
7100,592,44,40,84,
7101,627,41,32,73,
7102,622,51,41,92,
7103,638,41,29,70,
7104,629,50,34,84,
7105,582,34,35,69,
7106,640,46,34,80,
7107,646,47,43,90,
7108,587,40,25,65,
7109,586,37,38,75,
7110,616,42,36,78,
7111,595,38,37,75,
7112,572,48,40,88,
7113,638,43,41,84,
7114,642,48,30,78,
7115,667,53,46,99,
7116,647,41,39,80,
7117,589,45,32,77,
7118,603,42,40,82,
7119,575,45,33,78,
7120,641,54,34,88,
7121,644,51,45,96,
7122,610,35,35,70,
7123,607,42,28,70,
7124,672,54,38,92,
7125,621,49,43,92,
7126,603,37,38,75,
7127,633,49,31,80,
7128,673,44,49,93,
7129,569,34,29,63,
7130,557,39,30,69,
7131,670,53,29,82,
7132,623,70,30,100,
7133,596,40,33,73,
7134,661,51,28,79,
7135,634,47,29,76,
7136,553,43,32,75,
7137,594,48,30,78,
7138,583,36,25,61,
7139,612,39,32,71,
7140,597,43,35,78,
7141,631,42,32,74,
7142,589,39,40,79,
7143,602,44,33,77,
7144,569,34,30,64,
7145,624,39,34,73,
7146,611,46,41,87,
7147,586,50,33,83,
7148,629,44,40,84,
7149,631,46,28,74,
7150,668,55,42,97,
7151,634,47,43,90,
7152,621,49,31,80,
7153,619,49,30,79,
7154,599,50,34,84,
7155,650,50,40,90,
7156,612,44,41,85,
7157,600,52,38,90,
7158,633,58,27,85,
7159,560,47,28,75,
7160,623,52,38,90,
7161,626,31,41,72,
7162,652,44,31,75,
7163,643,37,36,73,
7164,635,37,38,75,
7165,617,31,42,73,
7166,612,47,26,73,
7167,628,57,23,80,
7168,582,49,35,84,
7169,596,44,32,76,
7170,618,47,39,86,
7171,628,56,33,89,
7172,654,35,36,71,
7173,640,46,37,83,
7174,610,55,45,100,
7175,639,45,42,87,
7176,607,42,37,79,
7177,578,46,28,74,
7178,620,49,38,87,
7179,627,52,45,97,
7180,621,45,43,88,
7181,588,54,36,90,
7182,636,43,37,80,
7183,610,40,35,75,
7184,571,57,43,100,
7185,628,47,40,87,
7186,632,56,29,85,
7187,628,48,45,93,
7188,645,48,37,85,
7189,657,46,36,82,
7190,600,53,32,85,
7191,590,42,24,66,
7192,664,54,39,93,
7193,654,48,41,89,
7194,595,50,34,84,
7195,629,53,32,85,
7196,596,46,28,74,
7197,615,48,37,85,
7198,592,45,35,80,
7199,598,45,35,80,
7200,586,42,32,74,
7201,618,47,45,92,
7202,620,47,36,83,
7203,650,45,45,90,
7204,622,43,32,75,
7205,576,34,24,58,
7206,612,46,34,80,
7207,650,43,35,78,
7208,589,49,32,81,
7209,580,35,36,71,
7210,596,40,35,75,
7211,605,42,26,68,
7212,677,48,36,84,
7213,591,45,28,73,
7214,632,42,35,77,
7215,581,49,29,78,
7216,628,46,33,79,
7217,603,52,39,91,
7218,661,50,30,80,
7219,625,49,27,76,
7220,611,47,44,91,
7221,607,45,34,79,
7222,558,47,32,79,
7223,635,58,40,98,
7224,558,51,35,86,
7225,661,48,39,87,
7226,626,49,24,73,
7227,589,47,37,84,
7228,626,50,29,79,
7229,612,38,44,82,
7230,607,47,29,76,
7231,618,46,32,78,
7232,632,45,36,81,
7233,622,45,30,75,
7234,613,39,28,67,
7235,629,40,38,78,
7236,614,49,30,79,
7237,628,42,39,81,
7238,617,53,35,88,
7239,628,44,44,88,
7240,642,49,34,83,
7241,639,51,37,88,
7242,623,43,39,82,
7243,639,47,37,84,
7244,638,50,28,78,
7245,608,49,31,80,
7246,622,44,45,89,
7247,622,59,38,97,
7248,615,39,31,70,
7249,645,35,34,69,
7250,634,49,28,77,
7251,608,47,48,95,
7252,612,52,28,80,
7253,615,48,36,84,
7254,638,38,32,70,
7255,606,51,43,94,
7256,621,44,40,84,
7257,628,46,40,86,
7258,607,44,27,71,
7259,672,42,50,92,
7260,584,42,40,82,
7261,677,41,37,78,
7262,654,46,39,85,
7263,654,44,37,81,
7264,598,43,32,75,
7265,570,44,31,75,
7266,625,58,32,90,
7267,628,50,37,87,
7268,639,57,29,86,
7269,597,41,29,70,
7270,634,41,39,80,
7271,637,50,31,81,
7272,609,38,30,68,
7273,581,44,30,74,
7274,600,44,34,78,
7275,623,27,42,69,
7276,598,38,39,77,
7277,591,45,33,78,
7278,569,44,31,75,
7279,625,37,40,77,
7280,618,57,30,87,
7281,573,42,41,83,
7282,594,44,39,83,
7283,640,43,37,80,
7284,621,46,40,86,
7285,654,51,31,82,
7286,590,37,31,68,
7287,600,39,27,66,
7288,660,43,41,84,
7289,641,45,35,80,
7290,594,49,24,73,
7291,608,44,40,84,
7292,607,44,24,68,
7293,631,37,43,80,
7294,640,44,38,82,
7295,607,50,28,78,
7296,624,47,36,83,
7297,586,39,25,64,
7298,642,49,45,94,
7299,663,48,34,82,
7300,648,48,35,83,
7301,609,51,25,76,
7302,620,41,38,79,
7303,630,39,34,73,
7304,609,47,41,88,
7305,626,47,33,80,
7306,641,55,32,87,
7307,635,36,31,67,
7308,647,39,33,72,
7309,613,50,38,88,
7310,647,53,40,93,
7311,647,36,32,68,
7312,648,37,32,69,
7313,587,36,34,70,
7314,612,39,26,65,
7315,611,53,32,85,
7316,552,41,31,72,
7317,579,49,32,81,
7318,610,42,24,66,
7319,545,44,37,81,
7320,664,33,35,68,
7321,582,45,33,78,
7322,651,52,31,83,
7323,623,45,43,88,
7324,619,53,46,99,
7325,606,41,27,68,
7326,597,47,42,89,
7327,614,53,34,87,
7328,607,36,28,64,
7329,576,44,39,83,
7330,629,46,33,79,
7331,568,41,35,76,
7332,619,54,25,79,
7333,616,34,36,70,
7334,628,53,44,97,
7335,595,43,40,83,
7336,577,47,46,93,
7337,644,41,44,85,
7338,600,50,27,77,
7339,673,52,37,89,
7340,615,50,32,82,
7341,631,43,28,71,
7342,642,43,42,85,
7343,621,43,34,77,
7344,559,38,25,63,
7345,578,48,38,86,
7346,608,40,38,78,
7347,637,45,35,80,
7348,686,62,35,97,
7349,635,51,33,84,
7350,582,45,37,82,
7351,615,41,39,80,
7352,599,44,30,74,
7353,627,47,35,82,
7354,560,45,42,87,
7355,591,48,32,80,
7356,615,49,39,88,
7357,654,41,43,84,
7358,631,48,39,87,
7359,639,45,32,77,
7360,638,46,41,87,
7361,618,44,29,73,
7362,620,37,30,67,
7363,641,44,42,86,
7364,636,47,35,82,
7365,624,45,41,86,
7366,635,48,41,89,
7367,624,38,38,76,
7368,647,39,33,72,
7369,638,47,35,82,
7370,594,36,37,73,
7371,595,43,29,72,
7372,606,58,42,100,
7373,641,33,46,79,
7374,654,47,33,80,
7375,587,40,39,79,
7376,623,29,24,53,
7377,634,37,33,70,
7378,617,49,34,83,
7379,593,29,37,66,
7380,583,46,35,81,
7381,625,65,30,95,
7382,608,50,43,93,
7383,597,44,34,78,
7384,603,38,25,63,
7385,620,41,41,82,
7386,651,51,40,91,
7387,631,52,34,86,
7388,626,38,43,81,
7389,604,51,31,82,
7390,581,40,40,80,
7391,600,37,27,64,
7392,566,59,36,95,
7393,605,33,29,62,
7394,613,45,42,87,
7395,607,52,32,84,
7396,607,33,36,69,
7397,635,39,45,84,
7398,679,63,42,105,
7399,585,39,40,79,
7400,658,43,38,81,
7401,596,42,28,70,
7402,610,36,39,75,
7403,631,46,30,76,
7404,597,52,30,82,
7405,627,39,38,77,
7406,603,43,34,77,
7407,585,49,34,83,
7408,621,52,41,93,
7409,645,59,28,87,
7410,626,39,34,73,
7411,587,47,30,77,
7412,629,39,37,76,
7413,634,43,31,74,
7414,625,36,39,75,
7415,603,43,30,73,
7416,636,47,44,91,
7417,628,32,32,64,
7418,625,41,23,64,
7419,591,37,36,73,
7420,605,42,34,76,
7421,608,50,43,93,
7422,667,46,36,82,
7423,600,39,35,74,
7424,640,42,50,92,
7425,579,47,25,72,
7426,659,43,37,80,
7427,684,45,38,83,
7428,567,46,38,84,
7429,584,38,31,69,
7430,600,38,33,71,
7431,649,40,41,81,
7432,664,45,43,88,
7433,642,42,49,91,
7434,630,46,29,75,
7435,609,44,33,77,
7436,633,41,33,74,
7437,577,44,37,81,
7438,598,41,37,78,
7439,628,49,37,86,
7440,642,50,42,92,
7441,655,37,33,70,
7442,593,37,31,68,
7443,583,31,37,68,
7444,625,43,42,85,
7445,630,38,40,78,
7446,622,50,40,90,
7447,614,47,35,82,
7448,658,48,30,78,
7449,567,32,27,59,
7450,632,27,47,74,
7451,658,53,30,83,
7452,628,53,38,91,
7453,602,34,31,65,
7454,611,50,40,90,
7455,661,36,39,75,
7456,617,50,40,90,
7457,633,51,34,85,
7458,597,48,39,87,
7459,666,52,42,94,
7460,588,46,33,79,
7461,640,48,38,86,
7462,619,35,35,70,
7463,616,49,47,96,
7464,631,49,33,82,
7465,622,49,37,86,
7466,606,39,29,68,
7467,629,40,39,79,
7468,669,55,40,95,
7469,617,44,39,83,
7470,599,47,33,80,
7471,624,44,30,74,
7472,594,43,41,84,
7473,618,44,38,82,
7474,621,37,31,68,
7475,611,44,38,82,
7476,611,47,33,80,
7477,597,41,39,80,
7478,589,37,32,69,
7479,637,44,36,80,
7480,626,44,26,70,
7481,614,41,28,69,
7482,652,55,30,85,
7483,658,42,41,83,
7484,601,37,26,63,
7485,634,44,37,81,
7486,587,55,28,83,
7487,630,33,42,75,
7488,586,42,24,66,
7489,629,35,23,58,
7490,635,40,45,85,
7491,675,56,38,94,
7492,655,56,29,85,
7493,626,53,31,84,
7494,645,44,44,88,
7495,615,37,27,64,
7496,621,55,42,97,
7497,657,54,31,85,
7498,602,42,36,78,
7499,617,43,25,68,
7500,650,47,44,91,
7501,651,43,46,89,
7502,606,56,32,88,
7503,624,38,35,73,
7504,620,42,40,82,
7505,624,48,42,90,
7506,650,39,37,76,
7507,585,38,30,68,
7508,601,41,38,79,
7509,631,44,19,63,
7510,644,36,45,81,
7511,615,46,39,85,
7512,640,47,31,78,
7513,599,40,27,67,
7514,612,46,37,83,
7515,618,40,45,85,
7516,574,36,35,71,
7517,609,45,29,74,
7518,606,39,37,76,
7519,589,38,30,68,
7520,580,34,39,73,
7521,619,41,28,69,
7522,619,42,27,69,
7523,654,45,39,84,
7524,650,47,36,83,
7525,593,39,31,70,
7526,633,41,34,75,
7527,668,43,40,83,
7528,601,56,27,83,
7529,635,44,38,82,
7530,639,46,37,83,
7531,598,34,35,69,
7532,564,38,39,77,
7533,611,46,44,90,
7534,641,50,34,84,
7535,630,46,34,80,
7536,597,38,37,75,
7537,593,50,29,79,
7538,634,48,34,82,
7539,590,47,32,79,
7540,609,44,33,77,
7541,627,38,30,68,
7542,598,45,24,69,
7543,629,47,32,79,
7544,616,48,26,74,
7545,617,52,32,84,
7546,586,36,29,65,
7547,644,40,25,65,
7548,576,34,33,67,
7549,621,45,34,79,
7550,598,44,30,74,
7551,616,48,38,86,
7552,610,55,34,89,
7553,669,38,35,73,
7554,579,56,33,89,
7555,588,43,28,71,
7556,600,48,41,89,
7557,623,59,31,90,
7558,626,55,46,101,
7559,576,40,26,66,
7560,645,42,38,80,
7561,674,52,41,93,
7562,647,45,43,88,
7563,594,45,33,78,
7564,600,49,27,76,
7565,564,37,19,56,
7566,621,43,50,93,
7567,546,41,35,76,
7568,622,47,29,76,
7569,655,55,32,87,
7570,602,50,28,78,
7571,618,48,40,88,
7572,628,56,37,93,
7573,631,51,34,85,
7574,611,39,41,80,
7575,645,45,29,74,
7576,588,34,26,60,
7577,650,37,36,73,
7578,614,35,36,71,
7579,619,42,40,82,
7580,655,47,39,86,
7581,627,52,37,89,
7582,614,45,41,86,
7583,637,49,44,93,
7584,609,44,35,79,
7585,560,40,24,64,
7586,619,43,31,74,
7587,639,49,38,87,
7588,593,33,35,68,
7589,623,33,35,68,
7590,615,54,23,77,
7591,648,45,38,83,
7592,662,55,39,94,
7593,617,52,30,82,
7594,646,47,37,84,
7595,593,36,43,79,
7596,634,51,36,87,
7597,590,37,18,55,
7598,637,38,26,64,
7599,643,35,36,71,
7600,603,49,30,79,
7601,589,33,26,59,
7602,612,39,32,71,
7603,706,54,38,92,
7604,611,54,33,87,
7605,604,43,39,82,
7606,639,48,43,91,
7607,662,53,38,91,
7608,591,55,33,88,
7609,655,56,34,90,
7610,637,48,40,88,
7611,626,47,37,84,
7612,637,41,32,73,
7613,638,52,45,97,
7614,603,52,33,85,
7615,638,49,41,90,
7616,642,43,30,73,
7617,597,50,36,86,
7618,664,60,38,98,
7619,658,45,44,89,
7620,666,48,41,89,
7621,633,44,40,84,
7622,618,39,36,75,
7623,624,44,41,85,
7624,600,34,34,68,
7625,623,45,33,78,
7626,573,36,16,52,
7627,619,55,30,85,
7628,609,55,33,88,
7629,609,36,36,72,
7630,599,52,33,85,
7631,587,47,33,80,
7632,631,47,39,86,
7633,602,47,32,79,
7634,623,43,32,75,
7635,620,45,38,83,
7636,626,45,40,85,
7637,627,40,42,82,
7638,642,42,48,90,
7639,615,49,33,82,
7640,647,41,32,73,
7641,598,49,37,86,
7642,612,51,18,69,
7643,550,41,48,89,
7644,630,52,33,85,
7645,625,44,34,78,
7646,622,37,24,61,
7647,614,44,25,69,
7648,639,41,34,75,
7649,606,51,41,92,
7650,658,49,34,83,
7651,650,47,40,87,
7652,622,45,25,70,
7653,630,38,34,72,
7654,655,57,43,100,
7655,685,34,36,70,
7656,628,46,29,75,
7657,634,40,38,78,
7658,619,47,36,83,
7659,629,47,45,92,
7660,637,44,31,75,
7661,600,35,34,69,
7662,579,39,36,75,
7663,612,42,40,82,
7664,604,59,30,89,
7665,641,48,38,86,
7666,607,52,32,84,
7667,635,54,40,94,
7668,679,57,41,98,
7669,611,40,32,72,
7670,617,43,28,71,
7671,586,38,30,68,
7672,597,51,32,83,
7673,621,53,32,85,
7674,610,37,45,82,
7675,607,38,32,70,
7676,640,35,27,62,
7677,559,39,34,73,
7678,634,53,35,88,
7679,636,46,39,85,
7680,589,55,29,84,
7681,634,51,32,83,
7682,679,51,39,90,
7683,648,43,44,87,
7684,624,40,33,73,
7685,624,46,31,77,
7686,640,36,37,73,
7687,691,41,41,82,
7688,627,32,36,68,
7689,586,42,38,80,
7690,597,48,34,82,
7691,579,40,28,68,
7692,607,39,37,76,
7693,649,52,41,93,
7694,647,41,37,78,
7695,587,44,26,70,
7696,626,46,37,83,
7697,653,48,39,87,
7698,598,47,36,83,
7699,647,35,32,67,
7700,656,55,46,101,
7701,558,41,42,83,
7702,614,37,32,69,
7703,633,43,37,80,
7704,653,51,36,87,
7705,631,50,34,84,
7706,611,44,40,84,
7707,616,44,34,78,
7708,615,39,30,69,
7709,636,46,30,76,
7710,598,51,25,76,
7711,640,51,36,87,
7712,579,48,39,87,
7713,597,47,34,81,
7714,637,58,35,93,
7715,635,45,27,72,
7716,660,44,37,81,
7717,616,51,36,87,
7718,579,30,37,67,
7719,660,53,40,93,
7720,657,55,36,91,
7721,643,37,49,86,
7722,620,39,36,75,
7723,622,51,34,85,
7724,610,38,41,79,
7725,637,43,36,79,
7726,614,35,42,77,
7727,641,50,35,85,
7728,588,44,32,76,
7729,621,45,36,81,
7730,630,53,58,111,
7731,590,52,33,85,
7732,610,47,28,75,
7733,584,33,29,62,
7734,627,47,41,88,
7735,624,50,36,86,
7736,610,55,35,90,
7737,622,51,34,85,
7738,646,47,37,84,
7739,647,50,31,81,
7740,628,47,38,85,
7741,650,45,42,87,
7742,650,58,38,96,
7743,611,39,31,70,
7744,605,55,27,82,
7745,590,41,36,77,
7746,592,39,39,78,
7747,617,37,44,81,
7748,629,49,28,77,
7749,566,48,27,75,
7750,606,41,43,84,
7751,632,43,37,80,
7752,626,51,38,89,
7753,599,56,37,93,
7754,631,47,40,87,
7755,610,35,38,73,
7756,565,42,24,66,
7757,631,47,34,81,
7758,607,45,33,78,
7759,628,42,36,78,
7760,614,49,40,89,
7761,620,39,43,82,
7762,650,31,32,63,
7763,617,48,39,87,
7764,647,44,37,81,
7765,639,49,33,82,
7766,601,36,38,74,
7767,593,40,26,66,
7768,620,37,34,71,
7769,641,44,33,77,
7770,589,44,31,75,
7771,606,37,24,61,
7772,660,40,35,75,
7773,609,49,44,93,
7774,624,51,47,98,
7775,635,56,35,91,
7776,599,48,36,84,
7777,629,43,34,77,
7778,588,47,26,73,
7779,624,54,32,86,
7780,649,43,38,81,
7781,586,37,37,74,
7782,609,46,30,76,
7783,611,45,27,72,
7784,628,34,28,62,
7785,604,39,33,72,
7786,650,42,39,81,
7787,591,54,35,89,
7788,609,56,42,98,
7789,610,45,38,83,
7790,628,44,31,75,
7791,604,44,33,77,
7792,587,44,32,76,
7793,617,43,35,78,
7794,618,33,23,56,
7795,659,40,40,80,
7796,684,40,37,77,
7797,665,47,42,89,
7798,667,50,32,82,
7799,629,48,31,79,
7800,661,51,41,92,
7801,607,42,36,78,
7802,611,36,43,79,
7803,636,36,35,71,
7804,645,43,48,91,
7805,635,55,33,88,
7806,588,53,34,87,
7807,598,51,40,91,
7808,618,47,44,91,
7809,645,45,43,88,
7810,634,38,45,83,
7811,597,44,34,78,
7812,601,42,33,75,
7813,602,53,38,91,
7814,614,43,34,77,
7815,650,48,32,80,
7816,617,42,37,79,
7817,592,41,39,80,
7818,627,50,31,81,
7819,600,48,34,82,
7820,582,39,36,75,
7821,632,55,28,83,
7822,620,44,27,71,
7823,624,43,40,83,
7824,573,52,34,86,
7825,619,52,25,77,
7826,588,47,31,78,
7827,625,44,44,88,
7828,628,35,44,79,
7829,603,41,38,79,
7830,630,51,47,98,
7831,606,44,32,76,
7832,595,42,36,78,
7833,689,65,37,102,
7834,670,53,43,96,
7835,602,32,27,59,
7836,629,40,35,75,
7837,639,48,40,88,
7838,643,48,40,88,
7839,621,44,41,85,
7840,622,53,29,82,
7841,645,36,36,72,
7842,621,39,33,72,
7843,644,56,38,94,
7844,648,48,39,87,
7845,620,53,34,87,
7846,604,40,45,85,
7847,594,43,33,76,
7848,618,47,43,90,
7849,630,45,33,78,
7850,580,47,35,82,
7851,637,46,34,80,
7852,610,50,28,78,
7853,629,42,39,81,
7854,657,37,33,70,
7855,625,29,39,68,
7856,620,46,29,75,
7857,625,47,38,85,
7858,633,51,33,84,
7859,653,45,35,80,
7860,665,42,37,79,
7861,600,45,29,74,
7862,599,51,33,84,
7863,609,49,31,80,
7864,620,30,42,72,
7865,663,49,42,91,
7866,667,45,48,93,
7867,641,51,42,93,
7868,631,55,32,87,
7869,663,43,45,88,
7870,622,50,41,91,
7871,601,50,32,82,
7872,616,36,50,86,
7873,644,56,51,107,
7874,636,51,39,90,
7875,622,38,37,75,
7876,611,50,46,96,
7877,662,41,39,80,
7878,596,42,34,76,
7879,639,60,37,97,
7880,665,53,38,91,
7881,612,56,30,86,
7882,636,42,36,78,
7883,608,41,44,85,
7884,632,49,37,86,
7885,636,52,42,94,
7886,670,63,45,108,
7887,639,49,29,78,
7888,604,48,44,92,
7889,660,58,38,96,
7890,670,52,37,89,
7891,593,51,40,91,
7892,641,57,26,83,
7893,601,64,38,102,
7894,594,45,42,87,
7895,626,47,22,69,
7896,617,49,35,84,
7897,615,52,34,86,
7898,627,46,29,75,
7899,587,43,41,84,
7900,627,48,35,83,
7901,610,39,27,66,
7902,607,42,36,78,
7903,621,43,27,70,
7904,631,45,30,75,
7905,605,43,29,72,
7906,683,44,36,80,
7907,618,41,32,73,
7908,619,60,37,97,
7909,594,36,28,64,
7910,647,42,42,84,
7911,632,43,47,90,
7912,585,43,33,76,
7913,571,44,36,80,
7914,572,35,24,59,
7915,614,44,38,82,
7916,643,51,49,100,
7917,624,47,37,84,
7918,684,51,33,84,
7919,612,54,47,101,
7920,641,48,31,79,
7921,619,47,32,79,
7922,574,45,28,73,
7923,630,45,37,82,
7924,671,50,36,86,
7925,590,48,35,83,
7926,652,48,47,95,
7927,587,41,31,72,
7928,622,53,33,86,
7929,582,39,30,69,
7930,670,57,32,89,
7931,624,45,33,78,
7932,700,56,41,97,
7933,633,55,37,92,
7934,684,55,29,84,
7935,644,45,43,88,
7936,614,46,32,78,
7937,625,45,32,77,
7938,591,54,41,95,
7939,639,45,36,81,
7940,611,44,30,74,
7941,586,35,32,67,
7942,587,43,39,82,
7943,635,49,23,72,
7944,629,46,28,74,
7945,614,46,33,79,
7946,601,62,29,91,
7947,617,47,28,75,
7948,673,41,33,74,
7949,610,50,40,90,
7950,604,43,40,83,
7951,623,51,34,85,
7952,606,44,36,80,
7953,635,46,37,83,
7954,629,39,42,81,
7955,621,44,37,81,
7956,638,47,30,77,
7957,618,40,32,72,
7958,628,43,35,78,
7959,633,35,44,79,
7960,659,58,46,104,
7961,613,49,40,89,
7962,617,36,37,73,
7963,625,60,35,95,
7964,600,38,43,81,
7965,583,40,25,65,
7966,628,46,42,88,
7967,598,50,38,88,
7968,621,43,45,88,
7969,604,51,37,88,
7970,599,50,21,71,
7971,584,43,37,80,
7972,639,38,28,66,
7973,641,51,22,73,
7974,601,47,32,79,
7975,589,34,43,77,
7976,622,30,36,66,
7977,644,44,39,83,
7978,615,43,29,72,
7979,613,46,23,69,
7980,641,42,46,88,
7981,617,43,34,77,
7982,578,36,29,65,
7983,590,46,33,79,
7984,595,37,31,68,
7985,638,53,38,91,
7986,618,42,39,81,
7987,647,39,32,71,
7988,648,47,30,77,
7989,584,45,35,80,
7990,591,40,28,68,
7991,609,46,33,79,
7992,583,36,26,62,
7993,630,46,36,82,
7994,667,45,30,75,
7995,646,50,46,96,
7996,615,41,41,82,
7997,640,52,40,92,
7998,597,55,31,86,
7999,581,53,39,92,
8000,624,47,40,87,
8001,591,36,29,65,
8002,611,40,33,73,
8003,651,49,34,83,
8004,625,48,46,94,
8005,631,39,34,73,
8006,604,44,42,86,
8007,660,42,37,79,
8008,643,48,32,80,
8009,567,38,36,74,
8010,629,36,39,75,
8011,612,47,36,83,
8012,624,40,35,75,
8013,582,42,27,69,
8014,594,46,37,83,
8015,607,41,37,78,
8016,640,49,42,91,
8017,605,45,36,81,
8018,628,35,39,74,
8019,616,47,33,80,
8020,644,64,32,96,
8021,636,52,31,83,
8022,631,49,42,91,
8023,615,49,31,80,
8024,648,60,33,93,
8025,655,36,43,79,
8026,646,44,38,82,
8027,591,49,25,74,
8028,640,50,26,76,
8029,597,55,21,76,
8030,621,38,39,77,
8031,627,53,48,101,
8032,654,42,50,92,
8033,637,39,48,87,
8034,618,37,30,67,
8035,600,41,35,76,
8036,620,31,24,55,
8037,606,40,35,75,
8038,611,49,36,85,
8039,621,46,31,77,
8040,658,37,29,66,
8041,612,45,28,73,
8042,610,43,30,73,
8043,597,36,30,66,
8044,626,32,24,56,
8045,645,38,48,86,
8046,633,44,35,79,
8047,604,37,29,66,
8048,634,56,41,97,
8049,581,34,28,62,
8050,639,49,35,84,
8051,613,43,36,79,
8052,614,47,47,94,
8053,631,42,39,81,
8054,643,43,29,72,
8055,646,47,36,83,
8056,652,44,36,80,
8057,629,34,37,71,
8058,572,46,31,77,
8059,668,48,40,88,
8060,631,44,33,77,
8061,630,48,34,82,
8062,581,38,40,78,
8063,638,51,41,92,
8064,553,34,31,65,
8065,619,39,35,74,
8066,596,49,28,77,
8067,615,47,36,83,
8068,623,44,33,77,
8069,587,40,35,75,
8070,614,36,42,78,
8071,634,34,38,72,
8072,602,47,39,86,
8073,622,45,35,80,
8074,640,44,41,85,
8075,577,49,28,77,
8076,628,41,26,67,
8077,662,56,36,92,
8078,602,50,36,86,
8079,583,49,28,77,
8080,563,42,29,71,
8081,587,50,37,87,
8082,592,32,35,67,
8083,600,62,20,82,
8084,577,39,34,73,
8085,641,52,43,95,
8086,601,35,33,68,
8087,637,46,32,78,
8088,672,51,38,89,
8089,632,42,35,77,
8090,637,36,40,76,
8091,615,44,43,87,
8092,576,45,35,80,
8093,619,35,43,78,
8094,596,47,39,86,
8095,641,44,54,98,
8096,627,58,33,91,
8097,629,51,44,95,
8098,656,45,41,86,
8099,602,49,29,78,
8100,664,54,40,94,
8101,616,47,33,80,
8102,623,48,36,84,
8103,626,51,36,87,
8104,643,50,31,81,
8105,587,33,45,78,
8106,636,46,33,79,
8107,607,50,31,81,
8108,667,43,39,82,
8109,598,46,29,75,
8110,645,57,34,91,
8111,634,36,32,68,
8112,655,48,33,81,
8113,612,55,20,75,
8114,588,37,37,74,
8115,625,46,34,80,
8116,629,36,33,69,
8117,690,56,42,98,
8118,588,30,44,74,
8119,629,41,41,82,
8120,622,55,37,92,
8121,609,50,33,83,
8122,614,51,33,84,
8123,625,42,35,77,
8124,646,68,33,101,
8125,675,41,36,77,
8126,634,53,37,90,
8127,574,46,36,82,
8128,626,61,31,92,
8129,594,46,44,90,
8130,658,46,42,88,
8131,591,36,33,69,
8132,591,37,27,64,
8133,620,45,32,77,
8134,596,41,39,80,
8135,598,45,30,75,
8136,590,53,40,93,
8137,639,40,36,76,
8138,625,57,29,86,
8139,592,41,24,65,
8140,605,62,36,98,
8141,606,43,42,85,
8142,666,51,39,90,
8143,585,57,27,84,
8144,582,42,32,74,
8145,639,40,36,76,
8146,614,41,32,73,
8147,611,45,29,74,
8148,633,38,38,76,
8149,608,51,40,91,
8150,652,45,36,81,
8151,606,39,38,77,
8152,633,36,45,81,
8153,649,50,32,82,
8154,611,42,33,75,
8155,575,44,30,74,
8156,650,39,39,78,
8157,643,54,42,96,
8158,647,47,41,88,
8159,617,50,37,87,
8160,631,40,39,79,
8161,602,42,42,84,
8162,643,43,35,78,
8163,598,31,32,63,
8164,615,55,34,89,
8165,587,43,33,76,
8166,636,43,36,79,
8167,603,48,34,82,
8168,617,46,35,81,
8169,626,38,41,79,
8170,643,53,36,89,
8171,608,42,33,75,
8172,630,46,41,87,
8173,637,50,31,81,
8174,697,38,36,74,
8175,618,39,30,69,
8176,618,43,25,68,
8177,572,38,48,86,
8178,622,43,27,70,
8179,559,39,34,73,
8180,593,44,28,72,
8181,629,52,40,92,
8182,569,46,30,76,
8183,595,41,33,74,
8184,592,42,30,72,
8185,629,37,46,83,
8186,636,55,49,104,
8187,627,52,38,90,
8188,618,47,37,84,
8189,630,52,34,86,
8190,583,42,26,68,
8191,606,40,44,84,
8192,670,51,39,90,
8193,654,56,42,98,
8194,633,33,32,65,
8195,683,49,44,93,
8196,633,48,37,85,
8197,594,49,40,89,
8198,616,34,37,71,
8199,598,44,27,71,
8200,577,38,28,66,
8201,612,51,45,96,
8202,579,42,39,81,
8203,638,45,31,76,
8204,640,56,36,92,
8205,592,43,40,83,
8206,614,52,35,87,
8207,589,34,34,68,
8208,629,45,27,72,
8209,587,48,35,83,
8210,620,39,29,68,
8211,640,51,28,79,
8212,671,34,37,71,
8213,609,45,32,77,
8214,577,40,39,79,
8215,572,38,32,70,
8216,605,52,37,89,
8217,567,36,38,74,
8218,668,50,39,89,
8219,618,39,34,73,
8220,579,33,30,63,
8221,646,37,37,74,
8222,618,44,36,80,
8223,646,52,44,96,
8224,623,51,37,88,
8225,602,49,39,88,
8226,657,42,37,79,
8227,604,45,33,78,
8228,620,46,37,83,
8229,568,53,30,83,
8230,585,44,38,82,
8231,573,45,36,81,
8232,617,41,36,77,
8233,618,50,25,75,
8234,615,42,27,69,
8235,639,53,40,93,
8236,641,43,42,85,
8237,612,47,45,92,
8238,609,55,33,88,
8239,612,45,34,79,
8240,571,34,31,65,
8241,624,45,33,78,
8242,595,38,36,74,
8243,623,46,29,75,
8244,630,39,33,72,
8245,592,29,39,68,
8246,595,44,24,68,
8247,598,37,39,76,
8248,626,48,31,79,
8249,622,44,30,74,
8250,635,48,39,87,
8251,628,46,39,85,
8252,630,46,30,76,
8253,588,50,29,79,
8254,620,33,52,85,
8255,637,37,36,73,
8256,630,48,31,79,
8257,614,55,35,90,
8258,598,51,28,79,
8259,642,43,39,82,
8260,626,43,40,83,
8261,622,48,39,87,
8262,584,43,49,92,
8263,610,47,40,87,
8264,596,45,33,78,
8265,604,50,33,83,
8266,613,41,36,77,
8267,662,47,48,95,
8268,651,42,45,87,
8269,621,41,40,81,
8270,642,48,38,86,
8271,642,46,24,70,
8272,617,49,34,83,
8273,628,40,26,66,
8274,600,32,40,72,
8275,619,44,27,71,
8276,587,41,30,71,
8277,620,45,37,82,
8278,641,44,28,72,
8279,604,48,44,92,
8280,597,48,29,77,
8281,585,38,30,68,
8282,600,44,39,83,
8283,678,53,36,89,
8284,603,50,32,82,
8285,570,45,32,77,
8286,588,35,35,70,
8287,627,49,40,89,
8288,679,58,38,96,
8289,605,32,34,66,
8290,647,54,34,88,
8291,614,40,33,73,
8292,598,35,38,73,
8293,625,49,32,81,
8294,605,49,34,83,
8295,591,61,32,93,
8296,631,52,28,80,
8297,615,46,42,88,
8298,593,43,36,79,
8299,609,45,35,80,
8300,594,42,31,73,
8301,575,34,31,65,
8302,633,43,35,78,
8303,664,38,38,76,
8304,629,46,41,87,
8305,609,42,23,65,
8306,612,34,33,67,
8307,601,42,29,71,
8308,609,56,26,82,
8309,637,49,45,94,
8310,652,49,44,93,
8311,603,43,39,82,
8312,606,62,37,99,
8313,651,51,37,88,
8314,589,39,35,74,
8315,628,39,42,81,
8316,608,46,46,92,
8317,582,48,33,81,
8318,566,33,35,68,
8319,621,48,36,84,
8320,651,55,31,86,
8321,602,42,31,73,
8322,598,48,36,84,
8323,645,45,33,78,
8324,580,38,28,66,
8325,646,39,42,81,
8326,613,39,40,79,
8327,639,38,42,80,
8328,602,38,31,69,
8329,617,53,38,91,
8330,637,40,40,80,
8331,584,33,28,61,
8332,619,50,39,89,
8333,606,29,37,66,
8334,654,47,45,92,
8335,622,46,34,80,
8336,628,54,32,86,
8337,683,50,41,91,
8338,616,53,29,82,
8339,637,50,42,92,
8340,602,43,42,85,
8341,602,43,36,79,
8342,664,52,38,90,
8343,588,37,32,69,
8344,703,55,52,107,
8345,638,39,40,79,
8346,603,45,32,77,
8347,629,42,32,74,
8348,639,37,35,72,
8349,643,39,31,70,
8350,602,60,41,101,
8351,607,40,36,76,
8352,616,37,36,73,
8353,623,39,28,67,
8354,602,58,25,83,
8355,609,38,45,83,
8356,620,52,24,76,
8357,610,39,32,71,
8358,645,36,41,77,
8359,626,37,40,77,
8360,597,33,37,70,
8361,658,55,38,93,
8362,626,44,29,73,
8363,601,43,39,82,
8364,588,38,40,78,
8365,596,48,30,78,
8366,562,43,28,71,
8367,629,43,42,85,
8368,617,31,31,62,
8369,630,44,47,91,
8370,597,47,26,73,
8371,622,42,32,74,
8372,651,47,35,82,
8373,626,35,31,66,
8374,589,45,29,74,
8375,623,46,34,80,
8376,626,51,21,72,
8377,650,63,33,96,
8378,608,46,35,81,
8379,617,32,33,65,
8380,650,47,40,87,
8381,597,44,29,73,
8382,671,63,32,95,
8383,611,38,31,69,
8384,606,38,35,73,
8385,654,52,38,90,
8386,608,46,36,82,
8387,542,40,39,79,
8388,629,53,29,82,
8389,630,42,31,73,
8390,637,49,41,90,
8391,646,43,32,75,
8392,591,37,33,70,
8393,627,40,49,89,
8394,599,38,32,70,
8395,623,45,26,71,
8396,593,35,37,72,
8397,588,34,31,65,
8398,607,47,36,83,
8399,631,38,39,77,
8400,652,48,41,89,
8401,604,45,25,70,
8402,587,62,22,84,
8403,581,34,30,64,
8404,561,43,36,79,
8405,611,50,32,82,
8406,651,33,54,87,
8407,612,39,40,79,
8408,640,38,32,70,
8409,638,58,22,80,
8410,640,59,31,90,
8411,607,60,32,92,
8412,574,37,36,73,
8413,568,35,29,64,
8414,607,43,26,69,
8415,661,46,40,86,
8416,672,55,39,94,
8417,611,58,38,96,
8418,608,53,36,89,
8419,609,49,27,76,
8420,621,41,40,81,
8421,623,43,37,80,
8422,655,47,40,87,
8423,589,49,33,82,
8424,583,45,30,75,
8425,617,61,27,88,
8426,632,49,42,91,
8427,606,55,27,82,
8428,583,34,37,71,
8429,620,38,43,81,
8430,575,44,36,80,
8431,653,53,33,86,
8432,596,37,32,69,
8433,589,38,47,85,
8434,631,48,27,75,
8435,617,47,37,84,
8436,630,37,41,78,
8437,675,47,44,91,
8438,629,47,47,94,
8439,607,37,31,68,
8440,675,41,42,83,
8441,605,41,37,78,
8442,586,42,34,76,
8443,631,47,30,77,
8444,595,39,36,75,
8445,667,52,38,90,
8446,598,41,38,79,
8447,642,56,31,87,
8448,647,56,36,92,
8449,626,38,42,80,
8450,601,39,39,78,
8451,649,45,29,74,
8452,612,52,37,89,
8453,593,42,26,68,
8454,643,46,34,80,
8455,647,44,45,89,
8456,646,52,40,92,
8457,583,53,40,93,
8458,572,40,27,67,
8459,646,50,35,85,
8460,608,42,27,69,
8461,625,45,40,85,
8462,642,55,36,91,
8463,641,57,38,95,
8464,593,50,29,79,
8465,650,47,39,86,
8466,570,45,24,69,
8467,599,54,43,97,
8468,606,41,40,81,
8469,617,47,43,90,
8470,593,44,34,78,
8471,626,47,35,82,
8472,604,39,29,68,
8473,644,55,44,99,
8474,625,46,25,71,
8475,601,45,20,65,
8476,629,54,30,84,
8477,589,53,31,84,
8478,603,41,41,82,
8479,639,45,36,81,
8480,576,37,25,62,
8481,587,35,28,63,
8482,567,57,26,83,
8483,636,41,34,75,
8484,635,50,25,75,
8485,650,47,49,96,
8486,569,35,33,68,
8487,588,40,31,71,
8488,623,44,35,79,
8489,620,51,31,82,
8490,639,54,31,85,
8491,638,50,45,95,
8492,557,37,30,67,
8493,621,50,34,84,
8494,657,46,40,86,
8495,600,38,31,69,
8496,644,54,29,83,
8497,607,50,24,74,
8498,620,46,30,76,
8499,618,46,31,77,
8500,613,50,38,88,
8501,634,47,33,80,
8502,597,44,37,81,
8503,587,42,29,71,
8504,592,48,28,76,
8505,592,47,24,71,
8506,655,50,40,90,
8507,636,51,43,94,
8508,620,44,33,77,
8509,649,54,40,94,
8510,599,46,43,89,
8511,634,49,24,73,
8512,627,45,25,70,
8513,620,47,37,84,
8514,563,34,36,70,
8515,605,52,32,84,
8516,591,39,31,70,
8517,611,51,45,96,
8518,628,34,37,71,
8519,631,39,31,70,
8520,581,42,32,74,
8521,639,56,37,93,
8522,580,36,29,65,
8523,589,40,33,73,
8524,637,48,38,86,
8525,633,49,33,82,
8526,606,51,30,81,
8527,618,54,31,85,
8528,608,30,27,57,
8529,583,50,29,79,
8530,621,55,34,89,
8531,646,52,37,89,
8532,621,49,30,79,
8533,694,44,46,90,
8534,650,38,39,77,
8535,603,43,40,83,
8536,619,45,35,80,
8537,631,39,40,79,
8538,621,53,27,80,
8539,641,54,57,111,
8540,589,49,33,82,
8541,615,42,28,70,
8542,545,34,37,71,
8543,622,41,39,80,
8544,637,39,27,66,
8545,626,44,40,84,
8546,620,54,38,92,
8547,594,44,42,86,
8548,573,44,39,83,
8549,569,44,36,80,
8550,605,36,32,68,
8551,613,45,35,80,
8552,589,34,31,65,
8553,621,53,29,82,
8554,647,43,28,71,
8555,610,50,33,83,
8556,653,42,25,67,
8557,626,54,32,86,
8558,608,45,40,85,
8559,536,37,28,65,
8560,601,50,29,79,
8561,627,49,34,83,
8562,644,64,36,100,
8563,594,55,30,85,
8564,643,42,40,82,
8565,627,40,41,81,
8566,607,46,32,78,
8567,614,43,38,81,
8568,598,36,39,75,
8569,603,60,25,85,
8570,656,48,30,78,
8571,643,44,41,85,
8572,586,38,36,74,
8573,604,40,34,74,
8574,581,43,32,75,
8575,662,48,35,83,
8576,588,40,31,71,
8577,597,42,32,74,
8578,624,47,31,78,
8579,642,38,43,81,
8580,648,44,35,79,
8581,650,37,42,79,
8582,623,45,30,75,
8583,606,31,33,64,
8584,599,48,32,80,
8585,657,58,40,98,
8586,641,40,35,75,
8587,598,30,33,63,
8588,643,49,33,82,
8589,668,53,39,92,
8590,640,47,43,90,
8591,617,53,28,81,
8592,642,51,36,87,
8593,607,35,33,68,
8594,632,41,39,80,
8595,623,48,33,81,
8596,623,48,38,86,
8597,671,42,36,78,
8598,612,48,32,80,
8599,663,40,39,79,
8600,555,38,29,67,
8601,617,49,32,81,
8602,623,49,41,90,
8603,616,51,36,87,
8604,622,52,38,90,
8605,609,49,37,86,
8606,604,39,33,72,
8607,614,50,36,86,
8608,622,42,55,97,
8609,652,45,40,85,
8610,594,43,28,71,
8611,652,45,39,84,
8612,612,39,37,76,
8613,658,39,51,90,
8614,654,41,32,73,
8615,639,47,39,86,
8616,607,42,28,70,
8617,602,40,30,70,
8618,618,52,26,78,
8619,605,55,39,94,
8620,658,47,53,100,
8621,658,46,29,75,
8622,619,54,31,85,
8623,599,47,32,79,
8624,621,55,28,83,
8625,619,42,40,82,
8626,631,42,32,74,
8627,632,55,31,86,
8628,636,37,26,63,
8629,665,63,48,111,
8630,672,56,37,93,
8631,641,47,29,76,
8632,625,44,36,80,
8633,620,39,33,72,
8634,629,39,37,76,
8635,566,45,28,73,
8636,660,41,33,74,
8637,628,49,34,83,
8638,572,40,36,76,
8639,621,37,35,72,
8640,602,38,35,73,
8641,625,60,32,92,
8642,619,45,30,75,
8643,619,40,35,75,
8644,629,47,35,82,
8645,663,49,41,90,
8646,666,40,40,80,
8647,651,51,44,95,
8648,588,48,34,82,
8649,642,48,34,82,
8650,609,47,31,78,
8651,615,44,38,82,
8652,583,33,36,69,
8653,629,36,40,76,
8654,668,47,27,74,
8655,603,49,28,77,
8656,636,43,40,83,
8657,625,64,22,86,
8658,654,45,30,75,
8659,629,34,37,71,
8660,594,42,38,80,
8661,633,43,33,76,
8662,642,49,34,83,
8663,649,43,34,77,
8664,597,35,33,68,
8665,610,58,32,90,
8666,602,40,31,71,
8667,629,50,46,96,
8668,642,58,31,89,
8669,650,38,37,75,
8670,668,46,48,94,
8671,588,44,38,82,
8672,573,50,28,78,
8673,636,38,50,88,
8674,606,39,43,82,
8675,657,54,30,84,
8676,648,44,41,85,
8677,605,50,31,81,
8678,645,52,30,82,
8679,606,54,27,81,
8680,621,57,37,94,
8681,634,33,33,66,
8682,613,50,34,84,
8683,629,51,38,89,
8684,621,41,42,83,
8685,629,47,30,77,
8686,596,46,34,80,
8687,665,50,43,93,
8688,625,44,34,78,
8689,619,42,42,84,
8690,598,40,29,69,
8691,643,37,45,82,
8692,646,47,40,87,
8693,585,42,29,71,
8694,596,40,34,74,
8695,646,41,41,82,
8696,620,44,27,71,
8697,595,52,20,72,
8698,601,44,32,76,
8699,622,53,37,90,
8700,617,46,39,85,
8701,603,55,39,94,
8702,651,48,28,76,
8703,635,42,30,72,
8704,628,39,43,82,
8705,586,49,37,86,
8706,627,44,29,73,
8707,653,50,39,89,
8708,659,48,25,73,
8709,617,43,46,89,
8710,577,47,35,82,
8711,597,44,35,79,
8712,633,59,33,92,
8713,584,41,30,71,
8714,580,47,38,85,
8715,633,57,26,83,
8716,567,36,27,63,
8717,602,37,43,80,
8718,620,45,28,73,
8719,650,47,23,70,
8720,637,52,28,80,
8721,657,36,50,86,
8722,614,41,30,71,
8723,646,45,46,91,
8724,657,46,36,82,
8725,584,41,31,72,
8726,567,37,50,87,
8727,606,39,35,74,
8728,598,46,39,85,
8729,581,35,32,67,
8730,646,53,45,98,
8731,614,51,26,77,
8732,673,49,41,90,
8733,585,37,41,78,
8734,576,37,37,74,
8735,643,44,33,77,
8736,609,54,41,95,
8737,616,35,37,72,
8738,595,38,25,63,
8739,619,46,33,79,
8740,648,50,35,85,
8741,594,38,30,68,
8742,648,49,36,85,
8743,629,45,42,87,
8744,649,35,31,66,
8745,607,45,41,86,
8746,606,49,49,98,
8747,601,56,35,91,
8748,626,52,27,79,
8749,608,44,40,84,
8750,619,49,32,81,
8751,638,46,37,83,
8752,609,44,36,80,
8753,634,44,35,79,
8754,623,48,28,76,
8755,595,41,33,74,
8756,628,50,39,89,
8757,624,35,32,67,
8758,618,39,38,77,
8759,616,39,37,76,
8760,613,43,31,74,
8761,565,39,32,71,
8762,598,38,29,67,
8763,571,38,32,70,
8764,641,47,44,91,
8765,592,39,31,70,
8766,598,36,34,70,
8767,586,37,36,73,
8768,602,36,39,75,
8769,571,36,42,78,
8770,688,64,32,96,
8771,606,37,32,69,
8772,628,44,36,80,
8773,623,47,45,92,
8774,570,44,46,90,
8775,625,45,31,76,
8776,618,26,29,55,
8777,591,46,30,76,
8778,620,45,34,79,
8779,620,51,23,74,
8780,645,52,33,85,
8781,626,49,33,82,
8782,652,36,42,78,
8783,631,33,38,71,
8784,637,43,37,80,
8785,623,53,30,83,
8786,615,53,37,90,
8787,585,55,30,85,
8788,640,54,27,81,
8789,625,47,31,78,
8790,610,50,33,83,
8791,621,43,35,78,
8792,594,44,27,71,
8793,612,40,27,67,
8794,632,46,40,86,
8795,616,36,29,65,
8796,633,33,41,74,
8797,611,31,40,71,
8798,631,51,39,90,
8799,630,49,42,91,
8800,635,54,37,91,
8801,638,49,42,91,
8802,636,43,34,77,
8803,628,45,42,87,
8804,634,53,36,89,
8805,624,23,32,55,
8806,626,45,36,81,
8807,595,47,33,80,
8808,593,48,34,82,
8809,631,49,39,88,
8810,656,44,31,75,
8811,577,52,30,82,
8812,667,47,33,80,
8813,632,47,43,90,
8814,606,44,29,73,
8815,599,50,32,82,
8816,580,48,28,76,
8817,644,49,37,86,
8818,648,47,39,86,
8819,637,44,33,77,
8820,638,44,34,78,
8821,599,43,38,81,
8822,623,54,42,96,
8823,653,52,45,97,
8824,597,37,31,68,
8825,654,51,33,84,
8826,621,49,29,78,
8827,636,62,43,105,
8828,651,46,39,85,
8829,601,30,39,69,
8830,597,50,26,76,
8831,615,49,46,95,
8832,632,44,27,71,
8833,589,40,41,81,
8834,598,41,28,69,
8835,629,53,40,93,
8836,687,49,32,81,
8837,603,44,33,77,
8838,651,47,38,85,
8839,624,44,32,76,
8840,624,45,28,73,
8841,639,43,32,75,
8842,640,38,41,79,
8843,578,44,30,74,
8844,624,45,38,83,
8845,623,42,44,86,
8846,630,43,35,78,
8847,608,44,45,89,
8848,615,50,42,92,
8849,622,39,30,69,
8850,656,51,31,82,
8851,589,47,32,79,
8852,649,35,31,66,
8853,612,52,37,89,
8854,620,34,33,67,
8855,623,44,45,89,
8856,610,47,41,88,
8857,577,43,37,80,
8858,622,57,36,93,
8859,619,42,34,76,
8860,608,36,39,75,
8861,620,51,36,87,
8862,586,41,37,78,
8863,592,53,32,85,
8864,627,31,44,75,
8865,620,50,38,88,
8866,688,50,31,81,
8867,678,45,42,87,
8868,629,49,45,94,
8869,562,39,26,65,
8870,598,41,35,76,
8871,686,63,25,88,
8872,658,54,32,86,
8873,621,55,43,98,
8874,603,39,39,78,
8875,645,46,29,75,
8876,609,38,33,71,
8877,648,40,43,83,
8878,632,54,44,98,
8879,653,43,39,82,
8880,582,51,26,77,
8881,598,37,28,65,
8882,599,45,25,70,
8883,591,38,39,77,
8884,650,36,42,78,
8885,590,39,30,69,
8886,675,48,41,89,
8887,627,45,43,88,
8888,618,43,30,73,
8889,622,41,44,85,
8890,633,49,41,90,
8891,613,46,24,70,
8892,590,49,41,90,
8893,639,57,31,88,
8894,652,51,34,85,
8895,636,58,28,86,
8896,669,43,32,75,
8897,672,37,31,68,
8898,644,48,39,87,
8899,622,50,41,91,
8900,527,44,27,71,
8901,614,36,38,74,
8902,613,36,37,73,
8903,637,50,32,82,
8904,635,45,44,89,
8905,632,53,38,91,
8906,604,47,41,88,
8907,580,41,39,80,
8908,626,53,35,88,
8909,622,50,38,88,
8910,623,41,35,76,
8911,643,51,31,82,
8912,557,40,31,71,
8913,646,44,48,92,
8914,558,33,36,69,
8915,597,47,44,91,
8916,582,50,28,78,
8917,640,55,40,95,
8918,592,42,40,82,
8919,603,43,30,73,
8920,613,48,33,81,
8921,566,39,35,74,
8922,582,38,32,70,
8923,642,56,28,84,
8924,614,44,30,74,
8925,623,50,36,86,
8926,607,51,40,91,
8927,627,44,38,82,
8928,605,43,33,76,
8929,612,44,35,79,
8930,588,44,36,80,
8931,588,45,31,76,
8932,596,45,34,79,
8933,623,34,29,63,
8934,570,43,37,80,
8935,601,41,24,65,
8936,620,39,36,75,
8937,578,40,31,71,
8938,572,37,35,72,
8939,600,39,27,66,
8940,611,52,30,82,
8941,594,46,42,88,
8942,650,34,28,62,
8943,648,48,36,84,
8944,575,42,36,78,
8945,609,34,39,73,
8946,623,49,38,87,
8947,597,57,47,104,
8948,599,48,39,87,
8949,596,35,24,59,
8950,656,53,47,100,
8951,615,40,33,73,
8952,635,50,30,80,
8953,628,54,29,83,
8954,627,45,35,80,
8955,630,47,26,73,
8956,630,45,31,76,
8957,611,40,32,72,
8958,618,39,29,68,
8959,645,56,45,101,
8960,604,42,43,85,
8961,635,48,29,77,
8962,625,45,29,74,
8963,608,46,27,73,
8964,653,51,49,100,
8965,640,54,32,86,
8966,596,44,40,84,
8967,645,33,25,58,
8968,635,56,32,88,
8969,634,50,32,82,
8970,592,36,35,71,
8971,636,36,30,66,
8972,626,49,30,79,
8973,603,50,39,89,
8974,611,38,43,81,
8975,670,48,38,86,
8976,622,49,41,90,
8977,645,57,41,98,
8978,645,43,35,78,
8979,652,43,34,77,
8980,644,40,35,75,
8981,600,39,37,76,
8982,654,46,32,78,
8983,631,43,33,76,
8984,663,56,41,97,
8985,621,44,35,79,
8986,670,56,44,100,
8987,655,45,30,75,
8988,577,52,29,81,
8989,647,41,40,81,
8990,629,35,38,73,
8991,674,47,34,81,
8992,571,41,32,73,
8993,629,50,38,88,
8994,626,50,30,80,
8995,592,38,27,65,
8996,605,42,36,78,
8997,590,39,45,84,
8998,656,48,34,82,
8999,625,39,32,71,
9000,599,33,38,71,
9001,644,46,37,83,
9002,627,36,38,74,
9003,666,42,38,80,
9004,594,43,37,80,
9005,603,52,30,82,
9006,620,35,40,75,
9007,660,48,36,84,
9008,589,38,38,76,
9009,646,45,46,91,
9010,633,38,30,68,
9011,609,48,30,78,
9012,664,54,41,95,
9013,640,44,44,88,
9014,592,38,32,70,
9015,620,49,30,79,
9016,619,44,32,76,
9017,606,36,35,71,
9018,636,46,37,83,
9019,598,33,33,66,
9020,606,45,37,82,
9021,614,41,37,78,
9022,588,39,28,67,
9023,604,34,37,71,
9024,614,31,34,65,
9025,571,44,42,86,
9026,645,63,39,102,
9027,622,53,43,96,
9028,647,41,31,72,
9029,617,42,21,63,
9030,634,45,30,75,
9031,600,48,38,86,
9032,583,32,36,68,
9033,696,66,32,98,
9034,582,40,27,67,
9035,622,49,40,89,
9036,647,53,41,94,
9037,606,49,38,87,
9038,601,37,30,67,
9039,609,41,36,77,
9040,585,39,34,73,
9041,589,40,37,77,
9042,612,51,39,90,
9043,663,53,42,95,
9044,617,55,28,83,
9045,634,37,41,78,
9046,680,40,50,90,
9047,693,53,29,82,
9048,587,46,43,89,
9049,632,54,26,80,
9050,568,34,18,52,
9051,603,46,38,84,
9052,622,40,35,75,
9053,627,32,29,61,
9054,625,49,36,85,
9055,608,36,29,65,
9056,633,47,36,83,
9057,647,55,36,91,
9058,606,45,31,76,
9059,674,47,37,84,
9060,623,33,34,67,
9061,636,48,55,103,
9062,603,43,35,78,
9063,579,45,45,90,
9064,626,53,33,86,
9065,664,43,44,87,
9066,695,43,40,83,
9067,616,55,38,93,
9068,619,57,36,93,
9069,592,36,39,75,
9070,580,46,37,83,
9071,638,42,34,76,
9072,616,38,28,66,
9073,623,42,29,71,
9074,615,46,31,77,
9075,604,48,38,86,
9076,679,41,37,78,
9077,569,47,40,87,
9078,626,38,29,67,
9079,613,46,30,76,
9080,630,35,35,70,
9081,569,31,34,65,
9082,617,44,25,69,
9083,644,40,36,76,
9084,619,45,40,85,
9085,567,49,31,80,
9086,647,40,28,68,
9087,611,40,39,79,
9088,611,49,32,81,
9089,669,51,35,86,
9090,643,55,33,88,
9091,620,50,33,83,
9092,562,41,31,72,
9093,590,39,31,70,
9094,624,55,36,91,
9095,619,45,38,83,
9096,603,37,27,64,
9097,626,33,41,74,
9098,597,41,32,73,
9099,584,40,31,71,
9100,675,47,33,80,
9101,600,38,25,63,
9102,618,35,37,72,
9103,623,45,37,82,
9104,646,40,31,71,
9105,642,45,35,80,
9106,631,54,42,96,
9107,650,39,37,76,
9108,594,40,15,55,
9109,637,40,27,67,
9110,622,47,28,75,
9111,626,40,33,73,
9112,600,42,34,76,
9113,611,47,30,77,
9114,642,46,34,80,
9115,676,62,28,90,
9116,618,42,37,79,
9117,666,49,39,88,
9118,638,59,38,97,
9119,601,44,35,79,
9120,580,41,32,73,
9121,628,49,28,77,
9122,672,42,43,85,
9123,619,50,33,83,
9124,665,48,35,83,
9125,595,47,51,98,
9126,612,42,26,68,
9127,590,58,27,85,
9128,587,41,42,83,
9129,625,43,26,69,
9130,635,47,30,77,
9131,586,38,37,75,
9132,670,44,40,84,
9133,600,40,35,75,
9134,642,43,38,81,
9135,584,33,30,63,
9136,617,40,28,68,
9137,665,45,42,87,
9138,615,40,44,84,
9139,646,48,39,87,
9140,634,52,38,90,
9141,615,44,33,77,
9142,667,49,39,88,
9143,625,43,34,77,
9144,689,53,32,85,
9145,620,50,34,84,
9146,554,53,25,78,
9147,626,43,34,77,
9148,604,53,31,84,
9149,592,37,36,73,
9150,646,48,28,76,
9151,644,43,25,68,
9152,646,42,36,78,
9153,627,54,37,91,
9154,626,43,37,80,
9155,631,44,44,88,
9156,624,46,35,81,
9157,594,42,37,79,
9158,648,41,40,81,
9159,634,49,26,75,
9160,618,63,35,98,
9161,616,51,35,86,
9162,582,46,31,77,
9163,609,38,32,70,
9164,620,44,31,75,
9165,607,40,33,73,
9166,582,51,35,86,
9167,600,46,37,83,
9168,649,46,31,77,
9169,637,38,51,89,
9170,636,43,33,76,
9171,653,38,41,79,
9172,598,41,36,77,
9173,680,47,38,85,
9174,639,41,38,79,
9175,643,51,39,90,
9176,660,43,38,81,
9177,605,52,44,96,
9178,588,38,31,69,
9179,630,48,40,88,
9180,614,46,40,86,
9181,598,50,35,85,
9182,620,43,19,62,
9183,609,46,33,79,
9184,603,40,37,77,
9185,618,40,37,77,
9186,596,43,31,74,
9187,616,47,33,80,
9188,605,46,33,79,
9189,607,46,31,77,
9190,583,47,43,90,
9191,644,44,32,76,
9192,597,47,39,86,
9193,648,45,34,79,
9194,664,47,41,88,
9195,585,44,34,78,
9196,585,47,27,74,
9197,606,50,25,75,
9198,643,38,42,80,
9199,666,37,47,84,
9200,662,46,37,83,
9201,616,55,37,92,
9202,647,52,37,89,
9203,654,54,43,97,
9204,608,52,30,82,
9205,603,49,41,90,
9206,640,51,30,81,
9207,687,44,40,84,
9208,617,36,30,66,
9209,624,33,33,66,
9210,633,45,40,85,
9211,616,40,26,66,
9212,655,54,34,88,
9213,600,46,39,85,
9214,620,49,46,95,
9215,596,49,35,84,
9216,651,31,42,73,
9217,626,44,37,81,
9218,620,51,29,80,
9219,600,35,30,65,
9220,599,40,31,71,
9221,626,45,36,81,
9222,565,43,38,81,
9223,629,49,37,86,
9224,612,53,46,99,
9225,616,46,40,86,
9226,612,42,31,73,
9227,593,47,28,75,
9228,588,37,45,82,
9229,618,48,47,95,
9230,637,55,30,85,
9231,597,57,25,82,
9232,622,50,34,84,
9233,601,50,33,83,
9234,624,37,43,80,
9235,637,46,37,83,
9236,686,44,40,84,
9237,624,56,46,102,
9238,567,41,35,76,
9239,639,47,29,76,
9240,677,57,49,106,
9241,612,40,35,75,
9242,623,46,43,89,
9243,620,39,42,81,
9244,583,42,33,75,
9245,624,41,35,76,
9246,610,49,43,92,
9247,638,45,34,79,
9248,650,46,26,72,
9249,585,47,30,77,
9250,605,47,41,88,
9251,602,42,38,80,
9252,576,40,20,60,
9253,621,47,26,73,
9254,618,40,39,79,
9255,646,49,55,104,
9256,629,47,30,77,
9257,585,47,34,81,
9258,566,45,26,71,
9259,590,56,30,86,
9260,597,43,34,77,
9261,650,42,29,71,
9262,644,58,38,96,
9263,638,54,40,94,
9264,609,33,31,64,
9265,642,55,43,98,
9266,639,58,34,92,
9267,621,35,30,65,
9268,625,50,47,97,
9269,647,47,31,78,
9270,609,41,32,73,
9271,577,46,50,96,
9272,619,53,45,98,
9273,625,41,45,86,
9274,626,41,40,81,
9275,554,33,31,64,
9276,584,45,35,80,
9277,610,38,44,82,
9278,588,40,28,68,
9279,558,34,34,68,
9280,595,48,35,83,
9281,625,39,44,83,
9282,576,35,26,61,
9283,641,30,38,68,
9284,611,49,40,89,
9285,603,39,36,75,
9286,609,49,38,87,
9287,608,47,27,74,
9288,606,44,37,81,
9289,620,48,38,86,
9290,657,51,35,86,
9291,611,38,54,92,
9292,617,38,35,73,
9293,621,51,36,87,
9294,588,34,40,74,
9295,626,35,37,72,
9296,611,48,32,80,
9297,627,51,36,87,
9298,648,42,34,76,
9299,605,39,31,70,
9300,584,36,35,71,
9301,610,32,24,56,
9302,596,43,29,72,
9303,601,46,42,88,
9304,629,46,40,86,
9305,666,43,35,78,
9306,618,38,37,75,
9307,611,59,32,91,
9308,629,45,33,78,
9309,613,62,32,94,
9310,639,40,41,81,
9311,685,45,38,83,
9312,597,46,29,75,
9313,636,39,37,76,
9314,616,45,36,81,
9315,620,40,27,67,
9316,653,44,36,80,
9317,632,54,38,92,
9318,663,50,37,87,
9319,615,39,36,75,
9320,642,44,35,79,
9321,629,45,44,89,
9322,627,51,32,83,
9323,608,41,31,72,
9324,631,51,36,87,
9325,609,43,33,76,
9326,624,51,38,89,
9327,636,58,35,93,
9328,682,42,49,91,
9329,655,45,24,69,
9330,631,50,39,89,
9331,639,38,34,72,
9332,617,39,28,67,
9333,605,34,23,57,
9334,644,43,28,71,
9335,653,39,36,75,
9336,586,39,38,77,
9337,565,36,33,69,
9338,647,39,47,86,
9339,650,48,37,85,
9340,599,54,40,94,
9341,627,48,40,88,
9342,581,45,35,80,
9343,638,43,45,88,
9344,630,43,36,79,
9345,590,45,29,74,
9346,569,28,24,52,
9347,622,38,27,65,
9348,629,43,40,83,
9349,631,36,31,67,
9350,614,59,34,93,
9351,672,64,39,103,
9352,622,44,37,81,
9353,580,24,36,60,
9354,597,49,39,88,
9355,628,41,45,86,
9356,631,37,26,63,
9357,574,42,29,71,
9358,611,44,34,78,
9359,616,52,33,85,
9360,600,54,31,85,
9361,620,44,36,80,
9362,616,56,26,82,
9363,634,47,32,79,
9364,634,46,37,83,
9365,593,43,33,76,
9366,655,37,28,65,
9367,641,56,40,96,
9368,577,50,22,72,
9369,627,48,32,80,
9370,625,43,37,80,
9371,624,37,29,66,
9372,620,42,30,72,
9373,643,43,32,75,
9374,652,42,43,85,
9375,624,33,34,67,
9376,667,45,33,78,
9377,622,46,31,77,
9378,632,41,35,76,
9379,603,52,30,82,
9380,622,40,31,71,
9381,611,49,37,86,
9382,613,41,32,73,
9383,633,47,34,81,
9384,570,48,27,75,
9385,603,41,29,70,
9386,603,42,34,76,
9387,614,53,31,84,
9388,685,39,33,72,
9389,605,42,35,77,
9390,594,30,27,57,
9391,567,38,32,70,
9392,640,47,29,76,
9393,590,32,24,56,
9394,637,46,39,85,
9395,600,39,36,75,
9396,594,47,36,83,
9397,612,53,36,89,
9398,586,52,34,86,
9399,636,45,31,76,
9400,623,49,33,82,
9401,643,45,31,76,
9402,560,31,43,74,
9403,628,53,35,88,
9404,612,34,37,71,
9405,604,58,36,94,
9406,640,45,34,79,
9407,622,52,40,92,
9408,596,38,39,77,
9409,647,47,34,81,
9410,595,40,28,68,
9411,620,45,45,90,
9412,619,46,37,83,
9413,625,37,39,76,
9414,592,48,38,86,
9415,613,50,35,85,
9416,615,47,26,73,
9417,592,40,37,77,
9418,612,45,30,75,
9419,626,37,35,72,
9420,598,38,37,75,
9421,611,54,42,96,
9422,632,40,41,81,
9423,593,41,31,72,
9424,610,44,29,73,
9425,614,38,33,71,
9426,651,60,29,89,
9427,632,45,37,82,
9428,619,60,31,91,
9429,664,43,40,83,
9430,638,36,30,66,
9431,625,35,41,76,
9432,592,46,30,76,
9433,610,44,35,79,
9434,635,48,30,78,
9435,568,37,33,70,
9436,635,37,38,75,
9437,662,57,30,87,
9438,632,49,35,84,
9439,604,39,40,79,
9440,590,48,26,74,
9441,614,49,40,89,
9442,634,42,37,79,
9443,612,43,31,74,
9444,617,46,27,73,
9445,602,37,38,75,
9446,605,49,42,91,
9447,669,46,38,84,
9448,696,46,32,78,
9449,627,48,35,83,
9450,614,53,35,88,
9451,606,48,31,79,
9452,663,48,38,86,
9453,586,40,30,70,
9454,641,52,40,92,
9455,661,51,30,81,
9456,627,43,40,83,
9457,613,46,26,72,
9458,607,44,28,72,
9459,648,45,42,87,
9460,610,39,45,84,
9461,607,49,40,89,
9462,637,39,33,72,
9463,622,40,29,69,
9464,642,46,39,85,
9465,620,38,35,73,
9466,644,54,34,88,
9467,596,45,30,75,
9468,615,41,21,62,
9469,673,43,34,77,
9470,625,36,29,65,
9471,598,53,30,83,
9472,604,50,30,80,
9473,593,46,33,79,
9474,616,43,28,71,
9475,617,37,25,62,
9476,595,41,39,80,
9477,639,46,30,76,
9478,600,48,22,70,
9479,590,43,30,73,
9480,596,45,28,73,
9481,668,49,31,80,
9482,644,61,30,91,
9483,619,46,34,80,
9484,625,51,40,91,
9485,606,52,38,90,
9486,636,51,32,83,
9487,641,46,33,79,
9488,664,48,49,97,
9489,627,37,27,64,
9490,615,46,29,75,
9491,613,37,29,66,
9492,630,42,39,81,
9493,573,46,31,77,
9494,622,46,30,76,
9495,615,36,29,65,
9496,632,61,25,86,
9497,618,43,43,86,
9498,600,46,44,90,
9499,607,36,20,56,
9500,581,40,41,81,
9501,591,45,37,82,
9502,632,40,37,77,
9503,588,36,31,67,
9504,608,45,27,72,
9505,613,49,37,86,
9506,641,47,29,76,
9507,615,41,29,70,
9508,622,33,39,72,
9509,570,52,28,80,
9510,648,46,38,84,
9511,590,41,36,77,
9512,614,51,31,82,
9513,578,39,41,80,
9514,638,45,43,88,
9515,647,55,37,92,
9516,617,40,28,68,
9517,592,40,31,71,
9518,616,50,36,86,
9519,586,41,34,75,
9520,595,37,40,77,
9521,616,33,37,70,
9522,592,44,28,72,
9523,658,47,30,77,
9524,625,42,39,81,
9525,606,53,34,87,
9526,617,50,38,88,
9527,654,58,37,95,
9528,630,44,40,84,
9529,631,35,42,77,
9530,652,46,33,79,
9531,619,38,41,79,
9532,611,51,36,87,
9533,631,44,28,72,
9534,656,47,34,81,
9535,632,51,37,88,
9536,705,44,39,83,
9537,639,50,37,87,
9538,594,39,39,78,
9539,658,48,38,86,
9540,616,37,33,70,
9541,608,39,47,86,
9542,586,48,31,79,
9543,614,46,37,83,
9544,595,34,34,68,
9545,620,40,41,81,
9546,613,41,35,76,
9547,602,53,28,81,
9548,621,35,26,61,
9549,633,44,39,83,
9550,617,48,24,72,
9551,654,51,40,91,
9552,624,48,40,88,
9553,606,37,29,66,
9554,622,50,34,84,
9555,668,48,33,81,
9556,676,51,30,81,
9557,674,35,39,74,
9558,625,43,35,78,
9559,612,54,40,94,
9560,611,46,28,74,
9561,582,34,28,62,
9562,656,35,37,72,
9563,615,46,44,90,
9564,623,55,29,84,
9565,583,37,34,71,
9566,631,51,45,96,
9567,571,40,21,61,
9568,613,41,48,89,
9569,632,52,32,84,
9570,643,46,32,78,
9571,614,34,32,66,
9572,609,38,30,68,
9573,621,50,47,97,
9574,607,50,42,92,
9575,627,41,37,78,
9576,623,48,39,87,
9577,591,36,31,67,
9578,576,38,30,68,
9579,619,53,36,89,
9580,635,41,43,84,
9581,611,46,43,89,
9582,629,36,29,65,
9583,615,41,31,72,
9584,643,43,41,84,
9585,598,37,38,75,
9586,630,45,31,76,
9587,645,54,41,95,
9588,632,42,41,83,
9589,624,42,44,86,
9590,612,42,36,78,
9591,589,38,35,73,
9592,628,55,31,86,
9593,634,35,39,74,
9594,618,45,34,79,
9595,650,43,37,80,
9596,664,38,39,77,
9597,622,59,34,93,
9598,620,44,34,78,
9599,620,45,41,86,
9600,578,36,34,70,
9601,618,39,42,81,
9602,630,45,42,87,
9603,638,48,18,66,
9604,619,45,31,76,
9605,587,55,29,84,
9606,661,49,43,92,
9607,613,42,25,67,
9608,577,43,34,77,
9609,628,52,25,77,
9610,584,37,35,72,
9611,582,28,36,64,
9612,648,52,33,85,
9613,648,62,40,102,
9614,629,29,40,69,
9615,656,54,33,87,
9616,609,44,39,83,
9617,653,55,34,89,
9618,587,41,35,76,
9619,573,41,29,70,
9620,654,44,48,92,
9621,657,46,32,78,
9622,622,55,33,88,
9623,653,45,42,87,
9624,613,36,32,68,
9625,590,45,40,85,
9626,679,39,31,70,
9627,604,44,32,76,
9628,606,48,31,79,
9629,625,37,36,73,
9630,643,41,35,76,
9631,629,47,39,86,
9632,661,49,32,81,
9633,591,31,36,67,
9634,591,48,36,84,
9635,600,37,45,82,
9636,626,45,48,93,
9637,659,49,46,95,
9638,652,57,30,87,
9639,639,49,37,86,
9640,623,36,30,66,
9641,651,52,35,87,
9642,621,60,41,101,
9643,599,30,35,65,
9644,628,56,27,83,
9645,627,49,41,90,
9646,626,40,42,82,
9647,615,53,32,85,
9648,636,44,33,77,
9649,613,33,35,68,
9650,645,53,43,96,
9651,661,45,43,88,
9652,644,40,33,73,
9653,577,38,29,67,
9654,614,56,44,100,
9655,645,45,43,88,
9656,633,47,33,80,
9657,648,42,35,77,
9658,607,43,34,77,
9659,616,43,36,79,
9660,600,39,29,68,
9661,666,43,44,87,
9662,598,43,37,80,
9663,611,50,43,93,
9664,625,58,41,99,
9665,590,42,27,69,
9666,609,33,30,63,
9667,678,50,37,87,
9668,601,55,28,83,
9669,597,48,37,85,
9670,591,35,40,75,
9671,586,40,34,74,
9672,627,46,37,83,
9673,625,53,37,90,
9674,635,46,36,82,
9675,629,50,32,82,
9676,656,51,41,92,
9677,619,46,40,86,
9678,647,49,47,96,
9679,664,48,41,89,
9680,598,44,40,84,
9681,654,37,49,86,
9682,572,45,28,73,
9683,645,52,35,87,
9684,624,55,32,87,
9685,591,36,37,73,
9686,663,59,40,99,
9687,588,41,32,73,
9688,621,41,32,73,
9689,574,43,33,76,
9690,599,35,41,76,
9691,602,43,36,79,
9692,591,39,35,74,
9693,588,54,35,89,
9694,615,47,31,78,
9695,564,31,35,66,
9696,606,31,48,79,
9697,639,50,36,86,
9698,645,42,32,74,
9699,661,52,38,90,
9700,662,60,36,96,
9701,620,42,33,75,
9702,660,50,42,92,
9703,641,49,31,80,
9704,625,46,31,77,
9705,643,66,35,101,
9706,615,47,33,80,
9707,635,46,33,79,
9708,583,47,32,79,
9709,627,52,40,92,
9710,618,48,37,85,
9711,602,43,37,80,
9712,602,34,36,70,
9713,590,37,33,70,
9714,645,47,27,74,
9715,625,36,34,70,
9716,599,40,36,76,
9717,594,52,36,88,
9718,643,47,38,85,
9719,585,52,34,86,
9720,596,46,33,79,
9721,594,46,42,88,
9722,613,40,44,84,
9723,622,43,36,79,
9724,643,51,34,85,
9725,648,51,38,89,
9726,597,37,25,62,
9727,619,40,32,72,
9728,577,34,33,67,
9729,634,33,39,72,
9730,612,47,42,89,
9731,575,53,39,92,
9732,663,48,31,79,
9733,611,46,37,83,
9734,629,44,36,80,
9735,576,39,28,67,
9736,632,36,36,72,
9737,623,53,42,95,
9738,630,53,42,95,
9739,643,43,40,83,
9740,630,47,27,74,
9741,631,38,44,82,
9742,623,41,35,76,
9743,622,46,35,81,
9744,635,50,40,90,
9745,659,49,30,79,
9746,621,31,27,58,
9747,586,34,27,61,
9748,626,37,35,72,
9749,661,45,52,97,
9750,643,53,29,82,
9751,607,41,27,68,
9752,586,56,33,89,
9753,612,45,28,73,
9754,642,46,44,90,
9755,598,43,34,77,
9756,621,42,38,80,
9757,597,41,41,82,
9758,597,45,38,83,
9759,588,37,31,68,
9760,614,45,38,83,
9761,623,40,33,73,
9762,614,50,39,89,
9763,621,42,28,70,
9764,605,43,28,71,
9765,610,41,40,81,
9766,636,52,30,82,
9767,579,47,42,89,
9768,623,54,29,83,
9769,611,43,35,78,
9770,634,47,38,85,
9771,571,30,36,66,
9772,586,52,28,80,
9773,618,44,36,80,
9774,622,44,22,66,
9775,579,47,27,74,
9776,570,37,26,63,
9777,658,41,29,70,
9778,664,30,37,67,
9779,650,53,32,85,
9780,593,39,35,74,
9781,610,52,35,87,
9782,653,53,34,87,
9783,632,61,31,92,
9784,680,54,35,89,
9785,611,42,37,79,
9786,611,45,31,76,
9787,598,45,39,84,
9788,612,37,28,65,
9789,627,41,43,84,
9790,613,40,36,76,
9791,618,51,36,87,
9792,656,60,34,94,
9793,582,32,32,64,
9794,586,44,39,83,
9795,583,36,31,67,
9796,611,32,42,74,
9797,633,41,39,80,
9798,618,42,45,87,
9799,662,52,32,84,
9800,660,47,38,85,
9801,608,50,42,92,
9802,613,33,30,63,
9803,641,42,41,83,
9804,614,42,27,69,
9805,590,34,38,72,
9806,611,50,32,82,
9807,622,33,37,70,
9808,632,44,36,80,
9809,618,44,26,70,
9810,548,44,28,72,
9811,621,39,44,83,
9812,629,42,33,75,
9813,588,50,42,92,
9814,634,39,41,80,
9815,609,46,35,81,
9816,592,39,36,75,
9817,657,39,39,78,
9818,615,49,38,87,
9819,629,51,37,88,
9820,590,54,45,99,
9821,639,40,32,72,
9822,655,41,52,93,
9823,599,39,36,75,
9824,616,45,39,84,
9825,599,53,29,82,
9826,664,59,40,99,
9827,612,53,27,80,
9828,628,41,47,88,
9829,622,56,32,88,
9830,638,44,45,89,
9831,626,45,43,88,
9832,605,42,37,79,
9833,623,36,28,64,
9834,569,48,34,82,
9835,601,41,34,75,
9836,578,50,40,90,
9837,592,44,31,75,
9838,633,52,34,86,
9839,666,53,44,97,
9840,635,37,40,77,
9841,623,44,36,80,
9842,630,41,36,77,
9843,555,39,39,78,
9844,624,49,32,81,
9845,612,48,35,83,
9846,645,54,39,93,
9847,646,45,31,76,
9848,644,29,33,62,
9849,635,46,40,86,
9850,651,45,46,91,
9851,630,36,33,69,
9852,608,36,21,57,
9853,617,42,33,75,
9854,623,42,35,77,
9855,645,42,26,68,
9856,615,46,32,78,
9857,654,39,32,71,
9858,626,47,40,87,
9859,603,43,29,72,
9860,620,46,28,74,
9861,621,58,36,94,
9862,624,37,35,72,
9863,621,47,36,83,
9864,565,45,25,70,
9865,653,55,41,96,
9866,620,50,37,87,
9867,608,38,36,74,
9868,646,48,35,83,
9869,654,47,39,86,
9870,628,41,37,78,
9871,666,47,37,84,
9872,664,54,29,83,
9873,616,54,33,87,
9874,675,44,37,81,
9875,618,44,32,76,
9876,602,59,29,88,
9877,583,44,33,77,
9878,639,47,39,86,
9879,609,39,34,73,
9880,608,47,27,74,
9881,592,44,32,76,
9882,622,37,35,72,
9883,655,49,42,91,
9884,653,54,42,96,
9885,623,45,37,82,
9886,626,46,36,82,
9887,624,49,32,81,
9888,599,33,35,68,
9889,606,36,37,73,
9890,624,37,37,74,
9891,636,47,33,80,
9892,610,44,35,79,
9893,611,48,30,78,
9894,643,58,29,87,
9895,674,49,42,91,
9896,627,47,37,84,
9897,640,34,39,73,
9898,628,49,37,86,
9899,627,37,38,75,
9900,595,50,30,80,
9901,594,41,22,63,
9902,644,49,38,87,
9903,622,49,44,93,
9904,608,45,18,63,
9905,582,40,39,79,
9906,640,47,29,76,
9907,623,47,40,87,
9908,618,48,36,84,
9909,618,45,43,88,
9910,619,53,40,93,
9911,636,49,35,84,
9912,605,36,36,72,
9913,603,53,41,94,
9914,623,44,31,75,
9915,601,34,47,81,
9916,618,32,30,62,
9917,642,53,47,100,
9918,660,47,36,83,
9919,650,49,36,85,
9920,648,59,33,92,
9921,628,45,28,73,
9922,663,51,38,89,
9923,639,55,25,80,
9924,600,50,29,79,
9925,582,45,34,79,
9926,615,50,26,76,
9927,630,41,44,85,
9928,616,36,24,60,
9929,609,48,35,83,
9930,646,43,31,74,
9931,616,47,34,81,
9932,632,44,32,76,
9933,612,48,31,79,
9934,607,43,32,75,
9935,615,48,29,77,
9936,573,33,34,67,
9937,592,55,27,82,
9938,618,44,36,80,
9939,666,50,34,84,
9940,638,43,28,71,
9941,590,42,39,81,
9942,662,60,36,96,
9943,631,49,43,92,
9944,612,43,33,76,
9945,608,45,37,82,
9946,585,50,39,89,
9947,588,44,47,91,
9948,596,48,35,83,
9949,628,49,45,94,
9950,611,41,34,75,
9951,607,39,42,81,
9952,656,37,33,70,
9953,604,37,37,74,
9954,645,36,43,79,
9955,607,48,30,78,
9956,637,59,36,95,
9957,609,34,39,73,
9958,657,49,34,83,
9959,657,62,27,89,
9960,562,39,26,65,
9961,606,36,39,75,
9962,638,46,52,98,
9963,623,40,43,83,
9964,575,41,29,70,
9965,602,28,42,70,
9966,559,38,41,79,
9967,637,43,37,80,
9968,611,47,35,82,
9969,580,38,40,78,
9970,622,58,31,89,
9971,629,40,26,66,
9972,597,41,40,81,
9973,645,52,37,89,
9974,591,43,25,68,
9975,645,53,42,95,
9976,633,34,40,74,
9977,616,48,37,85,
9978,638,56,37,93,
9979,604,44,34,78,
9980,648,37,37,74,
9981,606,39,34,73,
9982,678,49,52,101,
9983,623,42,45,87,
9984,613,59,34,93,
9985,606,47,34,81,
9986,681,50,39,89,
9987,601,45,43,88,
9988,602,47,36,83,
9989,662,51,35,86,
9990,613,51,32,83,
9991,642,52,32,84,
9992,630,47,39,86,
9993,635,48,32,80,
9994,601,38,48,86,
9995,620,53,44,97,
9996,603,45,27,72,
9997,608,50,33,83,
9998,633,43,37,80,
9999,645,47,33,80,
