eventID,numPhotons,numReachedDown,numReachedUp,numPE,
0,801,57,45,102,
1,816,72,44,116,
2,802,74,40,114,
3,795,57,45,102,
4,863,67,51,118,
5,808,65,58,123,
6,801,74,47,121,
7,838,57,57,114,
8,807,61,57,118,
9,841,59,49,108,
10,854,64,47,111,
11,806,51,46,97,
12,792,52,39,91,
13,797,54,43,97,
14,844,64,43,107,
15,830,65,47,112,
16,876,64,52,116,
17,814,54,43,97,
18,792,73,33,106,
19,834,63,50,113,
20,806,55,42,97,
21,847,67,50,117,
22,818,58,50,108,
23,773,49,44,93,
24,792,51,53,104,
25,831,66,43,109,
26,820,66,53,119,
27,778,58,42,100,
28,814,58,41,99,
29,803,57,51,108,
30,903,58,54,112,
31,813,47,44,91,
32,847,53,39,92,
33,868,66,41,107,
34,817,56,55,111,
35,792,68,42,110,
36,751,48,48,96,
37,819,49,46,95,
38,791,70,43,113,
39,797,66,44,110,
40,781,54,36,90,
41,849,64,52,116,
42,814,55,48,103,
43,857,61,49,110,
44,838,50,62,112,
45,843,52,47,99,
46,816,62,38,100,
47,856,51,44,95,
48,869,71,45,116,
49,791,49,34,83,
50,758,58,36,94,
51,810,61,48,109,
52,822,57,55,112,
53,829,63,57,120,
54,765,61,34,95,
55,847,63,37,100,
56,801,63,41,104,
57,836,68,43,111,
58,830,57,44,101,
59,810,61,43,104,
60,816,61,48,109,
61,814,66,45,111,
62,854,75,46,121,
63,825,50,40,90,
64,839,54,45,99,
65,821,71,42,113,
66,844,58,38,96,
67,774,54,44,98,
68,820,59,39,98,
69,820,50,50,100,
70,831,53,33,86,
71,813,46,43,89,
72,839,66,52,118,
73,852,58,54,112,
74,843,70,45,115,
75,814,66,51,117,
76,833,57,47,104,
77,861,74,50,124,
78,745,43,31,74,
79,884,63,57,120,
80,813,67,49,116,
81,824,54,44,98,
82,834,64,41,105,
83,844,56,46,102,
84,841,71,52,123,
85,814,49,42,91,
86,826,50,43,93,
87,811,57,49,106,
88,842,76,49,125,
89,824,63,49,112,
90,890,68,49,117,
91,804,68,42,110,
92,804,58,49,107,
93,817,60,37,97,
94,827,53,46,99,
95,871,70,46,116,
96,772,56,35,91,
97,847,83,46,129,
98,810,44,50,94,
99,836,53,50,103,
100,866,60,53,113,
101,860,62,47,109,
102,811,54,46,100,
103,803,46,47,93,
104,816,57,43,100,
105,842,47,46,93,
106,790,54,46,100,
107,853,45,53,98,
108,907,54,51,105,
109,802,69,49,118,
110,880,74,44,118,
111,784,61,34,95,
112,874,53,62,115,
113,826,54,43,97,
114,813,37,52,89,
115,786,67,41,108,
116,846,56,57,113,
117,804,59,38,97,
118,818,64,53,117,
119,845,56,44,100,
120,819,53,49,102,
121,837,66,45,111,
122,833,54,49,103,
123,825,63,52,115,
124,872,60,51,111,
125,790,55,36,91,
126,778,50,53,103,
127,817,52,47,99,
128,764,54,47,101,
129,819,45,49,94,
130,797,60,36,96,
131,849,67,51,118,
132,833,59,48,107,
133,812,55,43,98,
134,800,51,33,84,
135,821,68,47,115,
136,814,58,34,92,
137,821,58,45,103,
138,866,56,40,96,
139,827,56,45,101,
140,850,56,40,96,
141,868,54,42,96,
142,772,50,38,88,
143,793,57,53,110,
144,808,59,45,104,
145,786,49,54,103,
146,828,69,44,113,
147,795,57,53,110,
148,797,62,51,113,
149,805,47,45,92,
150,827,74,40,114,
151,849,61,48,109,
152,788,64,39,103,
153,851,63,35,98,
154,824,64,44,108,
155,881,50,44,94,
156,812,52,40,92,
157,818,70,42,112,
158,873,61,51,112,
159,796,60,55,115,
160,814,53,51,104,
161,827,62,43,105,
162,790,59,36,95,
163,858,62,55,117,
164,835,51,47,98,
165,822,61,45,106,
166,838,56,55,111,
167,841,78,40,118,
168,756,53,40,93,
169,849,58,41,99,
170,796,49,53,102,
171,828,66,40,106,
172,791,78,48,126,
173,768,62,41,103,
174,804,53,43,96,
175,821,62,42,104,
176,883,69,39,108,
177,803,73,49,122,
178,872,68,46,114,
179,813,63,34,97,
180,842,64,63,127,
181,762,57,40,97,
182,839,53,53,106,
183,851,78,56,134,
184,844,59,43,102,
185,831,59,47,106,
186,745,67,44,111,
187,808,54,46,100,
188,836,72,51,123,
189,794,51,54,105,
190,799,81,45,126,
191,822,69,45,114,
192,841,51,39,90,
193,851,63,51,114,
194,800,51,52,103,
195,830,59,46,105,
196,865,61,42,103,
197,800,68,53,121,
198,807,62,53,115,
199,842,68,47,115,
200,852,61,41,102,
201,850,80,35,115,
202,848,63,44,107,
203,803,60,46,106,
204,826,58,49,107,
205,824,66,43,109,
206,844,38,41,79,
207,806,59,54,113,
208,832,61,55,116,
209,767,67,43,110,
210,830,58,46,104,
211,851,82,46,128,
212,825,53,43,96,
213,811,56,44,100,
214,800,65,54,119,
215,799,56,40,96,
216,850,62,47,109,
217,821,45,37,82,
218,845,51,47,98,
219,813,52,48,100,
220,834,55,53,108,
221,817,53,43,96,
222,801,47,35,82,
223,768,59,61,120,
224,860,59,57,116,
225,856,56,49,105,
226,838,55,55,110,
227,855,67,48,115,
228,771,45,46,91,
229,798,51,29,80,
230,838,65,43,108,
231,865,65,50,115,
232,802,56,40,96,
233,813,69,36,105,
234,798,57,42,99,
235,838,54,58,112,
236,809,65,54,119,
237,828,57,42,99,
238,773,63,42,105,
239,838,74,49,123,
240,787,64,49,113,
241,825,67,53,120,
242,819,47,53,100,
243,864,57,42,99,
244,810,45,42,87,
245,782,66,44,110,
246,854,72,42,114,
247,769,54,47,101,
248,826,63,41,104,
249,804,61,33,94,
250,861,67,49,116,
251,843,57,60,117,
252,819,70,71,141,
253,799,71,47,118,
254,791,56,37,93,
255,828,66,45,111,
256,853,57,49,106,
257,843,61,54,115,
258,844,57,40,97,
259,834,67,54,121,
260,778,63,43,106,
261,853,63,47,110,
262,827,58,37,95,
263,862,64,35,99,
264,729,56,41,97,
265,814,57,50,107,
266,844,60,42,102,
267,851,63,39,102,
268,778,58,41,99,
269,831,69,34,103,
270,804,51,37,88,
271,846,51,42,93,
272,859,63,40,103,
273,772,66,40,106,
274,850,57,49,106,
275,826,63,43,106,
276,825,53,49,102,
277,812,45,31,76,
278,825,55,58,113,
279,830,59,49,108,
280,806,54,46,100,
281,822,65,57,122,
282,796,62,45,107,
283,857,50,43,93,
284,781,46,36,82,
285,872,59,52,111,
286,826,57,48,105,
287,817,65,45,110,
288,813,67,50,117,
289,830,51,43,94,
290,856,52,54,106,
291,786,62,50,112,
292,831,65,48,113,
293,817,47,41,88,
294,861,61,47,108,
295,813,61,39,100,
296,825,55,52,107,
297,829,78,43,121,
298,820,68,46,114,
299,806,61,58,119,
300,828,50,43,93,
301,844,58,44,102,
302,863,44,52,96,
303,833,56,39,95,
304,799,53,41,94,
305,791,59,40,99,
306,841,50,48,98,
307,788,67,46,113,
308,791,60,44,104,
309,799,53,43,96,
310,818,62,35,97,
311,829,68,54,122,
312,814,75,41,116,
313,828,74,51,125,
314,843,67,52,119,
315,860,54,52,106,
316,792,62,42,104,
317,815,56,49,105,
318,876,53,52,105,
319,851,68,45,113,
320,863,63,49,112,
321,817,67,45,112,
322,769,55,53,108,
323,829,69,48,117,
324,848,55,59,114,
325,828,55,42,97,
326,844,52,51,103,
327,817,69,42,111,
328,749,51,44,95,
329,827,65,50,115,
330,884,60,58,118,
331,851,63,47,110,
332,765,61,40,101,
333,858,66,56,122,
334,843,57,41,98,
335,854,69,48,117,
336,781,59,38,97,
337,835,56,59,115,
338,869,59,43,102,
339,824,65,45,110,
340,786,48,38,86,
341,814,63,55,118,
342,865,64,41,105,
343,851,65,47,112,
344,843,58,61,119,
345,804,48,37,85,
346,807,64,45,109,
347,878,61,44,105,
348,792,53,42,95,
349,829,55,55,110,
350,798,64,48,112,
351,815,57,44,101,
352,814,64,49,113,
353,787,58,36,94,
354,811,59,41,100,
355,790,54,43,97,
356,826,60,43,103,
357,839,68,48,116,
358,809,56,45,101,
359,815,58,46,104,
360,798,52,50,102,
361,810,62,56,118,
362,851,39,50,89,
363,867,74,48,122,
364,780,44,50,94,
365,794,49,44,93,
366,817,76,54,130,
367,823,64,43,107,
368,814,62,60,122,
369,813,59,60,119,
370,781,55,49,104,
371,779,51,36,87,
372,811,66,41,107,
373,855,73,48,121,
374,853,56,46,102,
375,855,60,48,108,
376,847,59,44,103,
377,847,67,49,116,
378,818,46,49,95,
379,793,61,66,127,
380,835,64,49,113,
381,803,62,40,102,
382,886,57,56,113,
383,815,70,52,122,
384,800,64,40,104,
385,847,51,43,94,
386,799,59,52,111,
387,883,62,58,120,
388,808,50,34,84,
389,862,72,54,126,
390,774,59,41,100,
391,776,65,44,109,
392,809,61,58,119,
393,822,46,33,79,
394,778,60,58,118,
395,821,48,58,106,
396,852,79,56,135,
397,825,61,51,112,
398,848,39,56,95,
399,890,81,59,140,
400,810,68,46,114,
401,872,54,50,104,
402,821,56,43,99,
403,857,48,67,115,
404,864,67,55,122,
405,849,71,44,115,
406,773,51,39,90,
407,724,56,35,91,
408,796,73,35,108,
409,844,66,36,102,
410,830,61,47,108,
411,793,55,54,109,
412,815,53,49,102,
413,750,65,44,109,
414,863,59,47,106,
415,856,61,65,126,
416,809,58,38,96,
417,821,53,44,97,
418,789,49,47,96,
419,816,58,47,105,
420,783,43,38,81,
421,824,50,50,100,
422,821,55,38,93,
423,811,60,44,104,
424,796,54,46,100,
425,826,56,42,98,
426,797,50,39,89,
427,807,61,47,108,
428,793,51,57,108,
429,757,53,41,94,
430,838,57,53,110,
431,837,63,45,108,
432,867,56,47,103,
433,810,54,50,104,
434,845,63,43,106,
435,841,53,37,90,
436,792,58,34,92,
437,819,60,37,97,
438,920,59,50,109,
439,820,61,45,106,
440,828,61,50,111,
441,828,56,43,99,
442,878,71,61,132,
443,817,66,46,112,
444,837,69,57,126,
445,822,55,41,96,
446,802,57,37,94,
447,812,54,41,95,
448,830,59,53,112,
449,821,66,41,107,
450,785,56,40,96,
451,819,60,54,114,
452,819,48,42,90,
453,808,56,44,100,
454,865,53,54,107,
455,851,52,45,97,
456,843,68,43,111,
457,874,79,44,123,
458,849,50,48,98,
459,847,59,45,104,
460,801,67,41,108,
461,823,54,35,89,
462,776,50,47,97,
463,780,49,50,99,
464,840,70,42,112,
465,901,58,54,112,
466,839,55,45,100,
467,890,57,50,107,
468,791,66,50,116,
469,853,70,49,119,
470,835,53,67,120,
471,866,59,38,97,
472,851,67,52,119,
473,852,55,46,101,
474,815,54,55,109,
475,849,63,48,111,
476,850,80,42,122,
477,858,65,62,127,
478,814,54,37,91,
479,832,57,45,102,
480,862,56,48,104,
481,798,56,45,101,
482,825,58,48,106,
483,860,64,42,106,
484,827,59,39,98,
485,799,60,51,111,
486,826,59,47,106,
487,818,66,53,119,
488,832,63,43,106,
489,814,58,46,104,
490,831,51,44,95,
491,790,63,39,102,
492,871,55,51,106,
493,829,63,45,108,
494,765,51,61,112,
495,855,67,41,108,
496,814,55,53,108,
497,803,51,39,90,
498,784,57,50,107,
499,826,54,38,92,
500,806,61,56,117,
501,820,73,43,116,
502,830,56,51,107,
503,858,84,37,121,
504,818,67,52,119,
505,809,55,49,104,
506,851,57,51,108,
507,755,42,38,80,
508,795,56,42,98,
509,827,57,45,102,
510,782,55,53,108,
511,833,56,55,111,
512,867,53,63,116,
513,852,65,46,111,
514,810,66,47,113,
515,763,43,36,79,
516,819,56,48,104,
517,847,62,35,97,
518,854,58,41,99,
519,801,55,55,110,
520,827,62,54,116,
521,766,53,46,99,
522,831,65,44,109,
523,801,50,37,87,
524,835,53,49,102,
525,821,75,45,120,
526,812,64,46,110,
527,861,69,49,118,
528,813,63,43,106,
529,813,52,45,97,
530,813,56,50,106,
531,791,61,38,99,
532,805,53,53,106,
533,855,42,56,98,
534,847,58,55,113,
535,857,68,57,125,
536,821,66,59,125,
537,834,68,54,122,
538,852,57,53,110,
539,832,63,47,110,
540,804,62,58,120,
541,795,65,32,97,
542,840,73,48,121,
543,838,75,44,119,
544,850,54,60,114,
545,871,69,47,116,
546,927,56,62,118,
547,767,46,43,89,
548,837,51,47,98,
549,910,64,52,116,
550,772,61,46,107,
551,868,73,39,112,
552,813,58,48,106,
553,821,77,42,119,
554,763,62,38,100,
555,803,57,48,105,
556,886,76,63,139,
557,871,55,47,102,
558,807,59,37,96,
559,818,60,50,110,
560,829,63,47,110,
561,860,65,48,113,
562,805,57,43,100,
563,854,53,40,93,
564,858,64,43,107,
565,787,53,53,106,
566,827,73,49,122,
567,804,58,39,97,
568,765,45,37,82,
569,845,54,59,113,
570,834,53,61,114,
571,828,65,46,111,
572,769,56,47,103,
573,806,62,50,112,
574,844,61,39,100,
575,787,57,47,104,
576,784,44,40,84,
577,770,58,43,101,
578,789,44,32,76,
579,850,62,50,112,
580,815,63,47,110,
581,855,64,48,112,
582,880,58,56,114,
583,809,61,43,104,
584,821,60,58,118,
585,857,69,53,122,
586,807,51,46,97,
587,851,55,46,101,
588,795,67,42,109,
589,759,61,45,106,
590,857,71,54,125,
591,810,62,49,111,
592,722,56,37,93,
593,849,55,51,106,
594,819,64,50,114,
595,837,64,46,110,
596,798,51,37,88,
597,858,51,61,112,
598,810,51,46,97,
599,775,66,32,98,
600,861,53,47,100,
601,813,59,47,106,
602,857,73,49,122,
603,847,82,39,121,
604,779,50,48,98,
605,817,70,50,120,
606,823,64,54,118,
607,794,58,55,113,
608,788,60,44,104,
609,799,61,50,111,
610,870,58,49,107,
611,862,65,44,109,
612,860,53,52,105,
613,844,58,56,114,
614,756,62,44,106,
615,848,61,45,106,
616,845,57,45,102,
617,895,75,57,132,
618,839,66,41,107,
619,839,45,64,109,
620,861,57,32,89,
621,813,47,41,88,
622,820,63,40,103,
623,796,73,52,125,
624,774,55,37,92,
625,874,49,52,101,
626,859,48,51,99,
627,815,61,52,113,
628,780,59,32,91,
629,817,55,44,99,
630,791,62,49,111,
631,839,57,47,104,
632,810,51,44,95,
633,813,57,42,99,
634,829,60,56,116,
635,846,56,37,93,
636,856,58,40,98,
637,859,70,51,121,
638,822,64,33,97,
639,839,60,49,109,
640,812,65,50,115,
641,781,56,44,100,
642,780,46,50,96,
643,826,56,43,99,
644,810,61,33,94,
645,761,46,34,80,
646,849,66,50,116,
647,837,54,48,102,
648,782,51,36,87,
649,820,46,52,98,
650,810,52,47,99,
651,847,55,49,104,
652,848,60,61,121,
653,783,45,47,92,
654,841,72,39,111,
655,834,57,38,95,
656,764,43,46,89,
657,847,51,50,101,
658,859,58,45,103,
659,787,53,53,106,
660,811,53,55,108,
661,821,44,50,94,
662,812,65,50,115,
663,813,62,49,111,
664,832,72,49,121,
665,814,53,49,102,
666,807,54,35,89,
667,804,50,47,97,
668,841,69,35,104,
669,808,60,47,107,
670,811,58,41,99,
671,811,57,47,104,
672,851,60,45,105,
673,843,58,54,112,
674,819,57,51,108,
675,823,64,53,117,
676,810,55,43,98,
677,881,69,50,119,
678,846,56,61,117,
679,850,56,35,91,
680,823,48,57,105,
681,803,53,57,110,
682,855,59,62,121,
683,779,52,43,95,
684,838,65,32,97,
685,844,49,49,98,
686,857,70,53,123,
687,862,63,41,104,
688,809,52,49,101,
689,776,65,57,122,
690,893,62,65,127,
691,837,61,64,125,
692,809,51,59,110,
693,801,54,52,106,
694,916,64,47,111,
695,796,55,48,103,
696,875,70,65,135,
697,850,58,63,121,
698,808,62,39,101,
699,791,47,53,100,
700,792,55,32,87,
701,773,51,51,102,
702,834,55,41,96,
703,869,63,49,112,
704,795,67,36,103,
705,791,51,37,88,
706,851,58,42,100,
707,826,54,50,104,
708,787,57,42,99,
709,898,58,73,131,
710,846,68,40,108,
711,798,61,43,104,
712,810,51,45,96,
713,791,59,42,101,
714,750,63,43,106,
715,815,65,35,100,
716,845,53,41,94,
717,788,64,40,104,
718,818,63,55,118,
719,830,59,48,107,
720,854,67,44,111,
721,833,47,50,97,
722,800,59,40,99,
723,840,63,54,117,
724,805,51,48,99,
725,825,74,51,125,
726,828,56,40,96,
727,853,71,54,125,
728,838,69,49,118,
729,871,40,48,88,
730,794,54,51,105,
731,825,64,37,101,
732,841,57,41,98,
733,829,61,45,106,
734,790,55,40,95,
735,770,50,45,95,
736,797,70,41,111,
737,778,48,40,88,
738,861,70,50,120,
739,811,62,38,100,
740,821,63,51,114,
741,791,53,44,97,
742,824,47,48,95,
743,810,53,51,104,
744,810,57,52,109,
745,832,72,58,130,
746,787,53,44,97,
747,839,81,54,135,
748,791,51,59,110,
749,794,60,40,100,
750,832,60,50,110,
751,863,62,44,106,
752,815,54,54,108,
753,815,66,47,113,
754,853,63,55,118,
755,810,61,51,112,
756,838,54,62,116,
757,794,45,38,83,
758,827,74,44,118,
759,838,56,57,113,
760,845,80,45,125,
761,828,50,39,89,
762,761,56,58,114,
763,850,58,48,106,
764,779,56,37,93,
765,873,62,48,110,
766,817,63,40,103,
767,820,57,61,118,
768,846,74,53,127,
769,801,63,47,110,
770,877,66,54,120,
771,782,40,37,77,
772,806,59,47,106,
773,809,64,47,111,
774,778,55,41,96,
775,837,55,46,101,
776,801,53,58,111,
777,843,62,46,108,
778,826,57,42,99,
779,786,44,46,90,
780,853,59,54,113,
781,818,57,44,101,
782,872,62,49,111,
783,807,46,51,97,
784,858,71,55,126,
785,822,62,47,109,
786,789,59,40,99,
787,833,57,49,106,
788,849,72,45,117,
789,766,60,49,109,
790,809,65,42,107,
791,846,63,53,116,
792,819,43,41,84,
793,782,50,52,102,
794,851,52,56,108,
795,811,44,35,79,
796,839,64,46,110,
797,844,48,50,98,
798,837,71,46,117,
799,804,54,54,108,
800,826,67,32,99,
801,801,71,50,121,
802,783,51,38,89,
803,793,58,35,93,
804,860,59,40,99,
805,876,55,65,120,
806,772,69,46,115,
807,850,56,52,108,
808,822,77,44,121,
809,827,55,43,98,
810,805,52,41,93,
811,807,57,56,113,
812,811,66,50,116,
813,830,64,55,119,
814,850,54,44,98,
815,822,65,29,94,
816,848,50,55,105,
817,824,62,39,101,
818,858,49,65,114,
819,793,47,40,87,
820,836,67,57,124,
821,823,66,46,112,
822,791,49,50,99,
823,818,66,56,122,
824,878,68,61,129,
825,799,52,42,94,
826,848,82,53,135,
827,804,62,37,99,
828,810,56,38,94,
829,829,62,58,120,
830,792,56,40,96,
831,816,60,54,114,
832,842,64,49,113,
833,824,58,57,115,
834,785,46,36,82,
835,827,62,65,127,
836,806,49,35,84,
837,804,47,38,85,
838,804,52,53,105,
839,785,46,38,84,
840,809,57,40,97,
841,824,58,46,104,
842,814,75,41,116,
843,757,55,42,97,
844,786,59,41,100,
845,854,74,46,120,
846,874,59,40,99,
847,761,61,34,95,
848,803,77,36,113,
849,850,67,47,114,
850,813,48,50,98,
851,801,65,43,108,
852,828,52,36,88,
853,780,59,34,93,
854,847,60,36,96,
855,870,63,53,116,
856,878,70,57,127,
857,809,57,39,96,
858,799,61,41,102,
859,826,64,38,102,
860,800,48,36,84,
861,857,60,49,109,
862,783,62,49,111,
863,925,64,49,113,
864,797,64,48,112,
865,832,55,47,102,
866,795,54,45,99,
867,817,73,44,117,
868,836,85,55,140,
869,859,68,50,118,
870,796,63,38,101,
871,824,57,46,103,
872,827,62,35,97,
873,862,56,46,102,
874,831,66,66,132,
875,856,61,45,106,
876,800,67,37,104,
877,788,60,44,104,
878,804,53,53,106,
879,834,46,43,89,
880,769,64,58,122,
881,824,66,51,117,
882,807,55,53,108,
883,790,44,51,95,
884,793,54,39,93,
885,826,58,57,115,
886,832,70,49,119,
887,837,60,46,106,
888,810,62,42,104,
889,810,53,39,92,
890,815,56,45,101,
891,804,64,42,106,
892,844,76,55,131,
893,839,50,59,109,
894,834,63,42,105,
895,814,60,52,112,
896,842,69,54,123,
897,860,64,52,116,
898,811,60,45,105,
899,800,68,41,109,
900,841,64,62,126,
901,851,63,42,105,
902,819,65,47,112,
903,785,62,49,111,
904,779,49,47,96,
905,797,62,52,114,
906,844,54,47,101,
907,851,70,44,114,
908,796,66,38,104,
909,851,60,45,105,
910,808,45,48,93,
911,782,58,40,98,
912,825,54,59,113,
913,830,52,44,96,
914,781,55,43,98,
915,809,56,46,102,
916,844,64,42,106,
917,802,48,35,83,
918,857,59,46,105,
919,814,76,38,114,
920,830,52,53,105,
921,820,63,49,112,
922,784,61,53,114,
923,840,68,53,121,
924,848,67,66,133,
925,815,64,54,118,
926,822,45,43,88,
927,815,52,35,87,
928,889,49,41,90,
929,818,61,42,103,
930,807,64,53,117,
931,782,49,46,95,
932,799,70,48,118,
933,794,55,38,93,
934,834,56,56,112,
935,871,67,45,112,
936,801,49,47,96,
937,807,57,43,100,
938,800,62,50,112,
939,796,49,31,80,
940,807,50,45,95,
941,794,55,41,96,
942,801,58,53,111,
943,859,65,45,110,
944,783,60,49,109,
945,812,64,37,101,
946,771,62,41,103,
947,785,55,43,98,
948,840,70,45,115,
949,806,73,41,114,
950,844,73,48,121,
951,817,54,43,97,
952,816,56,46,102,
953,819,69,45,114,
954,862,65,51,116,
955,741,59,37,96,
956,826,66,51,117,
957,818,52,53,105,
958,829,56,38,94,
959,807,52,55,107,
960,833,57,54,111,
961,829,57,40,97,
962,826,61,47,108,
963,872,56,49,105,
964,744,63,50,113,
965,818,63,32,95,
966,779,57,41,98,
967,799,47,59,106,
968,795,66,57,123,
969,773,52,27,79,
970,840,53,51,104,
971,863,55,43,98,
972,833,68,34,102,
973,777,60,48,108,
974,831,40,55,95,
975,815,70,56,126,
976,806,67,32,99,
977,835,63,55,118,
978,854,70,54,124,
979,831,70,47,117,
980,835,63,52,115,
981,805,50,52,102,
982,792,52,39,91,
983,772,56,51,107,
984,885,70,45,115,
985,825,47,36,83,
986,827,56,40,96,
987,784,63,40,103,
988,869,66,52,118,
989,830,64,58,122,
990,817,61,37,98,
991,856,53,40,93,
992,803,54,47,101,
993,824,64,50,114,
994,823,54,47,101,
995,827,63,48,111,
996,762,46,51,97,
997,830,49,42,91,
998,844,73,49,122,
999,836,69,52,121,
1000,792,69,43,112,
1001,890,60,46,106,
1002,773,57,47,104,
1003,810,70,49,119,
1004,777,56,48,104,
1005,839,68,46,114,
1006,763,56,49,105,
1007,817,59,47,106,
1008,776,54,39,93,
1009,794,59,40,99,
1010,815,75,49,124,
1011,809,70,53,123,
1012,784,43,49,92,
1013,809,67,39,106,
1014,806,65,50,115,
1015,859,62,52,114,
1016,802,56,47,103,
1017,843,54,56,110,
1018,854,57,48,105,
1019,845,66,40,106,
1020,834,56,46,102,
1021,783,74,48,122,
1022,832,67,38,105,
1023,798,43,45,88,
1024,808,41,50,91,
1025,841,72,46,118,
1026,846,52,48,100,
1027,796,62,39,101,
1028,857,74,47,121,
1029,795,49,52,101,
1030,824,53,36,89,
1031,782,57,36,93,
1032,793,58,48,106,
1033,810,63,41,104,
1034,830,63,49,112,
1035,852,69,46,115,
1036,799,72,54,126,
1037,769,63,43,106,
1038,828,87,33,120,
1039,751,50,33,83,
1040,854,74,53,127,
1041,829,50,44,94,
1042,824,54,44,98,
1043,867,64,54,118,
1044,826,66,46,112,
1045,800,70,49,119,
1046,783,63,52,115,
1047,859,63,49,112,
1048,800,55,45,100,
1049,836,59,40,99,
1050,854,60,63,123,
1051,810,48,41,89,
1052,815,56,41,97,
1053,829,55,65,120,
1054,799,69,39,108,
1055,809,76,46,122,
1056,843,59,48,107,
1057,837,66,45,111,
1058,810,54,38,92,
1059,870,61,52,113,
1060,773,54,40,94,
1061,854,60,50,110,
1062,833,82,54,136,
1063,822,50,41,91,
1064,858,69,48,117,
1065,852,82,48,130,
1066,830,66,50,116,
1067,848,53,43,96,
1068,810,56,44,100,
1069,808,53,50,103,
1070,858,67,48,115,
1071,769,52,40,92,
1072,823,59,43,102,
1073,780,64,49,113,
1074,843,57,48,105,
1075,839,60,40,100,
1076,793,66,47,113,
1077,904,65,43,108,
1078,817,62,49,111,
1079,839,53,47,100,
1080,818,61,43,104,
1081,815,72,43,115,
1082,788,66,46,112,
1083,774,53,42,95,
1084,795,53,58,111,
1085,792,54,46,100,
1086,815,67,41,108,
1087,807,54,34,88,
1088,827,57,56,113,
1089,791,66,52,118,
1090,806,61,47,108,
1091,843,60,49,109,
1092,833,61,60,121,
1093,854,78,47,125,
1094,817,50,52,102,
1095,833,57,51,108,
1096,767,60,49,109,
1097,785,58,46,104,
1098,805,59,48,107,
1099,821,54,58,112,
1100,803,52,50,102,
1101,800,52,53,105,
1102,830,64,45,109,
1103,830,53,51,104,
1104,853,64,47,111,
1105,861,62,45,107,
1106,834,48,47,95,
1107,815,49,52,101,
1108,825,66,59,125,
1109,855,59,50,109,
1110,828,55,44,99,
1111,811,49,48,97,
1112,804,54,49,103,
1113,809,64,42,106,
1114,835,61,53,114,
1115,827,49,45,94,
1116,838,55,49,104,
1117,809,59,46,105,
1118,804,48,46,94,
1119,805,50,41,91,
1120,901,63,41,104,
1121,805,58,53,111,
1122,826,60,57,117,
1123,803,51,47,98,
1124,862,62,59,121,
1125,838,56,47,103,
1126,806,67,45,112,
1127,775,66,39,105,
1128,816,54,61,115,
1129,823,58,57,115,
1130,832,58,44,102,
1131,819,50,61,111,
1132,850,66,45,111,
1133,769,53,49,102,
1134,860,67,52,119,
1135,861,66,41,107,
1136,883,70,58,128,
1137,808,60,46,106,
1138,802,55,39,94,
1139,798,68,39,107,
1140,788,47,41,88,
1141,836,56,57,113,
1142,862,43,48,91,
1143,806,62,38,100,
1144,813,59,48,107,
1145,832,65,30,95,
1146,852,56,47,103,
1147,847,67,50,117,
1148,802,44,54,98,
1149,795,55,48,103,
1150,856,78,54,132,
1151,841,45,47,92,
1152,847,56,42,98,
1153,851,67,46,113,
1154,834,53,41,94,
1155,847,77,45,122,
1156,743,42,51,93,
1157,786,49,39,88,
1158,829,62,44,106,
1159,884,61,57,118,
1160,808,51,49,100,
1161,845,50,67,117,
1162,799,68,51,119,
1163,818,57,36,93,
1164,842,56,60,116,
1165,821,61,58,119,
1166,823,54,55,109,
1167,828,48,49,97,
1168,810,56,60,116,
1169,824,58,46,104,
1170,819,47,29,76,
1171,817,63,44,107,
1172,832,61,48,109,
1173,810,65,41,106,
1174,757,50,54,104,
1175,811,74,50,124,
1176,826,65,54,119,
1177,806,55,42,97,
1178,822,51,47,98,
1179,837,79,53,132,
1180,802,52,49,101,
1181,767,55,41,96,
1182,820,65,49,114,
1183,826,53,46,99,
1184,798,60,48,108,
1185,829,48,48,96,
1186,827,46,45,91,
1187,812,43,50,93,
1188,867,74,56,130,
1189,835,62,47,109,
1190,788,70,45,115,
1191,803,49,45,94,
1192,880,73,58,131,
1193,816,64,40,104,
1194,825,61,52,113,
1195,843,49,46,95,
1196,827,67,37,104,
1197,823,61,37,98,
1198,855,64,42,106,
1199,805,61,47,108,
1200,864,62,40,102,
1201,812,56,50,106,
1202,830,57,49,106,
1203,790,49,32,81,
1204,826,61,43,104,
1205,808,65,44,109,
1206,869,72,43,115,
1207,843,61,62,123,
1208,841,78,48,126,
1209,871,69,55,124,
1210,784,60,40,100,
1211,781,56,46,102,
1212,875,80,52,132,
1213,822,56,51,107,
1214,836,63,49,112,
1215,838,68,55,123,
1216,800,49,45,94,
1217,818,60,56,116,
1218,829,71,42,113,
1219,800,60,47,107,
1220,814,56,50,106,
1221,817,56,54,110,
1222,851,62,55,117,
1223,832,54,40,94,
1224,815,55,40,95,
1225,861,58,36,94,
1226,880,67,61,128,
1227,810,53,54,107,
1228,776,53,36,89,
1229,830,61,51,112,
1230,777,52,51,103,
1231,756,54,45,99,
1232,837,60,50,110,
1233,854,74,42,116,
1234,789,59,52,111,
1235,857,63,48,111,
1236,905,71,55,126,
1237,835,52,44,96,
1238,772,56,46,102,
1239,825,67,39,106,
1240,823,64,45,109,
1241,812,54,43,97,
1242,759,53,48,101,
1243,811,73,40,113,
1244,784,49,39,88,
1245,805,67,51,118,
1246,813,55,50,105,
1247,781,46,57,103,
1248,847,55,50,105,
1249,817,73,31,104,
1250,784,56,48,104,
1251,802,63,40,103,
1252,784,57,52,109,
1253,769,74,32,106,
1254,828,63,56,119,
1255,762,61,52,113,
1256,821,70,43,113,
1257,865,64,53,117,
1258,823,65,42,107,
1259,809,60,47,107,
1260,769,59,31,90,
1261,910,56,53,109,
1262,804,56,50,106,
1263,875,75,39,114,
1264,819,52,40,92,
1265,789,58,48,106,
1266,828,60,41,101,
1267,833,63,46,109,
1268,833,52,49,101,
1269,814,54,46,100,
1270,822,74,51,125,
1271,835,54,43,97,
1272,803,71,52,123,
1273,804,70,52,122,
1274,798,49,48,97,
1275,842,79,55,134,
1276,842,59,39,98,
1277,846,68,50,118,
1278,873,81,57,138,
1279,834,68,57,125,
1280,776,55,46,101,
1281,806,54,46,100,
1282,839,49,50,99,
1283,839,58,59,117,
1284,883,66,59,125,
1285,845,58,54,112,
1286,836,60,40,100,
1287,852,79,45,124,
1288,838,60,45,105,
1289,821,64,43,107,
1290,856,53,44,97,
1291,803,62,59,121,
1292,812,63,42,105,
1293,809,60,50,110,
1294,839,47,47,94,
1295,823,59,52,111,
1296,886,72,40,112,
1297,783,49,44,93,
1298,797,52,57,109,
1299,785,50,27,77,
1300,824,61,42,103,
1301,812,58,51,109,
1302,771,58,55,113,
1303,826,67,50,117,
1304,817,60,53,113,
1305,806,84,51,135,
1306,838,56,42,98,
1307,831,65,43,108,
1308,873,66,54,120,
1309,863,55,48,103,
1310,795,69,41,110,
1311,824,64,51,115,
1312,809,65,39,104,
1313,807,58,44,102,
1314,803,66,44,110,
1315,874,67,43,110,
1316,854,58,47,105,
1317,885,73,45,118,
1318,814,68,49,117,
1319,849,56,42,98,
1320,866,59,62,121,
1321,807,59,52,111,
1322,816,79,62,141,
1323,793,71,52,123,
1324,834,59,41,100,
1325,764,48,42,90,
1326,865,62,48,110,
1327,824,64,48,112,
1328,805,47,64,111,
1329,873,63,44,107,
1330,851,79,59,138,
1331,839,63,37,100,
1332,827,63,44,107,
1333,784,59,51,110,
1334,798,61,50,111,
1335,871,52,51,103,
1336,828,46,51,97,
1337,845,71,51,122,
1338,837,63,55,118,
1339,834,55,53,108,
1340,824,50,52,102,
1341,809,49,56,105,
1342,785,60,55,115,
1343,814,64,40,104,
1344,844,66,63,129,
1345,820,66,51,117,
1346,878,75,53,128,
1347,808,57,40,97,
1348,833,65,56,121,
1349,831,70,52,122,
1350,836,49,48,97,
1351,851,77,44,121,
1352,867,67,50,117,
1353,822,58,44,102,
1354,829,49,40,89,
1355,819,74,48,122,
1356,815,62,46,108,
1357,808,61,46,107,
1358,850,66,50,116,
1359,738,63,39,102,
1360,861,71,48,119,
1361,799,72,39,111,
1362,804,71,41,112,
1363,804,52,49,101,
1364,843,64,45,109,
1365,826,75,46,121,
1366,836,70,39,109,
1367,838,65,48,113,
1368,841,75,48,123,
1369,768,60,46,106,
1370,840,49,47,96,
1371,816,53,50,103,
1372,827,56,37,93,
1373,816,58,39,97,
1374,901,70,51,121,
1375,853,62,51,113,
1376,859,70,41,111,
1377,786,61,42,103,
1378,849,67,40,107,
1379,819,56,44,100,
1380,803,52,47,99,
1381,808,65,49,114,
1382,852,62,57,119,
1383,806,54,40,94,
1384,828,72,53,125,
1385,807,52,47,99,
1386,820,75,42,117,
1387,815,63,42,105,
1388,811,65,39,104,
1389,839,61,53,114,
1390,824,57,54,111,
1391,844,57,39,96,
1392,859,50,48,98,
1393,821,58,51,109,
1394,848,64,49,113,
1395,817,69,31,100,
1396,779,65,44,109,
1397,792,52,51,103,
1398,812,58,41,99,
1399,855,63,56,119,
1400,774,64,35,99,
1401,837,46,55,101,
1402,871,67,59,126,
1403,843,61,53,114,
1404,759,50,33,83,
1405,865,59,61,120,
1406,821,67,45,112,
1407,794,69,37,106,
1408,816,67,48,115,
1409,836,65,56,121,
1410,782,46,44,90,
1411,807,59,36,95,
1412,820,62,55,117,
1413,835,67,42,109,
1414,781,57,40,97,
1415,871,58,43,101,
1416,791,51,43,94,
1417,789,57,42,99,
1418,843,69,42,111,
1419,781,56,41,97,
1420,805,56,56,112,
1421,811,58,48,106,
1422,911,54,48,102,
1423,833,59,48,107,
1424,870,52,44,96,
1425,828,61,48,109,
1426,793,59,42,101,
1427,847,74,56,130,
1428,835,70,38,108,
1429,785,69,39,108,
1430,834,54,45,99,
1431,798,54,41,95,
1432,869,44,43,87,
1433,834,49,43,92,
1434,860,59,49,108,
1435,842,54,43,97,
1436,810,47,58,105,
1437,841,60,41,101,
1438,843,52,37,89,
1439,851,47,51,98,
1440,836,59,38,97,
1441,812,54,36,90,
1442,818,70,59,129,
1443,799,59,46,105,
1444,867,61,55,116,
1445,810,60,44,104,
1446,813,58,41,99,
1447,775,43,34,77,
1448,761,62,41,103,
1449,796,51,44,95,
1450,820,59,52,111,
1451,786,61,47,108,
1452,783,65,44,109,
1453,848,57,46,103,
1454,807,63,47,110,
1455,834,65,62,127,
1456,808,56,46,102,
1457,842,65,45,110,
1458,821,55,50,105,
1459,898,66,51,117,
1460,862,67,44,111,
1461,797,50,42,92,
1462,831,57,51,108,
1463,892,67,52,119,
1464,821,67,60,127,
1465,815,58,46,104,
1466,757,60,43,103,
1467,847,60,41,101,
1468,842,67,43,110,
1469,861,61,46,107,
1470,821,57,47,104,
1471,782,48,46,94,
1472,845,55,41,96,
1473,934,52,43,95,
1474,769,44,35,79,
1475,833,77,50,127,
1476,805,57,46,103,
1477,828,71,59,130,
1478,833,62,41,103,
1479,815,63,46,109,
1480,815,53,45,98,
1481,810,56,42,98,
1482,818,51,50,101,
1483,829,57,42,99,
1484,787,58,46,104,
1485,874,52,50,102,
1486,787,51,54,105,
1487,813,61,58,119,
1488,790,71,55,126,
1489,803,59,43,102,
1490,795,51,49,100,
1491,843,61,46,107,
1492,793,54,41,95,
1493,819,60,45,105,
1494,863,55,50,105,
1495,785,64,38,102,
1496,775,61,40,101,
1497,772,58,41,99,
1498,849,56,42,98,
1499,833,53,55,108,
1500,745,38,51,89,
1501,800,59,50,109,
1502,828,51,55,106,
1503,830,65,56,121,
1504,869,70,48,118,
1505,854,57,45,102,
1506,800,56,43,99,
1507,775,56,37,93,
1508,798,50,47,97,
1509,844,68,50,118,
1510,787,73,53,126,
1511,852,55,59,114,
1512,848,76,44,120,
1513,808,62,34,96,
1514,825,46,53,99,
1515,856,62,51,113,
1516,839,48,45,93,
1517,741,55,47,102,
1518,822,55,53,108,
1519,867,67,48,115,
1520,833,66,47,113,
1521,837,63,46,109,
1522,783,58,50,108,
1523,824,56,37,93,
1524,852,51,53,104,
1525,804,51,43,94,
1526,843,67,41,108,
1527,810,63,33,96,
1528,825,47,37,84,
1529,843,60,48,108,
1530,846,53,42,95,
1531,836,58,47,105,
1532,857,60,49,109,
1533,814,59,43,102,
1534,848,62,49,111,
1535,832,55,55,110,
1536,849,58,60,118,
1537,818,55,52,107,
1538,821,56,47,103,
1539,842,61,62,123,
1540,831,58,67,125,
1541,761,62,37,99,
1542,800,57,43,100,
1543,788,45,52,97,
1544,834,47,49,96,
1545,882,49,41,90,
1546,770,55,37,92,
1547,784,62,37,99,
1548,863,72,28,100,
1549,822,58,46,104,
1550,838,66,45,111,
1551,827,52,37,89,
1552,791,53,38,91,
1553,868,73,41,114,
1554,813,64,43,107,
1555,827,42,49,91,
1556,782,62,52,114,
1557,866,67,51,118,
1558,861,72,50,122,
1559,825,52,44,96,
1560,883,63,60,123,
1561,837,61,53,114,
1562,789,67,44,111,
1563,848,55,47,102,
1564,834,55,38,93,
1565,815,57,55,112,
1566,786,53,57,110,
1567,832,63,46,109,
1568,844,47,45,92,
1569,840,63,55,118,
1570,864,66,54,120,
1571,837,62,56,118,
1572,795,67,55,122,
1573,849,65,53,118,
1574,814,52,47,99,
1575,784,55,49,104,
1576,856,63,57,120,
1577,853,62,46,108,
1578,813,61,50,111,
1579,809,65,47,112,
1580,843,64,45,109,
1581,863,63,53,116,
1582,938,74,49,123,
1583,852,56,48,104,
1584,839,64,58,122,
1585,794,73,41,114,
1586,856,66,35,101,
1587,845,56,46,102,
1588,845,71,62,133,
1589,864,56,44,100,
1590,865,61,54,115,
1591,789,66,47,113,
1592,842,71,45,116,
1593,740,75,47,122,
1594,825,70,51,121,
1595,811,54,61,115,
1596,824,66,29,95,
1597,843,55,55,110,
1598,788,67,55,122,
1599,843,56,47,103,
1600,832,61,54,115,
1601,774,51,41,92,
1602,807,56,49,105,
1603,788,54,41,95,
1604,837,45,52,97,
1605,782,60,41,101,
1606,829,68,45,113,
1607,804,57,51,108,
1608,826,49,41,90,
1609,804,71,45,116,
1610,812,55,44,99,
1611,794,66,40,106,
1612,847,71,56,127,
1613,843,63,47,110,
1614,771,60,40,100,
1615,817,60,40,100,
1616,759,64,34,98,
1617,847,53,49,102,
1618,833,58,46,104,
1619,804,84,37,121,
1620,805,48,40,88,
1621,860,64,45,109,
1622,817,49,54,103,
1623,827,61,57,118,
1624,904,60,49,109,
1625,824,58,48,106,
1626,756,63,47,110,
1627,790,47,49,96,
1628,793,54,41,95,
1629,880,66,46,112,
1630,848,61,45,106,
1631,851,73,39,112,
1632,817,49,49,98,
1633,804,47,56,103,
1634,785,46,46,92,
1635,850,74,51,125,
1636,802,57,43,100,
1637,762,53,42,95,
1638,853,57,49,106,
1639,808,47,52,99,
1640,847,62,48,110,
1641,825,57,58,115,
1642,824,71,52,123,
1643,833,68,50,118,
1644,852,58,55,113,
1645,810,83,47,130,
1646,816,56,53,109,
1647,821,50,48,98,
1648,791,65,42,107,
1649,823,58,39,97,
1650,857,70,50,120,
1651,846,64,61,125,
1652,841,68,43,111,
1653,864,71,48,119,
1654,814,58,45,103,
1655,797,56,38,94,
1656,813,67,46,113,
1657,822,52,50,102,
1658,876,75,54,129,
1659,817,60,42,102,
1660,832,69,40,109,
1661,804,65,50,115,
1662,821,68,44,112,
1663,891,65,49,114,
1664,785,53,49,102,
1665,813,57,56,113,
1666,813,64,51,115,
1667,781,50,50,100,
1668,793,45,48,93,
1669,880,77,50,127,
1670,820,56,56,112,
1671,825,59,53,112,
1672,823,66,61,127,
1673,831,63,50,113,
1674,751,50,48,98,
1675,814,46,49,95,
1676,861,61,44,105,
1677,796,51,45,96,
1678,832,43,49,92,
1679,791,60,47,107,
1680,834,62,47,109,
1681,833,49,40,89,
1682,844,46,43,89,
1683,784,52,53,105,
1684,800,52,41,93,
1685,853,64,45,109,
1686,788,61,54,115,
1687,802,67,55,122,
1688,883,69,56,125,
1689,853,64,62,126,
1690,806,57,53,110,
1691,825,55,35,90,
1692,904,72,50,122,
1693,831,65,53,118,
1694,819,58,57,115,
1695,806,66,43,109,
1696,823,64,43,107,
1697,841,54,51,105,
1698,809,56,52,108,
1699,819,57,45,102,
1700,802,59,50,109,
1701,834,76,60,136,
1702,771,41,36,77,
1703,879,76,47,123,
1704,845,59,45,104,
1705,818,70,43,113,
1706,789,50,33,83,
1707,849,59,48,107,
1708,840,62,38,100,
1709,873,70,53,123,
1710,850,65,48,113,
1711,797,41,58,99,
1712,826,59,43,102,
1713,791,58,39,97,
1714,772,55,44,99,
1715,853,60,47,107,
1716,785,53,53,106,
1717,835,63,44,107,
1718,831,62,54,116,
1719,854,59,35,94,
1720,821,60,43,103,
1721,866,62,47,109,
1722,782,56,49,105,
1723,894,55,38,93,
1724,798,57,40,97,
1725,835,65,44,109,
1726,818,61,40,101,
1727,862,63,48,111,
1728,832,51,44,95,
1729,821,71,51,122,
1730,815,63,39,102,
1731,782,57,42,99,
1732,839,65,44,109,
1733,791,52,41,93,
1734,851,61,51,112,
1735,810,58,45,103,
1736,810,52,41,93,
1737,862,68,42,110,
1738,806,54,47,101,
1739,802,47,63,110,
1740,790,52,46,98,
1741,845,67,54,121,
1742,838,52,42,94,
1743,815,63,44,107,
1744,800,50,52,102,
1745,829,67,57,124,
1746,878,63,42,105,
1747,858,49,42,91,
1748,789,47,44,91,
1749,844,61,44,105,
1750,795,73,48,121,
1751,796,58,45,103,
1752,788,52,54,106,
1753,831,59,61,120,
1754,795,64,46,110,
1755,797,58,40,98,
1756,794,68,36,104,
1757,792,60,38,98,
1758,844,81,46,127,
1759,866,65,56,121,
1760,802,70,48,118,
1761,832,56,42,98,
1762,837,66,34,100,
1763,829,60,32,92,
1764,791,50,49,99,
1765,811,70,47,117,
1766,808,59,55,114,
1767,794,50,40,90,
1768,814,56,47,103,
1769,807,56,49,105,
1770,886,70,59,129,
1771,875,60,45,105,
1772,806,50,50,100,
1773,833,58,34,92,
1774,831,58,42,100,
1775,819,47,53,100,
1776,806,69,44,113,
1777,889,64,44,108,
1778,846,61,59,120,
1779,817,65,53,118,
1780,846,70,50,120,
1781,803,70,33,103,
1782,835,69,44,113,
1783,855,72,48,120,
1784,797,56,43,99,
1785,792,61,41,102,
1786,817,48,45,93,
1787,787,48,50,98,
1788,848,56,47,103,
1789,809,80,46,126,
1790,807,67,57,124,
1791,901,59,45,104,
1792,827,67,43,110,
1793,824,69,46,115,
1794,842,54,61,115,
1795,859,68,46,114,
1796,812,62,41,103,
1797,844,70,55,125,
1798,843,58,57,115,
1799,785,59,44,103,
1800,851,64,43,107,
1801,834,67,49,116,
1802,809,65,44,109,
1803,870,53,58,111,
1804,829,52,43,95,
1805,836,47,39,86,
1806,792,65,33,98,
1807,790,71,41,112,
1808,819,59,49,108,
1809,828,63,56,119,
1810,855,68,47,115,
1811,764,53,33,86,
1812,798,70,39,109,
1813,724,53,39,92,
1814,839,63,49,112,
1815,805,69,49,118,
1816,847,61,47,108,
1817,843,72,47,119,
1818,745,53,48,101,
1819,767,63,44,107,
1820,911,68,44,112,
1821,861,77,47,124,
1822,835,61,52,113,
1823,892,55,42,97,
1824,817,46,42,88,
1825,838,61,35,96,
1826,820,54,44,98,
1827,817,52,48,100,
1828,806,58,55,113,
1829,796,50,51,101,
1830,852,66,51,117,
1831,818,57,45,102,
1832,868,58,51,109,
1833,794,52,53,105,
1834,856,65,47,112,
1835,818,64,60,124,
1836,799,60,56,116,
1837,734,68,41,109,
1838,838,56,38,94,
1839,823,65,42,107,
1840,839,59,53,112,
1841,865,63,45,108,
1842,763,48,50,98,
1843,859,49,39,88,
1844,793,57,33,90,
1845,865,52,39,91,
1846,817,65,58,123,
1847,842,55,45,100,
1848,832,57,52,109,
1849,827,48,44,92,
1850,778,50,54,104,
1851,803,66,55,121,
1852,729,59,31,90,
1853,835,79,45,124,
1854,854,71,44,115,
1855,872,70,42,112,
1856,860,67,43,110,
1857,805,49,42,91,
1858,879,68,48,116,
1859,857,49,45,94,
1860,831,54,44,98,
1861,839,57,41,98,
1862,831,64,43,107,
1863,825,59,49,108,
1864,814,55,54,109,
1865,858,61,53,114,
1866,822,55,37,92,
1867,811,56,38,94,
1868,844,54,48,102,
1869,784,62,50,112,
1870,813,47,41,88,
1871,821,54,36,90,
1872,838,51,41,92,
1873,840,62,45,107,
1874,801,60,35,95,
1875,790,55,53,108,
1876,830,65,47,112,
1877,818,60,43,103,
1878,813,50,49,99,
1879,797,64,39,103,
1880,806,51,60,111,
1881,893,71,60,131,
1882,777,59,43,102,
1883,800,70,52,122,
1884,876,43,49,92,
1885,829,68,45,113,
1886,833,73,46,119,
1887,843,67,42,109,
1888,822,69,45,114,
1889,780,36,44,80,
1890,858,56,45,101,
1891,783,51,51,102,
1892,830,81,46,127,
1893,846,67,51,118,
1894,776,57,40,97,
1895,851,65,49,114,
1896,827,68,50,118,
1897,863,60,45,105,
1898,811,61,43,104,
1899,858,56,52,108,
1900,802,51,49,100,
1901,838,65,49,114,
1902,815,56,49,105,
1903,872,53,52,105,
1904,821,62,43,105,
1905,802,62,52,114,
1906,760,59,41,100,
1907,767,49,42,91,
1908,815,71,43,114,
1909,807,37,49,86,
1910,794,59,43,102,
1911,821,54,43,97,
1912,833,62,50,112,
1913,822,57,41,98,
1914,868,66,41,107,
1915,815,64,47,111,
1916,792,68,45,113,
1917,818,54,57,111,
1918,880,76,52,128,
1919,848,48,61,109,
1920,812,61,48,109,
1921,862,53,65,118,
1922,839,66,49,115,
1923,829,55,52,107,
1924,834,61,44,105,
1925,828,66,44,110,
1926,805,58,54,112,
1927,852,58,41,99,
1928,850,76,50,126,
1929,765,58,42,100,
1930,799,65,40,105,
1931,794,52,60,112,
1932,799,60,49,109,
1933,828,62,41,103,
1934,818,59,47,106,
1935,809,55,37,92,
1936,853,60,64,124,
1937,832,51,51,102,
1938,852,57,49,106,
1939,876,57,49,106,
1940,791,54,45,99,
1941,836,65,34,99,
1942,843,61,46,107,
1943,825,53,49,102,
1944,803,59,34,93,
1945,821,63,53,116,
1946,874,58,48,106,
1947,805,67,43,110,
1948,868,58,53,111,
1949,821,59,47,106,
1950,832,56,60,116,
1951,817,59,61,120,
1952,804,44,52,96,
1953,781,59,47,106,
1954,814,57,42,99,
1955,870,60,65,125,
1956,852,64,55,119,
1957,812,63,40,103,
1958,845,65,56,121,
1959,856,52,49,101,
1960,827,54,55,109,
1961,828,53,54,107,
1962,819,59,57,116,
1963,856,55,57,112,
1964,785,66,37,103,
1965,845,56,46,102,
1966,846,60,51,111,
1967,777,57,39,96,
1968,860,65,50,115,
1969,833,56,37,93,
1970,822,66,41,107,
1971,839,48,45,93,
1972,871,65,46,111,
1973,847,64,52,116,
1974,839,70,52,122,
1975,773,49,41,90,
1976,809,64,46,110,
1977,827,54,54,108,
1978,819,71,40,111,
1979,812,53,47,100,
1980,795,62,47,109,
1981,824,61,55,116,
1982,811,74,44,118,
1983,774,52,45,97,
1984,804,64,45,109,
1985,850,64,62,126,
1986,824,61,56,117,
1987,835,57,36,93,
1988,832,61,48,109,
1989,881,56,50,106,
1990,804,45,48,93,
1991,898,56,43,99,
1992,819,63,43,106,
1993,801,63,56,119,
1994,838,56,53,109,
1995,817,60,58,118,
1996,831,67,35,102,
1997,830,64,50,114,
1998,794,62,45,107,
1999,773,61,41,102,
2000,802,57,50,107,
2001,853,74,44,118,
2002,823,71,58,129,
2003,856,53,49,102,
2004,775,55,43,98,
2005,842,56,41,97,
2006,821,61,41,102,
2007,805,52,40,92,
2008,825,59,45,104,
2009,871,62,53,115,
2010,804,75,46,121,
2011,802,48,43,91,
2012,848,58,55,113,
2013,786,52,50,102,
2014,796,63,39,102,
2015,857,67,52,119,
2016,807,56,43,99,
2017,771,67,42,109,
2018,836,67,43,110,
2019,819,68,54,122,
2020,794,60,50,110,
2021,813,53,55,108,
2022,855,63,48,111,
2023,787,57,53,110,
2024,794,52,45,97,
2025,808,61,47,108,
2026,848,53,37,90,
2027,802,65,38,103,
2028,786,54,56,110,
2029,785,57,37,94,
2030,773,56,49,105,
2031,834,57,44,101,
2032,807,66,46,112,
2033,801,57,35,92,
2034,767,61,45,106,
2035,831,61,43,104,
2036,851,56,43,99,
2037,834,62,46,108,
2038,787,41,45,86,
2039,868,55,55,110,
2040,834,54,49,103,
2041,796,62,33,95,
2042,825,46,35,81,
2043,785,65,28,93,
2044,802,52,51,103,
2045,865,59,45,104,
2046,810,62,47,109,
2047,831,58,59,117,
2048,799,56,61,117,
2049,799,51,38,89,
2050,862,58,58,116,
2051,863,60,48,108,
2052,868,60,53,113,
2053,852,67,51,118,
2054,786,66,50,116,
2055,841,48,42,90,
2056,786,56,43,99,
2057,806,59,44,103,
2058,795,54,59,113,
2059,854,45,49,94,
2060,839,52,55,107,
2061,855,53,50,103,
2062,829,42,39,81,
2063,836,56,47,103,
2064,815,55,41,96,
2065,827,53,51,104,
2066,858,72,45,117,
2067,872,60,42,102,
2068,843,55,51,106,
2069,797,73,47,120,
2070,811,71,50,121,
2071,785,55,43,98,
2072,806,61,51,112,
2073,837,68,53,121,
2074,781,57,29,86,
2075,814,69,54,123,
2076,838,62,62,124,
2077,832,60,53,113,
2078,874,63,35,98,
2079,750,55,33,88,
2080,792,75,49,124,
2081,843,70,48,118,
2082,830,56,55,111,
2083,816,57,39,96,
2084,836,63,34,97,
2085,827,44,38,82,
2086,882,66,54,120,
2087,828,53,41,94,
2088,851,68,47,115,
2089,842,66,47,113,
2090,800,67,49,116,
2091,862,51,47,98,
2092,831,73,44,117,
2093,873,66,55,121,
2094,799,52,42,94,
2095,807,61,51,112,
2096,843,62,52,114,
2097,794,55,37,92,
2098,827,55,65,120,
2099,869,61,47,108,
2100,838,53,43,96,
2101,805,71,59,130,
2102,836,65,47,112,
2103,781,57,36,93,
2104,854,58,42,100,
2105,776,60,58,118,
2106,804,62,40,102,
2107,867,63,58,121,
2108,781,56,50,106,
2109,840,71,41,112,
2110,835,59,55,114,
2111,765,53,42,95,
2112,826,63,43,106,
2113,811,44,39,83,
2114,824,61,53,114,
2115,865,60,55,115,
2116,855,71,50,121,
2117,808,57,47,104,
2118,817,68,43,111,
2119,795,54,45,99,
2120,829,69,49,118,
2121,735,56,41,97,
2122,872,59,37,96,
2123,802,66,43,109,
2124,818,76,44,120,
2125,784,47,46,93,
2126,793,58,52,110,
2127,878,71,54,125,
2128,847,63,47,110,
2129,783,57,45,102,
2130,852,51,50,101,
2131,796,84,40,124,
2132,862,50,58,108,
2133,772,62,50,112,
2134,797,56,48,104,
2135,827,49,43,92,
2136,880,66,45,111,
2137,838,75,45,120,
2138,837,54,45,99,
2139,798,68,42,110,
2140,831,61,52,113,
2141,846,56,47,103,
2142,790,58,42,100,
2143,842,58,41,99,
2144,832,59,45,104,
2145,815,53,40,93,
2146,757,50,38,88,
2147,842,55,57,112,
2148,870,72,59,131,
2149,827,61,43,104,
2150,767,66,39,105,
2151,800,46,36,82,
2152,834,63,47,110,
2153,826,64,38,102,
2154,843,57,38,95,
2155,861,64,57,121,
2156,809,61,45,106,
2157,803,52,48,100,
2158,816,56,52,108,
2159,802,58,39,97,
2160,819,56,46,102,
2161,795,60,50,110,
2162,861,51,42,93,
2163,844,68,33,101,
2164,792,52,51,103,
2165,788,57,45,102,
2166,856,64,46,110,
2167,807,51,53,104,
2168,831,63,45,108,
2169,814,62,38,100,
2170,818,53,51,104,
2171,862,47,49,96,
2172,888,66,39,105,
2173,825,67,52,119,
2174,770,60,40,100,
2175,845,59,33,92,
2176,876,62,54,116,
2177,839,66,41,107,
2178,813,52,42,94,
2179,843,57,49,106,
2180,822,58,50,108,
2181,869,59,45,104,
2182,781,73,41,114,
2183,817,62,46,108,
2184,853,62,50,112,
2185,818,67,40,107,
2186,795,61,58,119,
2187,774,56,60,116,
2188,819,64,65,129,
2189,784,58,45,103,
2190,790,57,49,106,
2191,858,64,61,125,
2192,834,75,48,123,
2193,823,61,47,108,
2194,812,63,50,113,
2195,843,70,36,106,
2196,796,52,40,92,
2197,841,64,42,106,
2198,835,56,37,93,
2199,877,56,47,103,
2200,834,55,45,100,
2201,786,56,45,101,
2202,821,57,45,102,
2203,810,51,47,98,
2204,868,66,52,118,
2205,856,51,57,108,
2206,830,65,44,109,
2207,812,66,36,102,
2208,827,71,52,123,
2209,775,69,45,114,
2210,833,56,50,106,
2211,825,69,45,114,
2212,784,65,55,120,
2213,848,66,45,111,
2214,846,71,57,128,
2215,825,68,50,118,
2216,851,62,47,109,
2217,825,53,45,98,
2218,840,52,53,105,
2219,822,68,48,116,
2220,792,53,55,108,
2221,860,71,49,120,
2222,801,52,52,104,
2223,852,63,45,108,
2224,831,59,54,113,
2225,864,55,54,109,
2226,788,66,43,109,
2227,848,47,41,88,
2228,800,56,33,89,
2229,830,43,49,92,
2230,780,44,45,89,
2231,903,71,72,143,
2232,836,56,52,108,
2233,786,60,50,110,
2234,835,67,42,109,
2235,863,49,65,114,
2236,844,56,57,113,
2237,780,50,33,83,
2238,803,60,34,94,
2239,848,73,43,116,
2240,868,56,59,115,
2241,791,59,50,109,
2242,816,61,48,109,
2243,834,63,45,108,
2244,796,63,44,107,
2245,844,72,60,132,
2246,790,68,42,110,
2247,813,68,45,113,
2248,789,50,46,96,
2249,902,73,42,115,
2250,836,66,39,105,
2251,847,55,46,101,
2252,780,59,47,106,
2253,842,69,48,117,
2254,832,69,55,124,
2255,803,54,43,97,
2256,860,73,46,119,
2257,773,57,40,97,
2258,826,54,38,92,
2259,815,64,36,100,
2260,843,64,38,102,
2261,844,57,49,106,
2262,785,58,42,100,
2263,830,55,49,104,
2264,806,65,44,109,
2265,782,70,48,118,
2266,836,65,45,110,
2267,838,60,48,108,
2268,825,48,42,90,
2269,776,51,38,89,
2270,846,73,36,109,
2271,811,63,36,99,
2272,898,74,50,124,
2273,862,60,50,110,
2274,784,60,44,104,
2275,827,53,43,96,
2276,818,58,41,99,
2277,802,59,39,98,
2278,817,59,46,105,
2279,835,64,62,126,
2280,849,67,44,111,
2281,790,62,39,101,
2282,810,49,43,92,
2283,856,64,55,119,
2284,829,54,59,113,
2285,851,59,51,110,
2286,807,47,50,97,
2287,793,56,43,99,
2288,788,58,45,103,
2289,767,62,49,111,
2290,833,63,55,118,
2291,806,55,40,95,
2292,887,59,39,98,
2293,814,64,38,102,
2294,874,66,46,112,
2295,829,64,39,103,
2296,749,52,33,85,
2297,795,50,42,92,
2298,787,39,41,80,
2299,773,42,34,76,
2300,822,67,43,110,
2301,848,61,71,132,
2302,822,49,38,87,
2303,859,69,62,131,
2304,819,59,53,112,
2305,800,69,44,113,
2306,832,48,52,100,
2307,764,55,43,98,
2308,783,63,52,115,
2309,831,67,45,112,
2310,813,67,51,118,
2311,885,68,70,138,
2312,751,49,37,86,
2313,823,67,54,121,
2314,793,62,45,107,
2315,850,66,46,112,
2316,861,59,48,107,
2317,857,61,47,108,
2318,797,47,46,93,
2319,800,51,47,98,
2320,752,52,47,99,
2321,829,82,43,125,
2322,881,67,54,121,
2323,805,71,57,128,
2324,800,56,33,89,
2325,783,66,50,116,
2326,812,60,43,103,
2327,803,54,37,91,
2328,883,70,45,115,
2329,886,49,56,105,
2330,826,65,44,109,
2331,824,49,55,104,
2332,811,56,39,95,
2333,829,76,41,117,
2334,815,58,39,97,
2335,797,60,47,107,
2336,835,65,53,118,
2337,825,54,47,101,
2338,821,54,41,95,
2339,825,50,43,93,
2340,829,47,47,94,
2341,839,56,45,101,
2342,849,57,51,108,
2343,821,60,45,105,
2344,842,56,46,102,
2345,813,57,46,103,
2346,864,58,56,114,
2347,828,51,60,111,
2348,818,70,47,117,
2349,833,46,42,88,
2350,805,69,45,114,
2351,775,70,41,111,
2352,824,45,53,98,
2353,867,59,40,99,
2354,818,69,46,115,
2355,855,59,48,107,
2356,803,51,28,79,
2357,838,66,51,117,
2358,803,63,37,100,
2359,820,52,52,104,
2360,835,54,50,104,
2361,842,75,59,134,
2362,789,60,47,107,
2363,824,72,44,116,
2364,822,65,40,105,
2365,877,55,47,102,
2366,761,60,43,103,
2367,823,61,54,115,
2368,872,64,42,106,
2369,807,48,46,94,
2370,851,62,52,114,
2371,785,63,42,105,
2372,816,70,52,122,
2373,794,61,39,100,
2374,801,68,51,119,
2375,841,61,53,114,
2376,840,62,36,98,
2377,826,61,55,116,
2378,808,59,47,106,
2379,803,57,51,108,
2380,830,71,50,121,
2381,762,57,31,88,
2382,798,47,59,106,
2383,834,51,52,103,
2384,854,62,41,103,
2385,799,40,41,81,
2386,842,52,45,97,
2387,880,66,48,114,
2388,853,67,51,118,
2389,800,58,49,107,
2390,768,50,43,93,
2391,825,66,47,113,
2392,808,48,52,100,
2393,858,58,38,96,
2394,824,75,41,116,
2395,762,47,37,84,
2396,802,65,46,111,
2397,825,64,53,117,
2398,865,48,61,109,
2399,822,44,37,81,
2400,804,57,39,96,
2401,788,61,38,99,
2402,842,67,46,113,
2403,777,63,47,110,
2404,788,45,42,87,
2405,816,64,55,119,
2406,811,62,48,110,
2407,817,55,45,100,
2408,813,71,48,119,
2409,829,66,39,105,
2410,817,65,48,113,
2411,848,62,39,101,
2412,788,60,41,101,
2413,865,59,51,110,
2414,823,77,44,121,
2415,806,72,51,123,
2416,870,53,54,107,
2417,787,51,54,105,
2418,844,64,44,108,
2419,803,59,30,89,
2420,861,62,53,115,
2421,845,53,55,108,
2422,787,59,39,98,
2423,851,66,44,110,
2424,792,67,47,114,
2425,840,55,43,98,
2426,833,57,53,110,
2427,814,40,52,92,
2428,823,50,52,102,
2429,785,58,39,97,
2430,755,51,43,94,
2431,821,56,50,106,
2432,823,76,56,132,
2433,831,57,46,103,
2434,830,64,41,105,
2435,884,65,50,115,
2436,814,52,44,96,
2437,851,61,68,129,
2438,821,54,51,105,
2439,830,65,52,117,
2440,820,53,39,92,
2441,790,61,43,104,
2442,832,48,49,97,
2443,753,54,40,94,
2444,846,56,54,110,
2445,806,45,46,91,
2446,808,53,49,102,
2447,827,52,39,91,
2448,811,60,46,106,
2449,906,55,44,99,
2450,833,54,38,92,
2451,799,66,37,103,
2452,812,65,40,105,
2453,800,67,42,109,
2454,812,66,47,113,
2455,837,51,46,97,
2456,784,46,36,82,
2457,820,62,43,105,
2458,809,53,50,103,
2459,835,56,54,110,
2460,790,48,40,88,
2461,859,64,54,118,
2462,840,47,45,92,
2463,860,45,49,94,
2464,826,74,47,121,
2465,817,63,53,116,
2466,824,55,48,103,
2467,847,57,43,100,
2468,836,62,49,111,
2469,821,57,42,99,
2470,809,70,48,118,
2471,809,57,47,104,
2472,858,73,52,125,
2473,796,65,45,110,
2474,819,56,39,95,
2475,858,63,49,112,
2476,829,65,49,114,
2477,790,45,44,89,
2478,836,60,44,104,
2479,846,51,47,98,
2480,843,59,52,111,
2481,820,72,58,130,
2482,796,60,53,113,
2483,867,77,59,136,
2484,795,64,40,104,
2485,811,56,40,96,
2486,868,71,51,122,
2487,875,54,37,91,
2488,848,67,56,123,
2489,857,53,52,105,
2490,819,56,55,111,
2491,822,61,40,101,
2492,775,45,38,83,
2493,835,59,52,111,
2494,844,47,47,94,
2495,849,70,49,119,
2496,815,69,63,132,
2497,793,54,49,103,
2498,888,60,48,108,
2499,824,63,49,112,
2500,833,42,44,86,
2501,811,63,44,107,
2502,781,52,46,98,
2503,804,52,50,102,
2504,844,65,40,105,
2505,827,52,45,97,
2506,837,65,56,121,
2507,786,64,43,107,
2508,833,66,48,114,
2509,839,71,49,120,
2510,801,63,43,106,
2511,861,71,55,126,
2512,836,74,46,120,
2513,818,71,47,118,
2514,787,60,43,103,
2515,811,51,48,99,
2516,852,72,51,123,
2517,844,70,53,123,
2518,864,62,49,111,
2519,781,60,44,104,
2520,828,55,49,104,
2521,845,65,52,117,
2522,888,63,43,106,
2523,837,75,44,119,
2524,842,60,57,117,
2525,821,48,49,97,
2526,854,58,54,112,
2527,821,50,52,102,
2528,799,64,39,103,
2529,851,68,47,115,
2530,801,60,47,107,
2531,851,51,49,100,
2532,829,58,53,111,
2533,836,51,56,107,
2534,837,66,45,111,
2535,858,55,42,97,
2536,817,59,44,103,
2537,865,62,48,110,
2538,844,70,41,111,
2539,860,72,60,132,
2540,812,49,53,102,
2541,860,64,43,107,
2542,829,56,50,106,
2543,839,50,44,94,
2544,808,70,49,119,
2545,845,59,42,101,
2546,799,59,66,125,
2547,829,60,50,110,
2548,806,61,52,113,
2549,811,52,51,103,
2550,791,54,41,95,
2551,851,62,49,111,
2552,814,60,59,119,
2553,838,61,43,104,
2554,819,61,44,105,
2555,834,46,44,90,
2556,833,54,50,104,
2557,825,54,40,94,
2558,789,54,40,94,
2559,821,68,60,128,
2560,838,60,59,119,
2561,791,55,36,91,
2562,833,70,47,117,
2563,809,65,44,109,
2564,792,73,48,121,
2565,870,56,52,108,
2566,876,58,52,110,
2567,818,70,52,122,
2568,794,55,50,105,
2569,807,54,50,104,
2570,831,66,61,127,
2571,798,65,39,104,
2572,847,67,45,112,
2573,833,60,49,109,
2574,795,41,43,84,
2575,793,58,54,112,
2576,832,62,54,116,
2577,848,47,46,93,
2578,826,50,45,95,
2579,790,60,44,104,
2580,801,59,48,107,
2581,813,61,42,103,
2582,789,56,36,92,
2583,840,67,55,122,
2584,819,63,40,103,
2585,874,80,41,121,
2586,795,71,39,110,
2587,802,48,46,94,
2588,839,60,40,100,
2589,737,41,38,79,
2590,787,55,43,98,
2591,809,67,42,109,
2592,882,67,56,123,
2593,802,64,35,99,
2594,791,55,56,111,
2595,824,58,43,101,
2596,841,60,42,102,
2597,832,51,56,107,
2598,795,52,42,94,
2599,820,59,42,101,
2600,808,67,40,107,
2601,831,56,44,100,
2602,805,61,52,113,
2603,831,52,47,99,
2604,830,59,48,107,
2605,855,63,45,108,
2606,800,53,47,100,
2607,847,64,56,120,
2608,823,48,53,101,
2609,812,70,52,122,
2610,841,64,52,116,
2611,870,63,50,113,
2612,865,61,44,105,
2613,848,60,63,123,
2614,829,50,44,94,
2615,851,47,52,99,
2616,826,59,59,118,
2617,813,52,57,109,
2618,841,56,45,101,
2619,855,70,50,120,
2620,811,50,44,94,
2621,819,55,35,90,
2622,831,67,47,114,
2623,816,66,36,102,
2624,866,65,46,111,
2625,829,60,41,101,
2626,860,53,44,97,
2627,803,53,42,95,
2628,778,55,45,100,
2629,807,52,55,107,
2630,842,56,44,100,
2631,836,58,51,109,
2632,883,72,48,120,
2633,826,53,52,105,
2634,821,65,49,114,
2635,808,63,52,115,
2636,810,61,48,109,
2637,835,67,53,120,
2638,865,57,47,104,
2639,884,65,58,123,
2640,813,69,39,108,
2641,840,70,44,114,
2642,805,53,52,105,
2643,827,72,39,111,
2644,788,75,46,121,
2645,883,62,64,126,
2646,811,62,53,115,
2647,855,57,53,110,
2648,806,66,52,118,
2649,817,57,46,103,
2650,862,57,59,116,
2651,868,65,41,106,
2652,768,52,47,99,
2653,803,57,49,106,
2654,842,68,52,120,
2655,844,68,50,118,
2656,813,67,39,106,
2657,757,67,39,106,
2658,807,49,52,101,
2659,823,65,43,108,
2660,841,64,50,114,
2661,826,58,46,104,
2662,833,54,49,103,
2663,829,51,37,88,
2664,816,64,37,101,
2665,831,45,37,82,
2666,813,54,40,94,
2667,867,64,42,106,
2668,822,67,46,113,
2669,822,49,49,98,
2670,785,59,54,113,
2671,853,58,45,103,
2672,857,66,41,107,
2673,835,57,44,101,
2674,843,53,54,107,
2675,809,53,53,106,
2676,822,61,51,112,
2677,846,64,52,116,
2678,854,67,48,115,
2679,822,54,42,96,
2680,865,54,43,97,
2681,803,60,35,95,
2682,817,52,47,99,
2683,824,39,44,83,
2684,834,74,34,108,
2685,849,72,44,116,
2686,829,61,59,120,
2687,808,59,40,99,
2688,851,55,48,103,
2689,864,64,66,130,
2690,812,60,63,123,
2691,837,70,45,115,
2692,778,64,35,99,
2693,756,49,47,96,
2694,835,74,43,117,
2695,833,68,49,117,
2696,834,56,38,94,
2697,849,72,42,114,
2698,803,74,38,112,
2699,796,51,49,100,
2700,830,63,35,98,
2701,802,64,45,109,
2702,843,48,40,88,
2703,787,58,44,102,
2704,825,55,55,110,
2705,816,55,55,110,
2706,833,64,47,111,
2707,808,55,50,105,
2708,772,78,40,118,
2709,840,66,43,109,
2710,846,71,42,113,
2711,797,66,44,110,
2712,814,54,52,106,
2713,789,60,41,101,
2714,819,61,45,106,
2715,828,69,51,120,
2716,779,53,44,97,
2717,853,69,55,124,
2718,826,63,47,110,
2719,860,52,40,92,
2720,847,60,39,99,
2721,848,54,49,103,
2722,805,48,47,95,
2723,791,62,64,126,
2724,867,47,42,89,
2725,794,62,52,114,
2726,787,44,55,99,
2727,849,69,46,115,
2728,823,61,50,111,
2729,866,55,38,93,
2730,780,58,48,106,
2731,817,50,39,89,
2732,866,62,44,106,
2733,876,68,51,119,
2734,766,58,54,112,
2735,847,53,58,111,
2736,861,66,41,107,
2737,819,54,45,99,
2738,771,66,44,110,
2739,837,58,53,111,
2740,797,57,44,101,
2741,798,57,41,98,
2742,807,56,41,97,
2743,879,58,44,102,
2744,781,58,43,101,
2745,813,54,50,104,
2746,751,58,41,99,
2747,825,71,38,109,
2748,779,58,44,102,
2749,819,64,51,115,
2750,774,56,46,102,
2751,847,60,50,110,
2752,840,73,48,121,
2753,839,67,45,112,
2754,821,71,45,116,
2755,853,63,54,117,
2756,838,63,46,109,
2757,807,68,36,104,
2758,844,51,49,100,
2759,810,67,47,114,
2760,843,56,53,109,
2761,884,61,55,116,
2762,824,51,52,103,
2763,819,55,60,115,
2764,859,60,52,112,
2765,828,67,49,116,
2766,823,60,35,95,
2767,782,68,51,119,
2768,791,51,43,94,
2769,835,48,42,90,
2770,851,71,53,124,
2771,818,51,44,95,
2772,828,50,36,86,
2773,827,66,44,110,
2774,814,69,43,112,
2775,820,69,45,114,
2776,851,71,49,120,
2777,838,70,55,125,
2778,834,49,58,107,
2779,796,55,40,95,
2780,777,56,43,99,
2781,821,54,37,91,
2782,885,68,54,122,
2783,833,36,38,74,
2784,778,49,50,99,
2785,847,53,44,97,
2786,831,53,49,102,
2787,803,51,41,92,
2788,835,58,44,102,
2789,843,60,45,105,
2790,826,56,38,94,
2791,783,60,44,104,
2792,836,56,46,102,
2793,800,65,47,112,
2794,787,61,49,110,
2795,820,66,54,120,
2796,798,62,46,108,
2797,846,57,53,110,
2798,850,75,40,115,
2799,810,53,45,98,
2800,832,55,42,97,
2801,828,52,47,99,
2802,828,64,46,110,
2803,803,66,50,116,
2804,830,65,41,106,
2805,823,56,37,93,
2806,871,49,50,99,
2807,856,58,50,108,
2808,828,51,52,103,
2809,853,59,48,107,
2810,854,57,50,107,
2811,799,55,56,111,
2812,834,53,40,93,
2813,840,53,57,110,
2814,780,52,45,97,
2815,767,60,47,107,
2816,848,72,45,117,
2817,830,72,37,109,
2818,858,64,51,115,
2819,847,52,42,94,
2820,804,49,45,94,
2821,831,59,46,105,
2822,857,63,53,116,
2823,848,55,48,103,
2824,808,64,47,111,
2825,800,63,48,111,
2826,804,61,43,104,
2827,873,84,44,128,
2828,832,70,61,131,
2829,884,55,63,118,
2830,825,52,55,107,
2831,809,59,48,107,
2832,823,47,41,88,
2833,857,59,59,118,
2834,798,63,55,118,
2835,874,57,41,98,
2836,772,60,37,97,
2837,831,57,37,94,
2838,878,71,58,129,
2839,818,55,57,112,
2840,825,46,46,92,
2841,803,57,37,94,
2842,780,65,46,111,
2843,831,65,43,108,
2844,806,65,46,111,
2845,846,66,43,109,
2846,836,62,47,109,
2847,860,55,46,101,
2848,817,52,43,95,
2849,746,54,50,104,
2850,797,69,54,123,
2851,828,70,55,125,
2852,841,71,48,119,
2853,832,60,50,110,
2854,790,59,54,113,
2855,845,74,48,122,
2856,778,40,36,76,
2857,875,52,39,91,
2858,819,58,51,109,
2859,887,76,47,123,
2860,764,39,41,80,
2861,786,62,49,111,
2862,789,59,42,101,
2863,859,46,59,105,
2864,763,61,38,99,
2865,789,46,42,88,
2866,799,63,49,112,
2867,847,62,43,105,
2868,790,42,41,83,
2869,846,56,43,99,
2870,823,65,47,112,
2871,849,67,39,106,
2872,776,51,49,100,
2873,833,62,52,114,
2874,833,57,51,108,
2875,838,46,47,93,
2876,826,62,45,107,
2877,786,46,46,92,
2878,799,61,40,101,
2879,822,47,49,96,
2880,774,54,37,91,
2881,837,66,46,112,
2882,819,45,52,97,
2883,810,65,43,108,
2884,805,56,52,108,
2885,824,60,40,100,
2886,822,69,48,117,
2887,845,64,43,107,
2888,827,54,48,102,
2889,822,59,45,104,
2890,811,62,38,100,
2891,805,64,50,114,
2892,787,65,32,97,
2893,787,56,42,98,
2894,807,56,50,106,
2895,764,60,46,106,
2896,874,46,43,89,
2897,841,64,44,108,
2898,820,73,53,126,
2899,795,50,37,87,
2900,796,45,37,82,
2901,806,67,49,116,
2902,832,42,35,77,
2903,898,63,44,107,
2904,876,60,40,100,
2905,830,57,43,100,
2906,790,49,45,94,
2907,836,66,48,114,
2908,857,57,40,97,
2909,786,52,42,94,
2910,828,56,40,96,
2911,833,43,48,91,
2912,801,63,58,121,
2913,791,41,40,81,
2914,836,52,45,97,
2915,833,61,48,109,
2916,819,75,38,113,
2917,844,56,53,109,
2918,867,72,56,128,
2919,918,85,57,142,
2920,784,56,32,88,
2921,845,65,49,114,
2922,802,57,44,101,
2923,847,56,42,98,
2924,837,47,62,109,
2925,861,67,48,115,
2926,845,71,40,111,
2927,797,65,47,112,
2928,812,68,49,117,
2929,881,63,57,120,
2930,788,60,49,109,
2931,831,57,41,98,
2932,832,61,37,98,
2933,892,65,48,113,
2934,762,47,39,86,
2935,839,61,53,114,
2936,772,62,46,108,
2937,794,51,44,95,
2938,842,71,45,116,
2939,808,58,40,98,
2940,904,71,62,133,
2941,838,53,53,106,
2942,828,59,52,111,
2943,758,56,56,112,
2944,790,61,40,101,
2945,867,66,51,117,
2946,810,62,35,97,
2947,832,61,42,103,
2948,813,51,47,98,
2949,776,59,47,106,
2950,789,65,44,109,
2951,756,52,44,96,
2952,803,67,50,117,
2953,829,56,57,113,
2954,793,50,51,101,
2955,763,56,41,97,
2956,871,47,53,100,
2957,785,63,37,100,
2958,876,59,54,113,
2959,809,65,51,116,
2960,780,57,38,95,
2961,835,53,41,94,
2962,756,56,37,93,
2963,854,54,57,111,
2964,793,48,43,91,
2965,781,61,52,113,
2966,837,62,46,108,
2967,839,54,48,102,
2968,823,70,60,130,
2969,794,58,38,96,
2970,800,59,58,117,
2971,845,55,51,106,
2972,844,61,55,116,
2973,838,47,49,96,
2974,858,54,48,102,
2975,802,49,58,107,
2976,774,52,42,94,
2977,802,52,46,98,
2978,814,59,44,103,
2979,814,56,39,95,
2980,898,78,40,118,
2981,843,59,48,107,
2982,790,57,50,107,
2983,811,57,50,107,
2984,809,69,37,106,
2985,791,61,39,100,
2986,870,68,38,106,
2987,840,56,44,100,
2988,777,59,39,98,
2989,910,79,53,132,
2990,841,65,59,124,
2991,847,71,52,123,
2992,782,58,44,102,
2993,804,55,50,105,
2994,826,65,41,106,
2995,836,65,49,114,
2996,824,55,52,107,
2997,897,58,58,116,
2998,823,72,50,122,
2999,798,61,46,107,
3000,841,75,46,121,
3001,771,58,54,112,
3002,832,66,45,111,
3003,818,52,58,110,
3004,786,61,46,107,
3005,829,59,33,92,
3006,832,64,48,112,
3007,844,57,43,100,
3008,751,53,40,93,
3009,821,55,43,98,
3010,843,71,52,123,
3011,891,73,49,122,
3012,840,54,44,98,
3013,833,52,72,124,
3014,849,57,45,102,
3015,843,46,41,87,
3016,821,67,36,103,
3017,810,64,58,122,
3018,866,56,46,102,
3019,778,50,45,95,
3020,812,74,36,110,
3021,819,58,37,95,
3022,851,69,49,118,
3023,825,63,47,110,
3024,823,53,53,106,
3025,789,54,45,99,
3026,858,57,48,105,
3027,812,48,44,92,
3028,829,60,49,109,
3029,853,62,55,117,
3030,802,54,38,92,
3031,760,44,41,85,
3032,885,57,47,104,
3033,793,58,41,99,
3034,845,70,51,121,
3035,854,67,50,117,
3036,842,62,42,104,
3037,834,56,43,99,
3038,812,74,44,118,
3039,844,61,41,102,
3040,840,57,46,103,
3041,848,83,51,134,
3042,824,56,44,100,
3043,845,52,54,106,
3044,800,60,47,107,
3045,842,54,59,113,
3046,839,57,58,115,
3047,835,69,46,115,
3048,791,56,51,107,
3049,817,59,41,100,
3050,837,63,54,117,
3051,848,64,49,113,
3052,849,53,42,95,
3053,759,52,46,98,
3054,778,39,47,86,
3055,863,67,43,110,
3056,805,50,53,103,
3057,798,52,50,102,
3058,811,54,45,99,
3059,830,55,55,110,
3060,794,49,55,104,
3061,851,58,47,105,
3062,844,63,49,112,
3063,848,58,48,106,
3064,843,47,41,88,
3065,851,62,51,113,
3066,841,59,41,100,
3067,796,55,51,106,
3068,790,60,52,112,
3069,850,59,52,111,
3070,842,44,46,90,
3071,855,62,44,106,
3072,796,73,47,120,
3073,822,68,51,119,
3074,869,75,42,117,
3075,790,44,46,90,
3076,821,54,48,102,
3077,849,64,43,107,
3078,851,65,56,121,
3079,839,66,48,114,
3080,871,59,43,102,
3081,844,72,50,122,
3082,838,63,39,102,
3083,783,60,52,112,
3084,803,47,40,87,
3085,878,69,59,128,
3086,857,57,58,115,
3087,810,63,43,106,
3088,841,48,52,100,
3089,772,66,47,113,
3090,820,52,56,108,
3091,857,71,48,119,
3092,869,61,57,118,
3093,877,52,51,103,
3094,869,71,42,113,
3095,806,64,52,116,
3096,829,49,41,90,
3097,792,69,52,121,
3098,805,68,48,116,
3099,786,65,40,105,
3100,828,61,49,110,
3101,864,68,48,116,
3102,853,67,47,114,
3103,767,56,43,99,
3104,830,70,45,115,
3105,789,59,46,105,
3106,841,67,53,120,
3107,862,64,40,104,
3108,861,56,56,112,
3109,819,56,61,117,
3110,861,63,49,112,
3111,836,56,54,110,
3112,851,49,45,94,
3113,848,51,51,102,
3114,797,63,39,102,
3115,880,65,50,115,
3116,806,62,40,102,
3117,801,63,44,107,
3118,824,64,41,105,
3119,806,54,43,97,
3120,788,38,48,86,
3121,842,47,40,87,
3122,816,64,54,118,
3123,810,65,55,120,
3124,800,41,47,88,
3125,813,64,52,116,
3126,791,49,45,94,
3127,795,57,46,103,
3128,804,54,36,90,
3129,849,74,41,115,
3130,816,44,48,92,
3131,842,60,37,97,
3132,761,54,43,97,
3133,857,49,47,96,
3134,840,65,53,118,
3135,808,72,39,111,
3136,796,41,46,87,
3137,877,55,60,115,
3138,883,56,57,113,
3139,824,63,70,133,
3140,852,73,54,127,
3141,875,81,54,135,
3142,813,65,53,118,
3143,809,58,52,110,
3144,819,57,50,107,
3145,854,58,53,111,
3146,851,62,35,97,
3147,773,57,38,95,
3148,878,59,48,107,
3149,815,61,50,111,
3150,870,66,56,122,
3151,855,60,53,113,
3152,846,64,54,118,
3153,785,57,42,99,
3154,808,55,52,107,
3155,858,64,48,112,
3156,835,55,50,105,
3157,827,56,47,103,
3158,812,65,38,103,
3159,813,46,40,86,
3160,796,66,46,112,
3161,819,58,36,94,
3162,878,59,47,106,
3163,834,55,58,113,
3164,805,54,39,93,
3165,797,68,39,107,
3166,861,54,53,107,
3167,821,72,42,114,
3168,811,63,44,107,
3169,852,57,43,100,
3170,841,58,51,109,
3171,821,60,52,112,
3172,842,49,56,105,
3173,819,64,40,104,
3174,813,70,47,117,
3175,833,69,50,119,
3176,803,70,38,108,
3177,880,61,43,104,
3178,818,60,43,103,
3179,826,65,40,105,
3180,773,68,44,112,
3181,829,56,46,102,
3182,844,73,53,126,
3183,846,67,43,110,
3184,821,57,41,98,
3185,791,60,44,104,
3186,799,43,45,88,
3187,803,53,49,102,
3188,788,75,42,117,
3189,842,64,43,107,
3190,816,62,35,97,
3191,811,66,49,115,
3192,799,42,53,95,
3193,817,73,36,109,
3194,820,55,52,107,
3195,797,61,43,104,
3196,823,65,43,108,
3197,813,56,39,95,
3198,830,60,51,111,
3199,860,67,54,121,
3200,821,52,57,109,
3201,861,62,33,95,
3202,816,75,57,132,
3203,762,58,41,99,
3204,820,58,49,107,
3205,864,67,45,112,
3206,848,67,64,131,
3207,819,63,47,110,
3208,860,59,43,102,
3209,823,52,41,93,
3210,835,64,34,98,
3211,828,51,48,99,
3212,797,56,42,98,
3213,789,58,55,113,
3214,823,72,49,121,
3215,840,56,41,97,
3216,798,66,61,127,
3217,826,60,50,110,
3218,830,65,44,109,
3219,881,61,70,131,
3220,813,59,56,115,
3221,822,70,37,107,
3222,805,64,42,106,
3223,830,68,40,108,
3224,821,57,43,100,
3225,834,57,54,111,
3226,793,56,52,108,
3227,793,59,43,102,
3228,854,60,41,101,
3229,826,75,43,118,
3230,828,63,46,109,
3231,868,58,55,113,
3232,812,58,50,108,
3233,837,68,40,108,
3234,849,67,48,115,
3235,834,65,41,106,
3236,858,63,42,105,
3237,789,64,47,111,
3238,819,65,51,116,
3239,806,74,49,123,
3240,788,57,47,104,
3241,801,41,40,81,
3242,842,54,44,98,
3243,792,58,41,99,
3244,880,69,58,127,
3245,822,53,46,99,
3246,773,49,38,87,
3247,831,46,41,87,
3248,840,52,49,101,
3249,848,62,47,109,
3250,845,55,49,104,
3251,876,62,46,108,
3252,790,52,38,90,
3253,818,59,45,104,
3254,770,65,53,118,
3255,853,68,33,101,
3256,836,52,51,103,
3257,855,60,53,113,
3258,818,69,57,126,
3259,850,64,47,111,
3260,765,52,37,89,
3261,842,71,35,106,
3262,840,39,52,91,
3263,859,69,39,108,
3264,829,63,36,99,
3265,793,59,61,120,
3266,821,53,46,99,
3267,835,63,51,114,
3268,826,60,57,117,
3269,857,66,55,121,
3270,797,51,52,103,
3271,827,63,53,116,
3272,914,57,59,116,
3273,848,58,50,108,
3274,857,62,50,112,
3275,818,70,37,107,
3276,818,55,45,100,
3277,858,75,47,122,
3278,791,58,47,105,
3279,872,65,55,120,
3280,841,61,49,110,
3281,799,50,40,90,
3282,853,66,40,106,
3283,842,58,66,124,
3284,841,62,41,103,
3285,827,70,56,126,
3286,832,66,36,102,
3287,821,54,28,82,
3288,816,68,42,110,
3289,840,68,50,118,
3290,878,67,61,128,
3291,838,55,49,104,
3292,843,64,53,117,
3293,863,73,57,130,
3294,799,61,44,105,
3295,848,79,41,120,
3296,808,75,45,120,
3297,827,59,42,101,
3298,786,49,38,87,
3299,799,52,38,90,
3300,866,46,43,89,
3301,889,68,58,126,
3302,849,59,46,105,
3303,855,72,48,120,
3304,840,65,52,117,
3305,814,66,33,99,
3306,920,46,60,106,
3307,829,58,63,121,
3308,805,64,43,107,
3309,848,56,40,96,
3310,836,61,50,111,
3311,809,50,53,103,
3312,819,70,46,116,
3313,832,56,52,108,
3314,854,65,56,121,
3315,826,52,57,109,
3316,820,46,34,80,
3317,814,50,42,92,
3318,786,46,56,102,
3319,799,59,52,111,
3320,805,60,54,114,
3321,813,58,40,98,
3322,821,53,52,105,
3323,819,66,53,119,
3324,824,68,46,114,
3325,840,62,51,113,
3326,786,51,38,89,
3327,846,55,47,102,
3328,828,62,32,94,
3329,734,72,45,117,
3330,846,66,48,114,
3331,792,58,34,92,
3332,788,58,45,103,
3333,789,55,48,103,
3334,833,73,47,120,
3335,816,66,44,110,
3336,843,54,49,103,
3337,831,55,61,116,
3338,832,73,52,125,
3339,819,63,45,108,
3340,835,65,49,114,
3341,894,67,45,112,
3342,767,61,44,105,
3343,803,44,36,80,
3344,803,57,47,104,
3345,816,51,54,105,
3346,775,66,46,112,
3347,850,61,47,108,
3348,770,61,37,98,
3349,804,54,39,93,
3350,806,65,47,112,
3351,827,61,41,102,
3352,837,71,47,118,
3353,793,61,46,107,
3354,825,57,45,102,
3355,841,59,40,99,
3356,790,51,52,103,
3357,812,51,37,88,
3358,860,60,51,111,
3359,834,70,50,120,
3360,836,64,33,97,
3361,754,60,35,95,
3362,854,58,55,113,
3363,822,69,47,116,
3364,804,72,43,115,
3365,841,68,47,115,
3366,804,53,53,106,
3367,835,52,50,102,
3368,823,65,59,124,
3369,839,67,51,118,
3370,824,75,35,110,
3371,835,56,37,93,
3372,848,52,63,115,
3373,825,74,50,124,
3374,800,52,57,109,
3375,821,68,42,110,
3376,809,66,60,126,
3377,811,65,46,111,
3378,799,57,43,100,
3379,825,66,45,111,
3380,841,65,40,105,
3381,822,64,42,106,
3382,829,51,63,114,
3383,821,63,58,121,
3384,799,68,41,109,
3385,820,56,47,103,
3386,845,62,38,100,
3387,869,56,42,98,
3388,853,52,40,92,
3389,839,57,33,90,
3390,845,61,48,109,
3391,833,55,42,97,
3392,782,61,41,102,
3393,801,69,39,108,
3394,772,53,46,99,
3395,867,68,53,121,
3396,848,52,60,112,
3397,817,56,54,110,
3398,791,61,49,110,
3399,847,65,53,118,
3400,823,68,42,110,
3401,820,47,63,110,
3402,780,64,33,97,
3403,840,70,50,120,
3404,828,56,48,104,
3405,848,65,57,122,
3406,803,54,39,93,
3407,805,61,40,101,
3408,891,82,46,128,
3409,824,63,51,114,
3410,832,58,43,101,
3411,796,55,58,113,
3412,814,72,46,118,
3413,790,47,46,93,
3414,850,72,39,111,
3415,860,78,49,127,
3416,851,56,60,116,
3417,837,59,52,111,
3418,881,70,51,121,
3419,868,58,43,101,
3420,833,51,56,107,
3421,828,66,48,114,
3422,855,67,34,101,
3423,858,66,46,112,
3424,821,67,37,104,
3425,821,66,44,110,
3426,833,55,46,101,
3427,823,63,41,104,
3428,889,51,60,111,
3429,822,60,41,101,
3430,833,64,48,112,
3431,780,55,58,113,
3432,815,52,49,101,
3433,851,64,44,108,
3434,828,59,48,107,
3435,852,58,48,106,
3436,853,68,42,110,
3437,837,63,47,110,
3438,830,64,51,115,
3439,792,66,42,108,
3440,816,75,37,112,
3441,870,55,50,105,
3442,789,52,38,90,
3443,800,52,42,94,
3444,843,59,39,98,
3445,808,53,39,92,
3446,809,50,53,103,
3447,857,66,45,111,
3448,882,71,42,113,
3449,792,59,52,111,
3450,813,57,58,115,
3451,824,69,49,118,
3452,827,61,53,114,
3453,782,64,40,104,
3454,782,49,38,87,
3455,846,61,58,119,
3456,831,58,40,98,
3457,754,59,39,98,
3458,808,56,51,107,
3459,785,61,46,107,
3460,803,64,45,109,
3461,821,52,41,93,
3462,789,55,41,96,
3463,795,68,60,128,
3464,844,61,51,112,
3465,799,61,42,103,
3466,806,66,39,105,
3467,833,69,37,106,
3468,851,74,58,132,
3469,812,71,54,125,
3470,736,54,34,88,
3471,811,65,44,109,
3472,849,52,39,91,
3473,819,56,56,112,
3474,819,67,52,119,
3475,825,54,49,103,
3476,827,54,49,103,
3477,842,76,48,124,
3478,836,63,57,120,
3479,839,48,46,94,
3480,852,45,51,96,
3481,831,60,48,108,
3482,814,68,47,115,
3483,816,62,35,97,
3484,802,59,47,106,
3485,810,58,42,100,
3486,805,45,37,82,
3487,808,59,51,110,
3488,833,68,35,103,
3489,870,62,43,105,
3490,811,60,48,108,
3491,856,61,57,118,
3492,832,72,55,127,
3493,836,59,56,115,
3494,844,71,33,104,
3495,801,60,58,118,
3496,846,77,42,119,
3497,805,64,43,107,
3498,827,52,34,86,
3499,806,45,43,88,
3500,808,56,59,115,
3501,924,56,53,109,
3502,831,72,54,126,
3503,786,58,55,113,
3504,870,44,48,92,
3505,792,58,51,109,
3506,833,51,47,98,
3507,813,70,43,113,
3508,838,70,43,113,
3509,799,44,48,92,
3510,780,56,41,97,
3511,767,66,34,100,
3512,829,57,54,111,
3513,824,67,42,109,
3514,798,55,48,103,
3515,811,53,52,105,
3516,828,42,49,91,
3517,762,44,46,90,
3518,843,66,35,101,
3519,809,51,52,103,
3520,773,54,47,101,
3521,824,58,40,98,
3522,851,63,45,108,
3523,860,62,69,131,
3524,845,53,44,97,
3525,789,65,45,110,
3526,804,64,45,109,
3527,799,49,46,95,
3528,846,62,52,114,
3529,851,48,38,86,
3530,841,59,41,100,
3531,859,68,43,111,
3532,829,60,44,104,
3533,797,52,45,97,
3534,838,57,51,108,
3535,904,66,36,102,
3536,785,57,44,101,
3537,819,61,39,100,
3538,870,77,45,122,
3539,847,66,48,114,
3540,811,46,41,87,
3541,800,48,61,109,
3542,822,55,43,98,
3543,901,79,53,132,
3544,769,55,39,94,
3545,813,59,46,105,
3546,831,65,45,110,
3547,823,56,48,104,
3548,788,66,44,110,
3549,796,46,50,96,
3550,829,57,38,95,
3551,838,69,51,120,
3552,806,49,53,102,
3553,836,69,42,111,
3554,773,53,40,93,
3555,764,61,44,105,
3556,785,61,48,109,
3557,841,62,57,119,
3558,793,43,49,92,
3559,836,66,49,115,
3560,841,53,56,109,
3561,779,65,44,109,
3562,829,66,47,113,
3563,820,51,45,96,
3564,848,61,47,108,
3565,783,61,54,115,
3566,772,59,40,99,
3567,850,51,43,94,
3568,823,67,47,114,
3569,833,57,60,117,
3570,827,68,42,110,
3571,839,70,51,121,
3572,806,61,41,102,
3573,807,56,52,108,
3574,835,62,47,109,
3575,839,71,47,118,
3576,814,69,37,106,
3577,840,68,51,119,
3578,828,56,53,109,
3579,849,66,54,120,
3580,789,49,47,96,
3581,812,69,35,104,
3582,777,51,33,84,
3583,821,48,44,92,
3584,859,48,56,104,
3585,775,52,37,89,
3586,879,60,51,111,
3587,788,37,37,74,
3588,831,60,48,108,
3589,858,64,47,111,
3590,820,69,45,114,
3591,889,63,48,111,
3592,857,42,45,87,
3593,803,54,52,106,
3594,777,67,34,101,
3595,862,63,58,121,
3596,819,66,51,117,
3597,796,75,40,115,
3598,791,57,54,111,
3599,784,49,41,90,
3600,832,52,42,94,
3601,870,69,62,131,
3602,875,67,32,99,
3603,780,68,55,123,
3604,759,58,46,104,
3605,890,72,53,125,
3606,781,51,49,100,
3607,792,61,40,101,
3608,819,64,44,108,
3609,834,57,42,99,
3610,833,69,49,118,
3611,821,60,44,104,
3612,807,60,41,101,
3613,824,49,53,102,
3614,847,65,58,123,
3615,805,63,52,115,
3616,849,71,44,115,
3617,840,55,50,105,
3618,853,60,46,106,
3619,840,62,47,109,
3620,830,48,42,90,
3621,831,68,38,106,
3622,798,49,47,96,
3623,844,57,39,96,
3624,816,58,50,108,
3625,855,73,39,112,
3626,833,65,38,103,
3627,825,62,51,113,
3628,855,84,43,127,
3629,811,54,36,90,
3630,840,53,42,95,
3631,829,40,49,89,
3632,832,52,53,105,
3633,837,69,51,120,
3634,814,63,41,104,
3635,845,73,41,114,
3636,815,64,56,120,
3637,832,47,52,99,
3638,810,64,57,121,
3639,854,49,44,93,
3640,809,49,48,97,
3641,761,58,44,102,
3642,766,58,44,102,
3643,789,53,31,84,
3644,834,66,46,112,
3645,853,69,51,120,
3646,830,61,44,105,
3647,805,46,54,100,
3648,839,55,45,100,
3649,851,59,45,104,
3650,781,64,48,112,
3651,856,72,62,134,
3652,794,61,60,121,
3653,788,59,32,91,
3654,858,66,56,122,
3655,838,58,53,111,
3656,796,62,47,109,
3657,803,70,40,110,
3658,852,67,53,120,
3659,840,66,40,106,
3660,853,77,38,115,
3661,833,48,51,99,
3662,855,63,57,120,
3663,832,61,59,120,
3664,847,53,52,105,
3665,834,65,45,110,
3666,795,46,43,89,
3667,815,58,46,104,
3668,846,48,52,100,
3669,864,68,45,113,
3670,723,50,45,95,
3671,814,57,46,103,
3672,859,63,47,110,
3673,806,63,42,105,
3674,864,51,52,103,
3675,868,68,49,117,
3676,814,57,48,105,
3677,826,67,34,101,
3678,800,57,53,110,
3679,840,72,42,114,
3680,870,52,60,112,
3681,853,64,56,120,
3682,840,54,44,98,
3683,759,49,48,97,
3684,867,70,48,118,
3685,807,67,50,117,
3686,820,55,52,107,
3687,815,50,49,99,
3688,800,58,38,96,
3689,809,52,43,95,
3690,851,56,50,106,
3691,825,65,62,127,
3692,815,61,57,118,
3693,860,60,51,111,
3694,812,62,50,112,
3695,828,64,45,109,
3696,778,59,27,86,
3697,844,54,34,88,
3698,836,67,33,100,
3699,794,43,42,85,
3700,821,58,44,102,
3701,845,57,45,102,
3702,842,53,54,107,
3703,795,50,48,98,
3704,769,53,38,91,
3705,794,71,52,123,
3706,840,66,51,117,
3707,813,64,50,114,
3708,842,57,44,101,
3709,840,58,54,112,
3710,833,63,51,114,
3711,794,53,50,103,
3712,794,55,43,98,
3713,827,56,48,104,
3714,777,73,40,113,
3715,851,46,41,87,
3716,826,56,38,94,
3717,788,55,53,108,
3718,793,52,47,99,
3719,844,63,36,99,
3720,873,71,50,121,
3721,792,65,51,116,
3722,817,57,35,92,
3723,780,47,55,102,
3724,837,82,51,133,
3725,871,60,66,126,
3726,789,46,46,92,
3727,891,60,52,112,
3728,793,60,48,108,
3729,863,62,48,110,
3730,838,60,47,107,
3731,803,54,49,103,
3732,826,50,46,96,
3733,815,61,53,114,
3734,842,79,47,126,
3735,843,57,51,108,
3736,862,80,47,127,
3737,836,63,41,104,
3738,821,53,51,104,
3739,796,50,49,99,
3740,861,48,46,94,
3741,844,44,41,85,
3742,814,66,49,115,
3743,812,55,52,107,
3744,813,47,48,95,
3745,847,52,45,97,
3746,810,66,36,102,
3747,855,76,57,133,
3748,840,58,45,103,
3749,885,72,52,124,
3750,833,64,52,116,
3751,854,53,51,104,
3752,779,54,56,110,
3753,862,51,45,96,
3754,872,68,36,104,
3755,852,63,39,102,
3756,848,58,43,101,
3757,817,62,37,99,
3758,803,59,45,104,
3759,776,49,56,105,
3760,779,56,47,103,
3761,830,59,58,117,
3762,867,68,58,126,
3763,838,51,55,106,
3764,840,67,50,117,
3765,811,66,42,108,
3766,869,73,59,132,
3767,811,59,40,99,
3768,842,66,39,105,
3769,829,70,63,133,
3770,842,56,46,102,
3771,825,52,42,94,
3772,809,37,43,80,
3773,787,63,41,104,
3774,844,60,51,111,
3775,804,55,55,110,
3776,822,73,47,120,
3777,831,71,50,121,
3778,826,62,46,108,
3779,821,66,48,114,
3780,878,70,55,125,
3781,818,59,53,112,
3782,753,43,41,84,
3783,858,68,54,122,
3784,829,45,41,86,
3785,828,60,47,107,
3786,810,50,43,93,
3787,808,68,48,116,
3788,876,66,61,127,
3789,888,59,50,109,
3790,849,50,43,93,
3791,830,49,56,105,
3792,802,63,40,103,
3793,852,58,47,105,
3794,806,44,35,79,
3795,809,66,42,108,
3796,834,65,55,120,
3797,808,43,36,79,
3798,807,53,50,103,
3799,844,55,56,111,
3800,804,66,41,107,
3801,826,59,54,113,
3802,800,61,45,106,
3803,822,49,38,87,
3804,829,57,56,113,
3805,783,63,52,115,
3806,846,49,53,102,
3807,816,65,53,118,
3808,863,53,53,106,
3809,786,60,39,99,
3810,842,63,59,122,
3811,819,43,47,90,
3812,805,57,39,96,
3813,781,52,43,95,
3814,830,74,41,115,
3815,818,52,53,105,
3816,810,63,53,116,
3817,784,45,53,98,
3818,840,65,50,115,
3819,851,70,51,121,
3820,811,55,41,96,
3821,866,48,43,91,
3822,835,71,50,121,
3823,809,42,35,77,
3824,791,53,47,100,
3825,828,62,42,104,
3826,789,59,61,120,
3827,799,66,47,113,
3828,847,55,46,101,
3829,811,60,50,110,
3830,770,49,51,100,
3831,849,68,48,116,
3832,793,66,45,111,
3833,885,60,57,117,
3834,818,48,40,88,
3835,857,70,67,137,
3836,803,76,37,113,
3837,824,67,53,120,
3838,786,55,47,102,
3839,813,63,53,116,
3840,847,64,49,113,
3841,809,59,40,99,
3842,790,68,48,116,
3843,829,58,52,110,
3844,844,66,45,111,
3845,792,63,49,112,
3846,801,61,35,96,
3847,841,69,48,117,
3848,768,48,35,83,
3849,834,51,56,107,
3850,830,54,42,96,
3851,812,60,44,104,
3852,851,67,53,120,
3853,847,61,46,107,
3854,791,64,40,104,
3855,842,59,45,104,
3856,797,59,54,113,
3857,797,42,45,87,
3858,828,67,37,104,
3859,813,54,48,102,
3860,863,59,54,113,
3861,801,68,43,111,
3862,866,60,47,107,
3863,826,58,49,107,
3864,835,55,53,108,
3865,849,57,44,101,
3866,799,57,58,115,
3867,782,64,46,110,
3868,834,59,53,112,
3869,798,59,48,107,
3870,851,74,51,125,
3871,847,62,41,103,
3872,867,66,50,116,
3873,825,50,52,102,
3874,843,71,47,118,
3875,842,65,51,116,
3876,826,48,42,90,
3877,864,73,43,116,
3878,823,60,43,103,
3879,805,40,46,86,
3880,861,69,47,116,
3881,873,59,46,105,
3882,815,61,57,118,
3883,823,51,31,82,
3884,786,59,49,108,
3885,806,59,50,109,
3886,843,57,40,97,
3887,759,54,39,93,
3888,848,65,38,103,
3889,865,61,51,112,
3890,841,61,43,104,
3891,839,54,38,92,
3892,907,69,54,123,
3893,828,61,44,105,
3894,804,66,51,117,
3895,842,62,52,114,
3896,807,53,40,93,
3897,848,61,50,111,
3898,811,65,39,104,
3899,801,56,56,112,
3900,774,47,52,99,
3901,851,61,45,106,
3902,840,66,47,113,
3903,821,68,35,103,
3904,834,62,49,111,
3905,874,62,71,133,
3906,768,58,37,95,
3907,849,63,53,116,
3908,798,59,44,103,
3909,861,57,58,115,
3910,828,60,51,111,
3911,845,63,51,114,
3912,810,60,39,99,
3913,825,63,40,103,
3914,839,68,43,111,
3915,784,58,36,94,
3916,819,68,55,123,
3917,847,57,51,108,
3918,865,59,59,118,
3919,816,66,51,117,
3920,896,61,46,107,
3921,821,61,50,111,
3922,785,59,46,105,
3923,832,65,54,119,
3924,789,51,41,92,
3925,837,69,58,127,
3926,875,66,56,122,
3927,851,78,49,127,
3928,819,66,57,123,
3929,844,63,50,113,
3930,821,48,43,91,
3931,790,52,49,101,
3932,790,59,48,107,
3933,886,64,44,108,
3934,832,49,47,96,
3935,827,68,48,116,
3936,822,73,38,111,
3937,841,65,46,111,
3938,814,72,48,120,
3939,868,88,50,138,
3940,831,55,32,87,
3941,834,65,61,126,
3942,811,60,40,100,
3943,807,64,48,112,
3944,816,63,48,111,
3945,818,49,48,97,
3946,805,66,48,114,
3947,839,59,53,112,
3948,776,48,42,90,
3949,799,60,53,113,
3950,809,63,41,104,
3951,801,65,39,104,
3952,808,61,45,106,
3953,877,72,51,123,
3954,813,54,43,97,
3955,849,75,51,126,
3956,841,58,33,91,
3957,799,50,35,85,
3958,871,50,51,101,
3959,810,65,37,102,
3960,842,61,37,98,
3961,868,55,54,109,
3962,846,66,59,125,
3963,830,57,47,104,
3964,860,63,52,115,
3965,771,54,50,104,
3966,836,52,49,101,
3967,793,68,44,112,
3968,818,52,47,99,
3969,833,60,49,109,
3970,828,64,50,114,
3971,826,70,42,112,
3972,866,55,52,107,
3973,780,53,39,92,
3974,829,57,49,106,
3975,780,50,48,98,
3976,827,70,42,112,
3977,836,50,57,107,
3978,820,59,41,100,
3979,777,58,39,97,
3980,834,60,43,103,
3981,842,62,45,107,
3982,749,56,55,111,
3983,857,71,42,113,
3984,825,85,53,138,
3985,751,47,39,86,
3986,857,69,39,108,
3987,829,52,56,108,
3988,848,81,43,124,
3989,810,65,43,108,
3990,830,76,44,120,
3991,832,76,44,120,
3992,808,59,48,107,
3993,808,49,45,94,
3994,819,61,48,109,
3995,863,69,47,116,
3996,845,60,50,110,
3997,820,68,41,109,
3998,807,54,46,100,
3999,816,65,57,122,
4000,751,57,28,85,
4001,847,64,45,109,
4002,828,66,47,113,
4003,844,62,39,101,
4004,828,71,36,107,
4005,835,53,52,105,
4006,858,55,51,106,
4007,789,53,45,98,
4008,830,58,50,108,
4009,799,63,50,113,
4010,825,69,51,120,
4011,813,55,45,100,
4012,846,61,48,109,
4013,758,50,35,85,
4014,810,64,51,115,
4015,885,59,64,123,
4016,822,72,52,124,
4017,796,58,42,100,
4018,878,56,47,103,
4019,856,62,41,103,
4020,846,52,55,107,
4021,827,51,54,105,
4022,825,54,45,99,
4023,820,62,42,104,
4024,807,59,45,104,
4025,788,58,41,99,
4026,830,64,56,120,
4027,771,58,37,95,
4028,825,66,43,109,
4029,809,57,43,100,
4030,814,49,55,104,
4031,810,60,62,122,
4032,841,62,42,104,
4033,778,53,40,93,
4034,816,65,36,101,
4035,811,53,48,101,
4036,854,73,54,127,
4037,828,75,56,131,
4038,840,60,41,101,
4039,814,42,51,93,
4040,820,59,45,104,
4041,839,57,54,111,
4042,767,53,46,99,
4043,815,54,52,106,
4044,796,65,48,113,
4045,830,60,46,106,
4046,826,49,47,96,
4047,842,67,57,124,
4048,832,66,52,118,
4049,871,71,48,119,
4050,837,56,40,96,
4051,859,60,66,126,
4052,846,56,48,104,
4053,799,53,50,103,
4054,791,67,32,99,
4055,795,63,60,123,
4056,820,53,47,100,
4057,858,69,53,122,
4058,810,52,58,110,
4059,788,57,42,99,
4060,853,45,48,93,
4061,875,59,52,111,
4062,807,44,48,92,
4063,866,48,49,97,
4064,866,54,58,112,
4065,845,56,57,113,
4066,824,52,43,95,
4067,830,58,44,102,
4068,844,61,50,111,
4069,880,49,49,98,
4070,802,62,38,100,
4071,851,53,51,104,
4072,828,51,51,102,
4073,813,53,55,108,
4074,820,64,51,115,
4075,827,64,36,100,
4076,833,58,46,104,
4077,865,60,45,105,
4078,875,70,55,125,
4079,830,56,52,108,
4080,842,71,46,117,
4081,822,68,49,117,
4082,793,68,47,115,
4083,833,55,48,103,
4084,821,58,54,112,
4085,762,70,44,114,
4086,832,53,43,96,
4087,851,56,49,105,
4088,792,63,33,96,
4089,822,57,47,104,
4090,771,41,54,95,
4091,840,61,49,110,
4092,866,65,53,118,
4093,832,64,50,114,
4094,836,64,43,107,
4095,803,58,51,109,
4096,772,65,52,117,
4097,842,63,40,103,
4098,805,63,35,98,
4099,824,62,46,108,
4100,825,54,53,107,
4101,793,52,52,104,
4102,854,54,54,108,
4103,846,66,43,109,
4104,804,52,45,97,
4105,879,50,54,104,
4106,831,59,54,113,
4107,773,52,52,104,
4108,794,57,46,103,
4109,858,62,56,118,
4110,816,65,64,129,
4111,822,72,56,128,
4112,806,61,43,104,
4113,859,58,49,107,
4114,833,66,42,108,
4115,837,55,53,108,
4116,830,57,47,104,
4117,832,55,48,103,
4118,828,70,48,118,
4119,827,56,47,103,
4120,916,65,53,118,
4121,803,67,38,105,
4122,825,63,43,106,
4123,777,64,52,116,
4124,783,47,39,86,
4125,813,55,64,119,
4126,797,61,41,102,
4127,824,61,39,100,
4128,854,64,56,120,
4129,795,73,39,112,
4130,811,51,44,95,
4131,832,52,57,109,
4132,802,63,39,102,
4133,828,68,45,113,
4134,812,59,51,110,
4135,811,48,43,91,
4136,813,34,58,92,
4137,851,56,48,104,
4138,806,45,40,85,
4139,858,68,54,122,
4140,861,67,59,126,
4141,783,72,44,116,
4142,850,69,38,107,
4143,775,68,43,111,
4144,762,56,43,99,
4145,841,57,55,112,
4146,833,71,45,116,
4147,817,61,44,105,
4148,842,73,52,125,
4149,832,74,56,130,
4150,843,63,57,120,
4151,864,67,37,104,
4152,819,59,37,96,
4153,807,69,52,121,
4154,828,65,42,107,
4155,838,65,46,111,
4156,860,59,43,102,
4157,818,59,55,114,
4158,814,53,47,100,
4159,796,52,42,94,
4160,851,62,57,119,
4161,808,60,41,101,
4162,840,60,41,101,
4163,845,66,53,119,
4164,791,56,47,103,
4165,837,73,47,120,
4166,856,57,62,119,
4167,777,49,47,96,
4168,836,72,40,112,
4169,842,55,51,106,
4170,849,65,49,114,
4171,832,54,53,107,
4172,823,51,57,108,
4173,848,66,41,107,
4174,823,54,40,94,
4175,778,59,41,100,
4176,822,59,48,107,
4177,799,56,39,95,
4178,766,60,40,100,
4179,838,72,46,118,
4180,781,54,42,96,
4181,821,53,50,103,
4182,761,58,52,110,
4183,892,56,52,108,
4184,817,55,31,86,
4185,791,64,43,107,
4186,838,75,53,128,
4187,831,64,44,108,
4188,823,61,51,112,
4189,818,59,45,104,
4190,894,66,49,115,
4191,813,62,36,98,
4192,854,55,49,104,
4193,779,49,55,104,
4194,791,52,45,97,
4195,790,58,42,100,
4196,824,63,45,108,
4197,847,70,43,113,
4198,799,59,44,103,
4199,812,58,39,97,
4200,780,59,27,86,
4201,821,52,50,102,
4202,871,66,40,106,
4203,793,63,39,102,
4204,782,62,44,106,
4205,829,62,50,112,
4206,785,73,48,121,
4207,842,61,45,106,
4208,864,67,36,103,
4209,822,59,55,114,
4210,900,62,55,117,
4211,812,65,56,121,
4212,794,46,57,103,
4213,794,44,52,96,
4214,835,61,55,116,
4215,877,62,40,102,
4216,822,60,43,103,
4217,783,50,46,96,
4218,794,59,39,98,
4219,812,65,50,115,
4220,821,61,47,108,
4221,794,65,49,114,
4222,764,52,42,94,
4223,777,53,47,100,
4224,821,67,39,106,
4225,847,57,59,116,
4226,850,76,31,107,
4227,844,67,36,103,
4228,842,63,38,101,
4229,802,46,42,88,
4230,825,61,51,112,
4231,794,67,45,112,
4232,888,53,51,104,
4233,786,53,54,107,
4234,884,79,48,127,
4235,874,52,50,102,
4236,781,58,40,98,
4237,825,72,52,124,
4238,776,55,53,108,
4239,837,62,42,104,
4240,828,49,42,91,
4241,809,61,58,119,
4242,800,71,40,111,
4243,813,54,40,94,
4244,821,60,31,91,
4245,888,62,69,131,
4246,761,60,41,101,
4247,838,61,54,115,
4248,843,55,46,101,
4249,837,67,53,120,
4250,841,71,54,125,
4251,868,52,54,106,
4252,801,57,42,99,
4253,810,53,45,98,
4254,840,64,50,114,
4255,863,54,56,110,
4256,815,69,47,116,
4257,824,50,42,92,
4258,826,60,41,101,
4259,817,54,47,101,
4260,834,49,57,106,
4261,792,53,37,90,
4262,809,51,47,98,
4263,786,57,43,100,
4264,817,70,26,96,
4265,795,68,42,110,
4266,859,58,40,98,
4267,867,54,49,103,
4268,833,71,41,112,
4269,825,56,46,102,
4270,794,60,45,105,
4271,798,56,39,95,
4272,847,49,48,97,
4273,868,62,39,101,
4274,841,64,48,112,
4275,898,87,46,133,
4276,804,50,33,83,
4277,771,70,43,113,
4278,784,63,50,113,
4279,878,62,57,119,
4280,825,60,42,102,
4281,804,56,44,100,
4282,816,50,51,101,
4283,786,52,39,91,
4284,782,48,47,95,
4285,842,57,44,101,
4286,793,54,61,115,
4287,807,59,55,114,
4288,834,50,43,93,
4289,871,66,50,116,
4290,879,63,54,117,
4291,791,60,51,111,
4292,806,58,53,111,
4293,791,51,47,98,
4294,835,50,46,96,
4295,829,71,45,116,
4296,792,53,43,96,
4297,793,54,33,87,
4298,839,57,40,97,
4299,783,62,47,109,
4300,842,61,50,111,
4301,849,63,44,107,
4302,800,53,53,106,
4303,885,57,56,113,
4304,883,63,49,112,
4305,883,58,54,112,
4306,881,71,53,124,
4307,882,80,41,121,
4308,885,67,60,127,
4309,780,53,35,88,
4310,864,62,40,102,
4311,846,65,50,115,
4312,814,60,49,109,
4313,847,90,35,125,
4314,846,82,38,120,
4315,859,69,48,117,
4316,787,66,40,106,
4317,858,75,50,125,
4318,798,52,40,92,
4319,787,56,58,114,
4320,852,57,46,103,
4321,835,62,43,105,
4322,778,70,51,121,
4323,810,49,45,94,
4324,816,52,46,98,
4325,787,55,58,113,
4326,808,69,38,107,
4327,826,56,38,94,
4328,858,56,54,110,
4329,850,64,45,109,
4330,848,48,53,101,
4331,867,62,56,118,
4332,792,49,54,103,
4333,814,63,43,106,
4334,818,54,43,97,
4335,814,66,49,115,
4336,806,63,46,109,
4337,869,60,58,118,
4338,804,58,48,106,
4339,790,60,37,97,
4340,847,60,42,102,
4341,786,62,38,100,
4342,782,49,55,104,
4343,782,35,45,80,
4344,804,55,55,110,
4345,834,60,55,115,
4346,791,60,48,108,
4347,854,53,43,96,
4348,831,72,50,122,
4349,816,62,46,108,
4350,842,51,50,101,
4351,808,61,45,106,
4352,827,62,45,107,
4353,812,66,57,123,
4354,877,63,51,114,
4355,848,66,56,122,
4356,865,70,49,119,
4357,811,52,34,86,
4358,841,58,56,114,
4359,857,58,54,112,
4360,827,70,57,127,
4361,844,70,45,115,
4362,842,62,53,115,
4363,823,66,42,108,
4364,855,71,55,126,
4365,778,59,50,109,
4366,799,50,51,101,
4367,824,57,45,102,
4368,798,53,46,99,
4369,855,53,54,107,
4370,905,67,64,131,
4371,810,49,49,98,
4372,800,70,60,130,
4373,883,62,42,104,
4374,855,63,59,122,
4375,823,45,50,95,
4376,817,60,52,112,
4377,871,59,54,113,
4378,829,59,47,106,
4379,839,64,37,101,
4380,790,56,41,97,
4381,820,65,57,122,
4382,811,64,43,107,
4383,808,60,39,99,
4384,851,62,45,107,
4385,853,61,53,114,
4386,846,63,56,119,
4387,867,56,37,93,
4388,832,63,37,100,
4389,828,70,45,115,
4390,847,75,38,113,
4391,818,62,54,116,
4392,828,66,41,107,
4393,806,61,58,119,
4394,891,60,45,105,
4395,881,70,41,111,
4396,800,55,37,92,
4397,810,61,47,108,
4398,834,66,41,107,
4399,849,61,40,101,
4400,799,57,47,104,
4401,842,62,59,121,
4402,893,58,52,110,
4403,864,65,48,113,
4404,852,66,53,119,
4405,796,53,42,95,
4406,840,56,51,107,
4407,813,56,42,98,
4408,825,61,46,107,
4409,823,62,52,114,
4410,827,55,46,101,
4411,833,59,51,110,
4412,843,57,47,104,
4413,868,64,39,103,
4414,832,55,39,94,
4415,858,66,52,118,
4416,891,56,43,99,
4417,804,56,40,96,
4418,886,64,44,108,
4419,851,62,50,112,
4420,814,61,59,120,
4421,851,56,54,110,
4422,828,60,46,106,
4423,806,62,46,108,
4424,749,59,44,103,
4425,826,64,49,113,
4426,809,56,44,100,
4427,801,55,31,86,
4428,797,62,38,100,
4429,823,58,47,105,
4430,834,65,60,125,
4431,860,63,48,111,
4432,832,60,42,102,
4433,797,63,40,103,
4434,817,56,43,99,
4435,782,55,46,101,
4436,784,53,49,102,
4437,816,62,38,100,
4438,828,57,52,109,
4439,812,63,63,126,
4440,804,62,55,117,
4441,809,52,45,97,
4442,804,55,42,97,
4443,847,55,52,107,
4444,892,59,62,121,
4445,830,66,39,105,
4446,826,46,53,99,
4447,762,44,39,83,
4448,881,73,58,131,
4449,775,52,47,99,
4450,881,69,53,122,
4451,771,50,41,91,
4452,822,53,55,108,
4453,855,50,48,98,
4454,821,55,42,97,
4455,820,60,47,107,
4456,827,49,56,105,
4457,888,65,63,128,
4458,800,61,47,108,
4459,809,72,43,115,
4460,806,60,40,100,
4461,880,65,55,120,
4462,795,69,43,112,
4463,775,49,49,98,
4464,852,64,58,122,
4465,850,54,57,111,
4466,762,69,37,106,
4467,837,54,44,98,
4468,844,61,43,104,
4469,825,60,40,100,
4470,812,71,38,109,
4471,788,57,49,106,
4472,785,50,45,95,
4473,788,54,65,119,
4474,813,75,38,113,
4475,774,69,41,110,
4476,841,63,39,102,
4477,782,63,37,100,
4478,846,66,49,115,
4479,847,59,41,100,
4480,805,56,47,103,
4481,847,52,49,101,
4482,771,64,42,106,
4483,821,68,50,118,
4484,818,77,46,123,
4485,788,51,31,82,
4486,815,52,49,101,
4487,812,66,39,105,
4488,820,65,47,112,
4489,860,46,47,93,
4490,804,53,47,100,
4491,834,50,47,97,
4492,856,62,49,111,
4493,833,53,59,112,
4494,797,63,52,115,
4495,810,54,56,110,
4496,803,48,43,91,
4497,769,52,44,96,
4498,853,62,47,109,
4499,874,60,53,113,
4500,832,61,44,105,
4501,819,60,48,108,
4502,810,67,50,117,
4503,833,57,32,89,
4504,824,61,46,107,
4505,847,62,47,109,
4506,823,64,45,109,
4507,812,46,48,94,
4508,800,53,46,99,
4509,793,48,47,95,
4510,826,64,42,106,
4511,836,56,42,98,
4512,767,47,40,87,
4513,811,50,41,91,
4514,846,58,53,111,
4515,795,65,40,105,
4516,793,54,35,89,
4517,844,55,57,112,
4518,811,59,46,105,
4519,785,67,39,106,
4520,827,53,50,103,
4521,840,49,47,96,
4522,777,54,46,100,
4523,853,77,39,116,
4524,872,56,35,91,
4525,885,66,75,141,
4526,861,63,52,115,
4527,841,54,51,105,
4528,851,69,56,125,
4529,828,61,47,108,
4530,799,68,46,114,
4531,884,66,49,115,
4532,837,53,59,112,
4533,880,71,64,135,
4534,826,68,49,117,
4535,800,59,34,93,
4536,826,57,46,103,
4537,800,56,45,101,
4538,816,66,42,108,
4539,815,56,42,98,
4540,811,76,35,111,
4541,780,54,49,103,
4542,812,60,49,109,
4543,879,71,40,111,
4544,793,68,43,111,
4545,856,63,29,92,
4546,824,61,54,115,
4547,820,75,48,123,
4548,828,48,52,100,
4549,789,73,36,109,
4550,761,52,42,94,
4551,798,52,47,99,
4552,775,61,42,103,
4553,803,63,46,109,
4554,864,66,45,111,
4555,809,78,30,108,
4556,843,59,55,114,
4557,846,58,57,115,
4558,838,57,55,112,
4559,819,53,50,103,
4560,844,61,40,101,
4561,820,57,46,103,
4562,827,51,37,88,
4563,803,68,37,105,
4564,858,60,35,95,
4565,788,52,37,89,
4566,845,65,68,133,
4567,775,49,41,90,
4568,856,71,37,108,
4569,809,65,46,111,
4570,795,74,38,112,
4571,847,58,64,122,
4572,814,53,51,104,
4573,781,59,44,103,
4574,821,65,39,104,
4575,781,59,44,103,
4576,866,63,51,114,
4577,830,63,40,103,
4578,858,70,53,123,
4579,812,58,57,115,
4580,826,55,46,101,
4581,839,61,53,114,
4582,799,54,38,92,
4583,804,58,44,102,
4584,811,62,47,109,
4585,834,57,62,119,
4586,836,59,57,116,
4587,827,62,54,116,
4588,841,53,47,100,
4589,808,57,45,102,
4590,842,52,44,96,
4591,768,61,42,103,
4592,854,60,39,99,
4593,848,57,45,102,
4594,775,57,40,97,
4595,838,63,36,99,
4596,810,61,43,104,
4597,843,71,44,115,
4598,872,62,50,112,
4599,848,54,44,98,
4600,834,60,45,105,
4601,831,47,38,85,
4602,792,60,43,103,
4603,845,64,58,122,
4604,816,57,47,104,
4605,824,67,44,111,
4606,843,65,48,113,
4607,808,62,60,122,
4608,827,56,54,110,
4609,818,56,51,107,
4610,784,58,45,103,
4611,877,66,51,117,
4612,874,77,48,125,
4613,819,46,55,101,
4614,828,53,45,98,
4615,795,58,50,108,
4616,787,58,41,99,
4617,817,60,52,112,
4618,789,65,42,107,
4619,788,60,50,110,
4620,796,51,41,92,
4621,829,63,52,115,
4622,766,58,52,110,
4623,791,51,50,101,
4624,817,62,38,100,
4625,777,51,49,100,
4626,816,46,53,99,
4627,825,70,45,115,
4628,840,58,38,96,
4629,828,71,46,117,
4630,794,46,48,94,
4631,801,48,43,91,
4632,861,53,51,104,
4633,834,59,59,118,
4634,764,34,45,79,
4635,838,60,45,105,
4636,785,62,43,105,
4637,859,70,47,117,
4638,791,65,45,110,
4639,821,46,52,98,
4640,764,67,42,109,
4641,803,68,42,110,
4642,762,56,50,106,
4643,873,53,58,111,
4644,790,49,45,94,
4645,824,63,36,99,
4646,785,58,42,100,
4647,823,67,47,114,
4648,848,62,37,99,
4649,822,64,51,115,
4650,847,69,49,118,
4651,816,59,54,113,
4652,809,68,36,104,
4653,833,70,59,129,
4654,846,74,52,126,
4655,775,48,42,90,
4656,836,64,52,116,
4657,793,63,48,111,
4658,813,53,51,104,
4659,844,60,39,99,
4660,853,61,54,115,
4661,806,67,37,104,
4662,801,55,50,105,
4663,851,60,53,113,
4664,856,58,36,94,
4665,830,60,42,102,
4666,779,57,41,98,
4667,842,66,39,105,
4668,894,67,45,112,
4669,801,54,44,98,
4670,814,80,45,125,
4671,891,65,61,126,
4672,837,47,39,86,
4673,821,50,39,89,
4674,826,55,39,94,
4675,833,60,63,123,
4676,803,64,45,109,
4677,899,71,47,118,
4678,830,56,39,95,
4679,825,52,56,108,
4680,746,38,48,86,
4681,842,60,54,114,
4682,799,71,46,117,
4683,839,64,48,112,
4684,852,55,47,102,
4685,827,62,38,100,
4686,811,60,42,102,
4687,816,59,49,108,
4688,826,45,43,88,
4689,762,58,38,96,
4690,837,66,44,110,
4691,834,60,60,120,
4692,854,59,42,101,
4693,792,56,44,100,
4694,763,55,56,111,
4695,803,53,38,91,
4696,818,66,49,115,
4697,819,57,55,112,
4698,827,79,34,113,
4699,749,56,49,105,
4700,821,45,49,94,
4701,849,73,44,117,
4702,794,53,46,99,
4703,770,41,53,94,
4704,816,66,47,113,
4705,825,52,59,111,
4706,823,69,37,106,
4707,802,60,38,98,
4708,820,55,49,104,
4709,775,58,45,103,
4710,859,58,45,103,
4711,832,63,43,106,
4712,818,64,48,112,
4713,830,74,50,124,
4714,790,59,53,112,
4715,783,43,47,90,
4716,827,62,42,104,
4717,805,54,48,102,
4718,802,58,48,106,
4719,810,75,51,126,
4720,796,57,46,103,
4721,808,52,40,92,
4722,820,52,57,109,
4723,807,50,47,97,
4724,896,65,47,112,
4725,825,68,47,115,
4726,862,59,60,119,
4727,797,60,54,114,
4728,841,51,44,95,
4729,811,53,37,90,
4730,802,54,34,88,
4731,834,68,64,132,
4732,791,58,48,106,
4733,855,53,55,108,
4734,793,55,53,108,
4735,817,68,38,106,
4736,829,65,47,112,
4737,812,72,47,119,
4738,878,54,49,103,
4739,862,66,55,121,
4740,843,69,51,120,
4741,787,56,52,108,
4742,818,61,47,108,
4743,770,59,47,106,
4744,830,62,46,108,
4745,839,56,40,96,
4746,848,58,52,110,
4747,840,46,48,94,
4748,784,68,43,111,
4749,845,54,38,92,
4750,824,63,45,108,
4751,823,65,47,112,
4752,799,69,36,105,
4753,863,62,51,113,
4754,781,61,51,112,
4755,856,70,39,109,
4756,857,51,56,107,
4757,822,60,44,104,
4758,872,72,61,133,
4759,833,59,38,97,
4760,820,61,35,96,
4761,848,66,45,111,
4762,823,52,37,89,
4763,834,67,47,114,
4764,787,54,43,97,
4765,832,45,37,82,
4766,784,59,50,109,
4767,799,69,45,114,
4768,814,52,54,106,
4769,860,58,48,106,
4770,806,58,42,100,
4771,857,68,49,117,
4772,854,62,45,107,
4773,810,58,47,105,
4774,863,65,51,116,
4775,751,63,41,104,
4776,807,69,44,113,
4777,791,59,38,97,
4778,831,73,30,103,
4779,781,55,41,96,
4780,816,53,47,100,
4781,808,45,49,94,
4782,811,66,46,112,
4783,875,74,47,121,
4784,843,69,48,117,
4785,885,64,53,117,
4786,857,84,53,137,
4787,858,59,52,111,
4788,878,53,54,107,
4789,855,63,48,111,
4790,798,53,58,111,
4791,806,69,48,117,
4792,827,54,42,96,
4793,878,68,49,117,
4794,848,60,41,101,
4795,820,56,43,99,
4796,882,70,70,140,
4797,800,64,37,101,
4798,815,65,48,113,
4799,753,47,43,90,
4800,834,53,57,110,
4801,827,49,56,105,
4802,822,61,43,104,
4803,821,62,59,121,
4804,835,56,57,113,
4805,807,44,44,88,
4806,825,53,35,88,
4807,836,67,48,115,
4808,847,65,48,113,
4809,843,61,54,115,
4810,874,65,55,120,
4811,805,60,58,118,
4812,859,56,44,100,
4813,836,52,53,105,
4814,835,58,58,116,
4815,824,58,46,104,
4816,807,56,54,110,
4817,833,61,43,104,
4818,832,64,38,102,
4819,838,50,59,109,
4820,805,58,41,99,
4821,785,57,45,102,
4822,819,54,40,94,
4823,825,59,47,106,
4824,814,54,43,97,
4825,872,52,36,88,
4826,824,56,60,116,
4827,819,53,50,103,
4828,852,78,51,129,
4829,799,62,41,103,
4830,819,51,38,89,
4831,810,63,43,106,
4832,786,52,45,97,
4833,809,72,54,126,
4834,856,62,49,111,
4835,803,64,37,101,
4836,805,59,36,95,
4837,840,66,43,109,
4838,828,49,44,93,
4839,843,73,55,128,
4840,848,62,49,111,
4841,851,57,38,95,
4842,822,64,50,114,
4843,834,57,50,107,
4844,805,69,36,105,
4845,795,56,47,103,
4846,837,76,41,117,
4847,809,57,39,96,
4848,829,59,37,96,
4849,776,52,45,97,
4850,865,65,52,117,
4851,822,54,53,107,
4852,864,47,46,93,
4853,847,61,51,112,
4854,823,50,39,89,
4855,815,49,51,100,
4856,824,63,51,114,
4857,839,68,52,120,
4858,790,62,45,107,
4859,876,68,46,114,
4860,819,52,42,94,
4861,854,68,50,118,
4862,800,51,51,102,
4863,801,46,54,100,
4864,836,56,48,104,
4865,828,71,41,112,
4866,835,55,43,98,
4867,811,63,48,111,
4868,871,65,59,124,
4869,854,67,51,118,
4870,819,62,37,99,
4871,875,60,51,111,
4872,810,75,40,115,
4873,811,60,49,109,
4874,776,59,33,92,
4875,812,51,45,96,
4876,782,52,40,92,
4877,795,74,56,130,
4878,853,75,42,117,
4879,815,61,43,104,
4880,838,63,54,117,
4881,823,54,40,94,
4882,873,80,48,128,
4883,813,60,50,110,
4884,839,58,43,101,
4885,807,55,54,109,
4886,849,52,55,107,
4887,819,52,41,93,
4888,788,48,52,100,
4889,860,83,50,133,
4890,781,60,35,95,
4891,857,75,46,121,
4892,806,57,42,99,
4893,823,65,41,106,
4894,875,66,46,112,
4895,817,63,55,118,
4896,778,64,45,109,
4897,841,60,45,105,
4898,848,64,36,100,
4899,783,59,27,86,
4900,845,58,55,113,
4901,859,60,43,103,
4902,894,80,61,141,
4903,829,62,56,118,
4904,836,54,47,101,
4905,785,61,56,117,
4906,806,57,52,109,
4907,842,60,46,106,
4908,778,59,39,98,
4909,850,53,57,110,
4910,811,71,47,118,
4911,779,55,45,100,
4912,860,68,55,123,
4913,832,46,58,104,
4914,837,61,56,117,
4915,871,58,48,106,
4916,829,68,49,117,
4917,847,57,44,101,
4918,847,67,39,106,
4919,864,64,46,110,
4920,784,60,52,112,
4921,852,60,49,109,
4922,805,56,39,95,
4923,811,57,45,102,
4924,780,42,57,99,
4925,849,55,32,87,
4926,848,66,54,120,
4927,828,62,44,106,
4928,832,68,43,111,
4929,810,57,51,108,
4930,820,57,45,102,
4931,840,44,41,85,
4932,849,66,50,116,
4933,833,49,47,96,
4934,781,54,36,90,
4935,861,58,49,107,
4936,830,59,48,107,
4937,801,59,37,96,
4938,826,54,32,86,
4939,811,62,47,109,
4940,846,58,42,100,
4941,757,61,44,105,
4942,805,59,45,104,
4943,778,73,47,120,
4944,834,60,50,110,
4945,825,67,48,115,
4946,779,56,40,96,
4947,762,63,41,104,
4948,914,63,57,120,
4949,836,65,49,114,
4950,841,61,55,116,
4951,795,55,50,105,
4952,795,46,58,104,
4953,810,73,51,124,
4954,859,59,52,111,
4955,768,54,27,81,
4956,841,70,52,122,
4957,835,64,52,116,
4958,867,75,45,120,
4959,772,45,44,89,
4960,882,81,47,128,
4961,839,58,48,106,
4962,817,65,42,107,
4963,868,58,46,104,
4964,841,56,61,117,
4965,832,65,58,123,
4966,821,59,46,105,
4967,868,48,53,101,
4968,877,63,47,110,
4969,795,61,47,108,
4970,820,64,40,104,
4971,820,68,52,120,
4972,788,52,52,104,
4973,854,52,46,98,
4974,880,74,57,131,
4975,855,62,59,121,
4976,815,50,43,93,
4977,800,51,55,106,
4978,842,64,54,118,
4979,858,70,53,123,
4980,857,70,47,117,
4981,849,54,49,103,
4982,874,67,57,124,
4983,827,49,42,91,
4984,828,62,37,99,
4985,817,57,48,105,
4986,832,84,47,131,
4987,841,62,53,115,
4988,851,59,44,103,
4989,836,60,42,102,
4990,820,59,50,109,
4991,795,55,50,105,
4992,830,68,47,115,
4993,800,70,41,111,
4994,882,66,47,113,
4995,829,57,57,114,
4996,819,72,51,123,
4997,789,57,46,103,
4998,808,69,46,115,
4999,865,59,40,99,
5000,843,65,50,115,
5001,835,65,55,120,
5002,834,73,34,107,
5003,767,45,43,88,
5004,824,40,55,95,
5005,800,67,45,112,
5006,871,80,50,130,
5007,782,62,52,114,
5008,839,55,51,106,
5009,812,53,52,105,
5010,826,56,45,101,
5011,791,52,37,89,
5012,868,64,45,109,
5013,858,67,45,112,
5014,805,61,52,113,
5015,824,55,42,97,
5016,801,62,31,93,
5017,800,47,43,90,
5018,893,50,69,119,
5019,788,58,42,100,
5020,805,59,42,101,
5021,850,71,60,131,
5022,788,70,45,115,
5023,817,73,40,113,
5024,873,76,49,125,
5025,793,64,43,107,
5026,812,51,43,94,
5027,801,49,46,95,
5028,843,68,37,105,
5029,827,62,47,109,
5030,815,52,46,98,
5031,830,60,44,104,
5032,884,77,53,130,
5033,850,68,45,113,
5034,810,44,43,87,
5035,790,62,53,115,
5036,789,48,48,96,
5037,820,64,51,115,
5038,847,61,50,111,
5039,779,59,64,123,
5040,816,63,49,112,
5041,784,54,58,112,
5042,830,66,42,108,
5043,858,74,45,119,
5044,830,60,53,113,
5045,781,60,37,97,
5046,856,62,53,115,
5047,834,61,47,108,
5048,834,64,44,108,
5049,832,42,45,87,
5050,822,42,51,93,
5051,869,62,48,110,
5052,797,70,47,117,
5053,856,65,53,118,
5054,810,58,45,103,
5055,787,47,41,88,
5056,780,55,37,92,
5057,784,62,46,108,
5058,804,62,38,100,
5059,786,64,48,112,
5060,816,61,36,97,
5061,836,56,56,112,
5062,851,54,43,97,
5063,880,59,52,111,
5064,830,65,40,105,
5065,853,65,52,117,
5066,875,65,48,113,
5067,834,68,54,122,
5068,828,54,46,100,
5069,861,83,39,122,
5070,823,60,48,108,
5071,830,67,35,102,
5072,761,54,39,93,
5073,818,60,45,105,
5074,795,55,43,98,
5075,859,62,60,122,
5076,794,55,52,107,
5077,854,42,44,86,
5078,796,58,45,103,
5079,832,61,58,119,
5080,837,53,51,104,
5081,832,67,45,112,
5082,873,70,47,117,
5083,826,51,59,110,
5084,837,65,69,134,
5085,822,68,45,113,
5086,853,55,46,101,
5087,823,53,45,98,
5088,838,62,46,108,
5089,817,61,44,105,
5090,791,59,41,100,
5091,849,63,45,108,
5092,862,60,55,115,
5093,866,76,41,117,
5094,816,57,58,115,
5095,874,77,55,132,
5096,814,55,54,109,
5097,821,60,50,110,
5098,846,70,43,113,
5099,845,57,57,114,
5100,788,46,51,97,
5101,795,52,45,97,
5102,807,57,46,103,
5103,825,65,54,119,
5104,792,63,44,107,
5105,786,63,42,105,
5106,816,59,44,103,
5107,830,60,34,94,
5108,794,59,42,101,
5109,797,58,46,104,
5110,798,63,40,103,
5111,844,64,45,109,
5112,913,51,45,96,
5113,846,47,46,93,
5114,824,57,52,109,
5115,813,60,41,101,
5116,826,78,52,130,
5117,783,46,36,82,
5118,826,61,57,118,
5119,831,59,50,109,
5120,811,56,49,105,
5121,807,59,32,91,
5122,814,58,55,113,
5123,809,57,44,101,
5124,787,66,39,105,
5125,832,52,38,90,
5126,768,60,39,99,
5127,841,65,50,115,
5128,825,58,46,104,
5129,827,63,43,106,
5130,846,47,52,99,
5131,799,61,51,112,
5132,845,55,36,91,
5133,786,51,47,98,
5134,802,48,52,100,
5135,839,53,39,92,
5136,853,63,39,102,
5137,885,52,52,104,
5138,825,61,55,116,
5139,852,68,61,129,
5140,845,62,42,104,
5141,831,55,49,104,
5142,814,55,57,112,
5143,823,58,51,109,
5144,828,66,53,119,
5145,820,61,47,108,
5146,858,52,52,104,
5147,818,55,50,105,
5148,872,72,50,122,
5149,812,56,43,99,
5150,814,56,50,106,
5151,811,60,44,104,
5152,829,65,36,101,
5153,770,55,44,99,
5154,857,64,45,109,
5155,818,62,38,100,
5156,787,44,48,92,
5157,791,52,42,94,
5158,823,61,45,106,
5159,873,66,47,113,
5160,765,58,44,102,
5161,812,76,48,124,
5162,824,78,44,122,
5163,814,67,48,115,
5164,849,61,59,120,
5165,833,52,52,104,
5166,814,56,42,98,
5167,791,46,61,107,
5168,834,58,34,92,
5169,773,52,40,92,
5170,823,63,48,111,
5171,807,49,52,101,
5172,776,52,45,97,
5173,896,54,55,109,
5174,834,67,43,110,
5175,792,60,42,102,
5176,838,48,59,107,
5177,806,55,48,103,
5178,806,49,46,95,
5179,850,69,40,109,
5180,848,73,53,126,
5181,809,56,46,102,
5182,800,49,54,103,
5183,818,55,47,102,
5184,813,50,48,98,
5185,815,60,44,104,
5186,852,62,48,110,
5187,807,60,43,103,
5188,817,56,51,107,
5189,855,57,45,102,
5190,798,66,47,113,
5191,847,58,50,108,
5192,836,69,44,113,
5193,804,69,40,109,
5194,869,54,44,98,
5195,808,59,36,95,
5196,844,61,43,104,
5197,837,55,37,92,
5198,819,66,54,120,
5199,774,58,35,93,
5200,805,62,38,100,
5201,823,52,47,99,
5202,842,57,47,104,
5203,815,62,44,106,
5204,819,66,38,104,
5205,820,47,57,104,
5206,855,54,37,91,
5207,772,69,52,121,
5208,853,58,39,97,
5209,845,64,62,126,
5210,826,65,54,119,
5211,817,70,42,112,
5212,824,57,44,101,
5213,828,57,52,109,
5214,872,64,52,116,
5215,828,56,56,112,
5216,815,64,38,102,
5217,852,51,55,106,
5218,835,66,56,122,
5219,833,55,48,103,
5220,749,58,48,106,
5221,815,56,39,95,
5222,842,63,46,109,
5223,812,33,44,77,
5224,832,54,65,119,
5225,813,70,51,121,
5226,779,55,40,95,
5227,805,48,48,96,
5228,858,53,46,99,
5229,794,56,44,100,
5230,811,54,40,94,
5231,879,63,52,115,
5232,847,62,37,99,
5233,871,77,51,128,
5234,847,57,47,104,
5235,851,60,59,119,
5236,808,40,39,79,
5237,843,63,55,118,
5238,845,66,50,116,
5239,832,60,48,108,
5240,828,52,49,101,
5241,810,70,46,116,
5242,770,64,63,127,
5243,834,64,50,114,
5244,803,59,45,104,
5245,775,54,43,97,
5246,837,52,53,105,
5247,805,60,37,97,
5248,828,63,55,118,
5249,779,56,47,103,
5250,851,56,45,101,
5251,822,67,43,110,
5252,842,66,40,106,
5253,857,54,46,100,
5254,814,57,38,95,
5255,839,65,44,109,
5256,800,53,40,93,
5257,834,61,46,107,
5258,824,59,44,103,
5259,832,53,68,121,
5260,858,69,46,115,
5261,880,51,48,99,
5262,814,51,36,87,
5263,832,60,56,116,
5264,869,62,47,109,
5265,834,69,60,129,
5266,841,65,42,107,
5267,801,54,42,96,
5268,849,49,40,89,
5269,818,49,46,95,
5270,791,65,50,115,
5271,816,50,46,96,
5272,833,59,46,105,
5273,832,46,46,92,
5274,871,67,52,119,
5275,853,67,57,124,
5276,834,62,44,106,
5277,840,69,40,109,
5278,779,61,46,107,
5279,824,62,46,108,
5280,815,61,49,110,
5281,814,50,36,86,
5282,841,52,47,99,
5283,834,57,44,101,
5284,817,51,50,101,
5285,821,59,46,105,
5286,784,68,43,111,
5287,855,62,43,105,
5288,845,61,42,103,
5289,791,60,45,105,
5290,857,56,50,106,
5291,808,52,47,99,
5292,884,56,45,101,
5293,769,61,57,118,
5294,790,38,52,90,
5295,831,49,56,105,
5296,800,47,46,93,
5297,851,64,57,121,
5298,846,60,48,108,
5299,813,65,41,106,
5300,777,48,48,96,
5301,805,60,42,102,
5302,836,54,44,98,
5303,798,74,51,125,
5304,788,48,38,86,
5305,812,43,48,91,
5306,842,63,44,107,
5307,863,66,55,121,
5308,845,67,57,124,
5309,828,56,55,111,
5310,884,52,57,109,
5311,796,54,41,95,
5312,791,56,36,92,
5313,775,51,41,92,
5314,774,59,44,103,
5315,844,59,40,99,
5316,806,64,41,105,
5317,790,66,45,111,
5318,821,56,47,103,
5319,798,63,48,111,
5320,829,58,46,104,
5321,770,59,42,101,
5322,790,63,59,122,
5323,827,55,43,98,
5324,874,63,44,107,
5325,799,55,53,108,
5326,804,67,49,116,
5327,799,72,43,115,
5328,783,59,41,100,
5329,872,78,37,115,
5330,822,60,48,108,
5331,830,59,43,102,
5332,879,59,60,119,
5333,786,70,47,117,
5334,824,48,54,102,
5335,812,59,44,103,
5336,790,58,39,97,
5337,781,52,43,95,
5338,814,63,49,112,
5339,820,72,36,108,
5340,823,60,44,104,
5341,848,60,44,104,
5342,846,62,38,100,
5343,797,51,51,102,
5344,860,66,50,116,
5345,820,61,57,118,
5346,814,64,46,110,
5347,782,68,38,106,
5348,842,65,45,110,
5349,817,64,56,120,
5350,823,57,52,109,
5351,788,50,49,99,
5352,799,49,41,90,
5353,867,68,48,116,
5354,865,59,56,115,
5355,824,66,50,116,
5356,860,67,42,109,
5357,845,54,47,101,
5358,791,59,43,102,
5359,790,45,55,100,
5360,816,59,43,102,
5361,853,70,66,136,
5362,851,56,58,114,
5363,793,62,50,112,
5364,819,54,57,111,
5365,809,49,43,92,
5366,779,57,45,102,
5367,856,66,58,124,
5368,772,54,40,94,
5369,836,65,50,115,
5370,835,66,40,106,
5371,855,55,55,110,
5372,839,52,58,110,
5373,852,60,56,116,
5374,841,51,48,99,
5375,864,52,60,112,
5376,830,50,35,85,
5377,863,56,44,100,
5378,820,50,50,100,
5379,847,45,45,90,
5380,843,55,38,93,
5381,845,52,43,95,
5382,834,66,54,120,
5383,792,59,38,97,
5384,796,47,40,87,
5385,798,53,48,101,
5386,796,58,37,95,
5387,859,61,52,113,
5388,810,54,49,103,
5389,801,60,52,112,
5390,813,58,45,103,
5391,852,66,51,117,
5392,826,71,62,133,
5393,816,64,40,104,
5394,787,58,50,108,
5395,834,66,50,116,
5396,803,68,41,109,
5397,810,53,46,99,
5398,858,73,48,121,
5399,837,77,46,123,
5400,844,66,44,110,
5401,793,66,42,108,
5402,878,72,49,121,
5403,818,47,46,93,
5404,793,60,43,103,
5405,823,60,47,107,
5406,865,49,56,105,
5407,821,54,43,97,
5408,890,54,61,115,
5409,832,74,55,129,
5410,811,62,40,102,
5411,801,53,56,109,
5412,812,61,54,115,
5413,859,68,60,128,
5414,819,59,42,101,
5415,836,66,44,110,
5416,807,47,47,94,
5417,804,59,43,102,
5418,859,60,45,105,
5419,834,60,55,115,
5420,815,73,40,113,
5421,821,49,49,98,
5422,807,50,46,96,
5423,863,70,59,129,
5424,835,64,48,112,
5425,850,60,44,104,
5426,860,59,36,95,
5427,848,71,52,123,
5428,813,44,40,84,
5429,796,57,49,106,
5430,851,59,48,107,
5431,833,55,56,111,
5432,869,65,52,117,
5433,855,69,53,122,
5434,845,54,43,97,
5435,778,75,54,129,
5436,836,55,60,115,
5437,821,58,49,107,
5438,817,54,54,108,
5439,818,61,40,101,
5440,822,68,53,121,
5441,852,73,53,126,
5442,872,72,56,128,
5443,829,60,43,103,
5444,765,46,41,87,
5445,841,61,40,101,
5446,819,67,39,106,
5447,828,54,46,100,
5448,799,57,51,108,
5449,860,57,40,97,
5450,804,53,44,97,
5451,782,51,47,98,
5452,828,67,56,123,
5453,805,55,50,105,
5454,837,68,44,112,
5455,819,62,41,103,
5456,839,58,43,101,
5457,856,44,44,88,
5458,813,60,49,109,
5459,792,63,44,107,
5460,883,70,59,129,
5461,864,55,44,99,
5462,846,70,48,118,
5463,768,45,43,88,
5464,886,67,45,112,
5465,877,69,49,118,
5466,843,58,49,107,
5467,789,63,28,91,
5468,800,73,46,119,
5469,865,54,43,97,
5470,849,69,52,121,
5471,836,57,36,93,
5472,800,59,45,104,
5473,792,53,44,97,
5474,844,51,58,109,
5475,888,62,64,126,
5476,823,72,47,119,
5477,768,63,41,104,
5478,810,58,44,102,
5479,860,61,59,120,
5480,869,61,49,110,
5481,897,67,57,124,
5482,824,66,47,113,
5483,769,64,48,112,
5484,832,64,45,109,
5485,763,55,54,109,
5486,829,60,52,112,
5487,837,68,53,121,
5488,881,60,53,113,
5489,785,51,46,97,
5490,774,50,30,80,
5491,747,58,37,95,
5492,772,54,53,107,
5493,774,58,36,94,
5494,793,62,46,108,
5495,810,46,50,96,
5496,823,67,51,118,
5497,826,60,52,112,
5498,838,52,62,114,
5499,800,59,60,119,
5500,872,76,45,121,
5501,821,60,42,102,
5502,806,71,43,114,
5503,802,64,52,116,
5504,837,60,50,110,
5505,837,70,50,120,
5506,797,60,46,106,
5507,868,56,47,103,
5508,813,59,46,105,
5509,807,50,45,95,
5510,860,45,46,91,
5511,822,62,43,105,
5512,820,53,53,106,
5513,809,62,41,103,
5514,809,76,35,111,
5515,805,52,40,92,
5516,786,65,44,109,
5517,803,76,56,132,
5518,821,72,46,118,
5519,847,65,53,118,
5520,821,65,45,110,
5521,723,58,40,98,
5522,840,74,50,124,
5523,831,57,45,102,
5524,818,52,61,113,
5525,851,66,56,122,
5526,853,58,51,109,
5527,820,56,41,97,
5528,788,56,34,90,
5529,850,52,51,103,
5530,839,64,38,102,
5531,811,50,44,94,
5532,812,63,46,109,
5533,732,56,46,102,
5534,769,60,44,104,
5535,835,61,61,122,
5536,763,55,39,94,
5537,770,49,42,91,
5538,901,63,59,122,
5539,819,69,50,119,
5540,820,66,35,101,
5541,847,59,59,118,
5542,840,62,49,111,
5543,820,51,49,100,
5544,852,71,42,113,
5545,785,58,54,112,
5546,813,62,51,113,
5547,823,65,36,101,
5548,776,48,43,91,
5549,810,59,51,110,
5550,857,52,53,105,
5551,847,56,41,97,
5552,891,73,51,124,
5553,802,65,48,113,
5554,826,72,46,118,
5555,873,64,43,107,
5556,835,49,42,91,
5557,844,51,49,100,
5558,785,50,43,93,
5559,811,52,48,100,
5560,814,67,44,111,
5561,753,60,43,103,
5562,907,59,57,116,
5563,821,64,47,111,
5564,813,65,49,114,
5565,817,57,42,99,
5566,846,66,45,111,
5567,841,59,56,115,
5568,817,66,46,112,
5569,809,65,58,123,
5570,775,55,48,103,
5571,800,56,45,101,
5572,842,72,48,120,
5573,853,77,48,125,
5574,828,61,55,116,
5575,830,53,36,89,
5576,817,62,50,112,
5577,827,56,34,90,
5578,801,65,51,116,
5579,771,44,40,84,
5580,786,54,49,103,
5581,839,53,54,107,
5582,789,60,47,107,
5583,873,60,40,100,
5584,868,64,58,122,
5585,801,70,48,118,
5586,838,55,58,113,
5587,857,59,40,99,
5588,802,48,47,95,
5589,828,63,43,106,
5590,804,69,41,110,
5591,782,50,44,94,
5592,849,65,53,118,
5593,803,57,38,95,
5594,820,47,54,101,
5595,791,55,47,102,
5596,906,54,51,105,
5597,843,58,59,117,
5598,852,52,46,98,
5599,866,62,50,112,
5600,871,54,43,97,
5601,843,53,43,96,
5602,784,56,41,97,
5603,843,52,53,105,
5604,841,65,50,115,
5605,823,58,45,103,
5606,778,46,39,85,
5607,841,74,47,121,
5608,853,57,46,103,
5609,810,54,43,97,
5610,839,68,42,110,
5611,881,68,51,119,
5612,872,60,56,116,
5613,830,53,55,108,
5614,822,60,49,109,
5615,834,58,49,107,
5616,790,67,41,108,
5617,852,83,57,140,
5618,875,63,44,107,
5619,789,69,46,115,
5620,791,58,37,95,
5621,880,68,52,120,
5622,823,70,50,120,
5623,856,66,51,117,
5624,802,54,43,97,
5625,855,71,58,129,
5626,821,56,50,106,
5627,817,65,51,116,
5628,882,57,48,105,
5629,777,58,46,104,
5630,847,55,46,101,
5631,830,54,43,97,
5632,822,57,47,104,
5633,790,53,47,100,
5634,824,63,35,98,
5635,854,48,55,103,
5636,849,55,44,99,
5637,864,62,52,114,
5638,829,75,47,122,
5639,857,65,44,109,
5640,825,54,45,99,
5641,746,54,37,91,
5642,794,57,50,107,
5643,829,65,52,117,
5644,813,43,48,91,
5645,805,78,36,114,
5646,808,45,54,99,
5647,879,64,49,113,
5648,824,54,49,103,
5649,799,55,46,101,
5650,810,57,46,103,
5651,811,55,46,101,
5652,817,55,49,104,
5653,802,61,38,99,
5654,832,48,38,86,
5655,844,55,42,97,
5656,800,58,60,118,
5657,824,51,53,104,
5658,819,65,57,122,
5659,840,57,47,104,
5660,782,48,44,92,
5661,846,72,51,123,
5662,833,61,47,108,
5663,824,57,60,117,
5664,787,60,34,94,
5665,821,62,47,109,
5666,824,68,43,111,
5667,796,49,60,109,
5668,836,55,37,92,
5669,853,60,47,107,
5670,783,49,45,94,
5671,790,58,44,102,
5672,841,58,54,112,
5673,815,63,46,109,
5674,845,62,41,103,
5675,847,78,56,134,
5676,792,64,54,118,
5677,809,59,40,99,
5678,881,63,50,113,
5679,809,67,47,114,
5680,896,71,56,127,
5681,829,60,36,96,
5682,819,59,53,112,
5683,805,59,47,106,
5684,802,55,54,109,
5685,872,57,49,106,
5686,813,61,37,98,
5687,843,58,43,101,
5688,793,59,47,106,
5689,857,62,54,116,
5690,820,50,40,90,
5691,862,58,44,102,
5692,750,66,32,98,
5693,847,54,64,118,
5694,820,59,50,109,
5695,819,65,34,99,
5696,800,60,43,103,
5697,785,45,39,84,
5698,869,69,57,126,
5699,855,42,45,87,
5700,830,61,48,109,
5701,865,65,57,122,
5702,813,57,47,104,
5703,801,55,45,100,
5704,803,74,39,113,
5705,850,72,47,119,
5706,794,56,36,92,
5707,870,54,61,115,
5708,820,62,45,107,
5709,837,62,41,103,
5710,822,55,43,98,
5711,836,66,54,120,
5712,827,62,46,108,
5713,809,64,42,106,
5714,789,75,30,105,
5715,889,58,52,110,
5716,784,59,46,105,
5717,844,60,54,114,
5718,804,47,39,86,
5719,813,54,46,100,
5720,835,58,54,112,
5721,873,60,52,112,
5722,825,47,54,101,
5723,815,38,44,82,
5724,819,51,53,104,
5725,814,52,42,94,
5726,800,53,45,98,
5727,813,45,57,102,
5728,803,54,45,99,
5729,777,59,40,99,
5730,807,68,49,117,
5731,813,61,41,102,
5732,831,68,57,125,
5733,822,69,44,113,
5734,823,55,44,99,
5735,795,53,42,95,
5736,760,68,38,106,
5737,805,53,65,118,
5738,840,65,52,117,
5739,795,60,49,109,
5740,799,66,58,124,
5741,843,64,41,105,
5742,796,61,53,114,
5743,804,61,32,93,
5744,812,49,55,104,
5745,851,63,65,128,
5746,850,56,47,103,
5747,804,62,51,113,
5748,827,64,46,110,
5749,826,66,46,112,
5750,803,65,51,116,
5751,817,62,45,107,
5752,827,56,45,101,
5753,820,56,48,104,
5754,799,64,42,106,
5755,784,54,51,105,
5756,876,54,48,102,
5757,837,61,55,116,
5758,829,50,40,90,
5759,826,67,68,135,
5760,826,61,51,112,
5761,803,52,42,94,
5762,797,71,43,114,
5763,822,53,47,100,
5764,805,67,44,111,
5765,850,63,54,117,
5766,803,62,43,105,
5767,815,68,45,113,
5768,810,57,48,105,
5769,815,45,49,94,
5770,759,51,44,95,
5771,869,57,49,106,
5772,846,63,50,113,
5773,789,64,48,112,
5774,839,62,56,118,
5775,789,63,43,106,
5776,748,62,41,103,
5777,826,59,56,115,
5778,866,52,54,106,
5779,810,59,42,101,
5780,802,51,53,104,
5781,768,50,46,96,
5782,800,60,50,110,
5783,786,53,42,95,
5784,775,58,45,103,
5785,818,52,56,108,
5786,793,58,43,101,
5787,835,76,53,129,
5788,764,56,44,100,
5789,778,58,58,116,
5790,819,66,48,114,
5791,810,55,52,107,
5792,844,52,52,104,
5793,820,47,48,95,
5794,826,61,52,113,
5795,822,54,59,113,
5796,844,61,45,106,
5797,826,68,43,111,
5798,890,67,65,132,
5799,805,60,37,97,
5800,848,65,43,108,
5801,784,61,41,102,
5802,788,57,39,96,
5803,877,61,64,125,
5804,779,53,39,92,
5805,829,63,44,107,
5806,822,53,46,99,
5807,814,62,41,103,
5808,839,62,51,113,
5809,835,66,48,114,
5810,822,50,36,86,
5811,836,62,47,109,
5812,833,68,49,117,
5813,803,59,52,111,
5814,817,62,33,95,
5815,822,70,60,130,
5816,843,53,59,112,
5817,812,57,49,106,
5818,792,73,43,116,
5819,844,66,45,111,
5820,796,56,40,96,
5821,789,50,35,85,
5822,813,61,45,106,
5823,791,53,52,105,
5824,844,67,38,105,
5825,805,68,48,116,
5826,791,55,44,99,
5827,819,47,47,94,
5828,824,75,43,118,
5829,769,59,42,101,
5830,827,75,46,121,
5831,868,71,35,106,
5832,877,71,47,118,
5833,875,73,43,116,
5834,787,69,36,105,
5835,833,58,54,112,
5836,796,62,45,107,
5837,827,64,50,114,
5838,829,45,47,92,
5839,871,71,57,128,
5840,828,75,48,123,
5841,854,69,54,123,
5842,785,69,40,109,
5843,825,37,52,89,
5844,855,65,48,113,
5845,855,64,54,118,
5846,771,52,39,91,
5847,810,57,51,108,
5848,809,54,41,95,
5849,814,72,38,110,
5850,833,62,52,114,
5851,797,54,44,98,
5852,819,65,48,113,
5853,855,64,40,104,
5854,807,50,37,87,
5855,810,60,35,95,
5856,872,66,50,116,
5857,823,58,53,111,
5858,830,56,57,113,
5859,823,67,59,126,
5860,801,57,41,98,
5861,837,65,54,119,
5862,750,35,50,85,
5863,866,68,38,106,
5864,807,70,35,105,
5865,854,49,40,89,
5866,795,63,37,100,
5867,832,51,35,86,
5868,788,64,56,120,
5869,857,66,50,116,
5870,883,65,52,117,
5871,814,54,44,98,
5872,853,64,42,106,
5873,766,63,45,108,
5874,785,55,37,92,
5875,812,56,41,97,
5876,809,61,48,109,
5877,821,62,40,102,
5878,844,62,60,122,
5879,838,58,60,118,
5880,817,64,52,116,
5881,819,55,48,103,
5882,805,51,48,99,
5883,835,61,38,99,
5884,782,59,42,101,
5885,785,72,43,115,
5886,747,47,48,95,
5887,833,64,53,117,
5888,796,58,47,105,
5889,750,60,47,107,
5890,792,50,40,90,
5891,799,43,52,95,
5892,813,57,50,107,
5893,804,63,40,103,
5894,857,77,48,125,
5895,848,64,41,105,
5896,875,60,54,114,
5897,816,66,39,105,
5898,819,62,47,109,
5899,845,66,46,112,
5900,802,60,43,103,
5901,828,49,42,91,
5902,789,53,46,99,
5903,851,66,38,104,
5904,843,63,43,106,
5905,764,69,45,114,
5906,810,66,35,101,
5907,827,58,43,101,
5908,837,67,48,115,
5909,794,54,40,94,
5910,824,57,49,106,
5911,845,64,56,120,
5912,765,49,36,85,
5913,867,70,46,116,
5914,840,57,42,99,
5915,796,55,49,104,
5916,835,62,45,107,
5917,764,56,53,109,
5918,800,52,41,93,
5919,792,51,54,105,
5920,845,63,50,113,
5921,789,46,36,82,
5922,812,55,48,103,
5923,843,80,45,125,
5924,803,57,41,98,
5925,836,58,55,113,
5926,774,52,32,84,
5927,829,58,50,108,
5928,818,64,64,128,
5929,843,58,54,112,
5930,846,65,52,117,
5931,860,62,76,138,
5932,799,57,52,109,
5933,806,61,38,99,
5934,827,60,64,124,
5935,814,71,43,114,
5936,837,63,35,98,
5937,863,74,53,127,
5938,869,60,51,111,
5939,801,63,59,122,
5940,824,66,47,113,
5941,776,51,52,103,
5942,842,69,53,122,
5943,809,52,39,91,
5944,808,60,51,111,
5945,816,67,40,107,
5946,754,66,44,110,
5947,807,45,53,98,
5948,785,66,42,108,
5949,817,60,45,105,
5950,763,58,39,97,
5951,842,64,52,116,
5952,824,57,63,120,
5953,820,63,46,109,
5954,873,61,50,111,
5955,795,61,55,116,
5956,851,59,54,113,
5957,826,62,45,107,
5958,824,72,47,119,
5959,797,49,53,102,
5960,811,56,49,105,
5961,855,58,50,108,
5962,866,69,44,113,
5963,786,60,40,100,
5964,839,54,45,99,
5965,856,82,44,126,
5966,798,59,35,94,
5967,820,60,46,106,
5968,794,60,49,109,
5969,822,65,37,102,
5970,836,61,61,122,
5971,834,61,42,103,
5972,818,49,43,92,
5973,771,60,37,97,
5974,821,48,64,112,
5975,799,56,45,101,
5976,807,64,48,112,
5977,829,67,55,122,
5978,837,62,56,118,
5979,845,74,45,119,
5980,826,60,61,121,
5981,780,60,45,105,
5982,777,55,45,100,
5983,808,43,48,91,
5984,828,66,54,120,
5985,829,54,46,100,
5986,766,51,53,104,
5987,809,50,40,90,
5988,820,53,46,99,
5989,825,68,42,110,
5990,824,46,43,89,
5991,864,74,48,122,
5992,768,62,38,100,
5993,831,56,41,97,
5994,867,64,60,124,
5995,786,53,40,93,
5996,833,73,43,116,
5997,774,56,44,100,
5998,814,49,35,84,
5999,827,56,44,100,
6000,795,58,42,100,
6001,849,61,37,98,
6002,836,64,38,102,
6003,811,63,53,116,
6004,867,72,63,135,
6005,809,49,50,99,
6006,779,59,40,99,
6007,862,63,54,117,
6008,840,66,46,112,
6009,785,71,46,117,
6010,797,45,50,95,
6011,830,57,48,105,
6012,840,71,46,117,
6013,848,69,45,114,
6014,840,57,51,108,
6015,823,52,62,114,
6016,875,55,46,101,
6017,827,65,41,106,
6018,871,52,49,101,
6019,816,62,57,119,
6020,811,52,53,105,
6021,795,74,43,117,
6022,865,57,48,105,
6023,823,68,47,115,
6024,822,68,50,118,
6025,842,57,50,107,
6026,827,50,56,106,
6027,846,53,54,107,
6028,826,58,56,114,
6029,891,58,56,114,
6030,856,75,53,128,
6031,814,62,49,111,
6032,819,65,36,101,
6033,799,52,43,95,
6034,795,66,38,104,
6035,793,69,40,109,
6036,802,49,42,91,
6037,873,63,50,113,
6038,812,67,49,116,
6039,818,52,44,96,
6040,829,55,43,98,
6041,812,54,44,98,
6042,859,84,45,129,
6043,850,66,47,113,
6044,878,56,45,101,
6045,828,72,59,131,
6046,788,51,39,90,
6047,801,51,38,89,
6048,769,42,46,88,
6049,793,54,47,101,
6050,798,61,52,113,
6051,807,68,61,129,
6052,796,46,50,96,
6053,819,60,48,108,
6054,846,65,47,112,
6055,804,78,59,137,
6056,830,71,43,114,
6057,868,64,46,110,
6058,836,58,39,97,
6059,856,47,45,92,
6060,776,53,30,83,
6061,836,51,56,107,
6062,886,66,55,121,
6063,839,58,52,110,
6064,763,52,37,89,
6065,773,63,37,100,
6066,793,53,47,100,
6067,879,71,56,127,
6068,845,65,43,108,
6069,829,58,47,105,
6070,789,65,44,109,
6071,803,51,47,98,
6072,899,65,57,122,
6073,838,58,54,112,
6074,751,55,40,95,
6075,891,61,57,118,
6076,774,55,46,101,
6077,826,64,50,114,
6078,900,62,52,114,
6079,819,64,57,121,
6080,812,45,52,97,
6081,823,64,31,95,
6082,822,58,45,103,
6083,853,65,53,118,
6084,812,71,33,104,
6085,813,68,47,115,
6086,791,59,64,123,
6087,826,53,44,97,
6088,810,80,36,116,
6089,803,56,51,107,
6090,813,69,49,118,
6091,822,67,36,103,
6092,817,57,58,115,
6093,844,52,43,95,
6094,807,64,54,118,
6095,866,65,60,125,
6096,839,51,46,97,
6097,805,55,45,100,
6098,841,59,49,108,
6099,798,56,41,97,
6100,786,67,55,122,
6101,827,66,52,118,
6102,813,64,54,118,
6103,782,56,42,98,
6104,827,64,38,102,
6105,861,66,53,119,
6106,813,50,30,80,
6107,828,57,39,96,
6108,822,53,40,93,
6109,861,72,58,130,
6110,787,47,37,84,
6111,820,63,39,102,
6112,841,64,54,118,
6113,857,63,59,122,
6114,802,60,38,98,
6115,848,56,49,105,
6116,849,69,46,115,
6117,833,62,46,108,
6118,779,71,33,104,
6119,786,68,40,108,
6120,850,67,38,105,
6121,811,73,47,120,
6122,822,70,44,114,
6123,806,64,46,110,
6124,804,44,43,87,
6125,795,53,48,101,
6126,810,53,50,103,
6127,825,70,53,123,
6128,806,60,47,107,
6129,813,61,48,109,
6130,811,48,47,95,
6131,774,54,51,105,
6132,872,53,38,91,
6133,890,74,49,123,
6134,834,72,47,119,
6135,835,71,55,126,
6136,729,62,43,105,
6137,809,73,51,124,
6138,854,64,50,114,
6139,797,56,59,115,
6140,838,53,61,114,
6141,822,49,54,103,
6142,874,65,50,115,
6143,835,53,44,97,
6144,766,69,47,116,
6145,867,53,46,99,
6146,808,52,38,90,
6147,802,66,41,107,
6148,811,61,51,112,
6149,851,52,54,106,
6150,832,58,36,94,
6151,791,66,39,105,
6152,833,70,55,125,
6153,913,61,43,104,
6154,813,61,42,103,
6155,823,58,50,108,
6156,841,58,50,108,
6157,822,65,43,108,
6158,764,61,38,99,
6159,850,52,57,109,
6160,809,68,50,118,
6161,828,59,45,104,
6162,792,55,57,112,
6163,869,65,39,104,
6164,876,50,51,101,
6165,845,61,42,103,
6166,793,72,44,116,
6167,801,64,44,108,
6168,802,69,42,111,
6169,822,62,51,113,
6170,851,54,53,107,
6171,846,71,47,118,
6172,824,65,58,123,
6173,797,72,42,114,
6174,743,63,49,112,
6175,814,54,41,95,
6176,786,60,45,105,
6177,800,58,54,112,
6178,756,52,47,99,
6179,778,57,43,100,
6180,816,59,42,101,
6181,832,63,40,103,
6182,869,75,44,119,
6183,808,52,52,104,
6184,875,62,53,115,
6185,840,54,47,101,
6186,822,60,46,106,
6187,814,55,60,115,
6188,810,57,31,88,
6189,869,71,48,119,
6190,819,63,28,91,
6191,822,53,49,102,
6192,832,55,45,100,
6193,855,70,52,122,
6194,808,50,51,101,
6195,778,65,46,111,
6196,832,60,46,106,
6197,841,56,42,98,
6198,849,67,51,118,
6199,811,56,33,89,
6200,822,60,49,109,
6201,843,56,60,116,
6202,841,71,45,116,
6203,809,63,50,113,
6204,802,48,46,94,
6205,803,58,54,112,
6206,808,49,47,96,
6207,828,59,47,106,
6208,802,57,42,99,
6209,803,57,49,106,
6210,837,73,51,124,
6211,788,42,44,86,
6212,849,63,45,108,
6213,776,39,44,83,
6214,806,58,48,106,
6215,823,48,48,96,
6216,801,51,50,101,
6217,824,61,34,95,
6218,864,63,47,110,
6219,830,61,53,114,
6220,796,56,45,101,
6221,854,55,63,118,
6222,813,57,48,105,
6223,862,63,53,116,
6224,787,62,49,111,
6225,833,64,65,129,
6226,802,47,42,89,
6227,806,67,54,121,
6228,851,57,45,102,
6229,811,65,52,117,
6230,833,61,56,117,
6231,813,66,33,99,
6232,765,51,43,94,
6233,812,56,62,118,
6234,832,73,42,115,
6235,820,51,52,103,
6236,791,53,48,101,
6237,849,64,44,108,
6238,788,41,55,96,
6239,837,67,52,119,
6240,868,67,44,111,
6241,821,58,41,99,
6242,840,75,45,120,
6243,750,63,34,97,
6244,870,76,50,126,
6245,806,59,47,106,
6246,839,54,42,96,
6247,845,59,46,105,
6248,806,52,45,97,
6249,825,52,53,105,
6250,863,60,49,109,
6251,842,61,53,114,
6252,822,62,49,111,
6253,785,66,50,116,
6254,813,60,42,102,
6255,810,57,54,111,
6256,800,63,43,106,
6257,809,58,52,110,
6258,810,61,43,104,
6259,831,58,50,108,
6260,832,65,37,102,
6261,845,51,40,91,
6262,824,58,50,108,
6263,879,61,62,123,
6264,814,66,46,112,
6265,827,63,40,103,
6266,797,87,38,125,
6267,814,61,38,99,
6268,794,57,39,96,
6269,782,66,49,115,
6270,803,50,66,116,
6271,856,66,45,111,
6272,777,58,54,112,
6273,804,55,60,115,
6274,783,56,43,99,
6275,844,46,46,92,
6276,819,49,42,91,
6277,829,55,45,100,
6278,820,73,31,104,
6279,806,58,53,111,
6280,864,70,57,127,
6281,871,63,37,100,
6282,750,68,34,102,
6283,783,75,55,130,
6284,820,69,48,117,
6285,817,65,47,112,
6286,806,55,50,105,
6287,762,57,44,101,
6288,856,48,44,92,
6289,803,77,30,107,
6290,787,57,34,91,
6291,837,54,44,98,
6292,813,68,33,101,
6293,828,47,45,92,
6294,852,71,53,124,
6295,867,68,42,110,
6296,848,62,40,102,
6297,773,53,37,90,
6298,831,66,42,108,
6299,835,86,50,136,
6300,813,56,36,92,
6301,843,50,46,96,
6302,781,47,49,96,
6303,789,64,44,108,
6304,835,62,55,117,
6305,840,66,41,107,
6306,810,61,49,110,
6307,806,63,42,105,
6308,766,58,38,96,
6309,804,50,34,84,
6310,788,46,51,97,
6311,797,51,48,99,
6312,799,56,51,107,
6313,814,52,40,92,
6314,796,56,40,96,
6315,849,51,46,97,
6316,799,65,41,106,
6317,834,53,39,92,
6318,769,53,45,98,
6319,807,52,45,97,
6320,839,58,44,102,
6321,780,58,50,108,
6322,825,60,42,102,
6323,798,67,55,122,
6324,830,79,44,123,
6325,823,59,49,108,
6326,843,65,49,114,
6327,803,55,48,103,
6328,799,58,39,97,
6329,844,56,50,106,
6330,855,50,47,97,
6331,813,63,41,104,
6332,875,76,51,127,
6333,784,59,42,101,
6334,866,60,46,106,
6335,814,51,54,105,
6336,822,62,50,112,
6337,846,66,54,120,
6338,793,51,39,90,
6339,827,50,54,104,
6340,811,55,49,104,
6341,825,59,49,108,
6342,850,63,35,98,
6343,816,41,47,88,
6344,784,50,44,94,
6345,811,72,44,116,
6346,827,63,39,102,
6347,794,63,41,104,
6348,901,77,54,131,
6349,861,64,63,127,
6350,821,57,46,103,
6351,759,56,38,94,
6352,855,69,53,122,
6353,826,69,43,112,
6354,832,50,49,99,
6355,786,45,49,94,
6356,810,60,53,113,
6357,833,60,48,108,
6358,806,69,50,119,
6359,846,50,58,108,
6360,822,71,40,111,
6361,801,59,56,115,
6362,827,68,50,118,
6363,850,67,56,123,
6364,817,64,58,122,
6365,784,53,40,93,
6366,861,60,61,121,
6367,830,60,50,110,
6368,847,65,48,113,
6369,837,59,50,109,
6370,830,73,52,125,
6371,825,55,47,102,
6372,808,54,50,104,
6373,858,52,43,95,
6374,832,66,49,115,
6375,845,60,45,105,
6376,904,67,48,115,
6377,768,47,40,87,
6378,813,64,51,115,
6379,804,56,52,108,
6380,798,58,48,106,
6381,856,79,51,130,
6382,819,54,46,100,
6383,818,61,63,124,
6384,781,60,40,100,
6385,830,64,43,107,
6386,838,66,53,119,
6387,817,53,49,102,
6388,791,57,45,102,
6389,845,65,50,115,
6390,843,62,54,116,
6391,840,66,33,99,
6392,821,66,49,115,
6393,832,59,45,104,
6394,826,63,54,117,
6395,858,74,49,123,
6396,797,74,49,123,
6397,790,56,39,95,
6398,830,68,55,123,
6399,845,49,55,104,
6400,811,70,45,115,
6401,857,63,53,116,
6402,854,57,66,123,
6403,843,55,56,111,
6404,816,65,44,109,
6405,821,73,47,120,
6406,797,50,57,107,
6407,837,51,53,104,
6408,839,66,48,114,
6409,790,55,44,99,
6410,828,58,49,107,
6411,854,68,37,105,
6412,851,65,40,105,
6413,817,66,44,110,
6414,815,74,49,123,
6415,815,56,44,100,
6416,884,66,59,125,
6417,846,63,52,115,
6418,873,60,60,120,
6419,865,67,53,120,
6420,854,69,34,103,
6421,798,66,31,97,
6422,813,48,40,88,
6423,810,55,45,100,
6424,852,57,55,112,
6425,824,66,35,101,
6426,818,65,50,115,
6427,830,55,42,97,
6428,831,61,42,103,
6429,828,50,37,87,
6430,810,61,50,111,
6431,801,59,45,104,
6432,788,54,39,93,
6433,786,58,51,109,
6434,852,66,49,115,
6435,828,68,40,108,
6436,824,51,58,109,
6437,750,64,57,121,
6438,853,54,47,101,
6439,852,65,48,113,
6440,788,54,48,102,
6441,825,61,43,104,
6442,887,84,57,141,
6443,878,60,51,111,
6444,849,52,56,108,
6445,844,61,57,118,
6446,806,71,47,118,
6447,808,52,37,89,
6448,797,64,42,106,
6449,841,61,40,101,
6450,831,63,36,99,
6451,792,54,50,104,
6452,830,59,56,115,
6453,821,66,37,103,
6454,851,56,45,101,
6455,818,47,42,89,
6456,732,62,36,98,
6457,843,49,42,91,
6458,831,64,46,110,
6459,825,47,57,104,
6460,832,65,47,112,
6461,820,59,48,107,
6462,825,62,42,104,
6463,820,75,38,113,
6464,835,57,50,107,
6465,811,56,40,96,
6466,840,58,50,108,
6467,912,64,60,124,
6468,826,50,36,86,
6469,813,54,45,99,
6470,841,75,43,118,
6471,844,67,48,115,
6472,820,56,40,96,
6473,761,45,42,87,
6474,859,60,44,104,
6475,836,66,54,120,
6476,803,62,38,100,
6477,826,54,46,100,
6478,811,50,48,98,
6479,845,50,44,94,
6480,819,51,50,101,
6481,777,53,43,96,
6482,821,43,53,96,
6483,824,54,50,104,
6484,815,69,48,117,
6485,835,53,37,90,
6486,826,56,46,102,
6487,788,62,40,102,
6488,834,68,46,114,
6489,798,62,51,113,
6490,814,56,48,104,
6491,851,78,50,128,
6492,843,50,42,92,
6493,840,57,50,107,
6494,833,43,37,80,
6495,840,65,51,116,
6496,741,47,34,81,
6497,789,58,47,105,
6498,843,65,61,126,
6499,805,37,52,89,
6500,789,64,40,104,
6501,873,51,43,94,
6502,808,62,52,114,
6503,810,58,51,109,
6504,819,71,41,112,
6505,777,58,48,106,
6506,820,55,63,118,
6507,807,58,42,100,
6508,812,50,42,92,
6509,842,51,44,95,
6510,828,64,37,101,
6511,831,64,53,117,
6512,846,69,51,120,
6513,800,63,53,116,
6514,815,58,49,107,
6515,809,45,51,96,
6516,835,62,32,94,
6517,856,57,46,103,
6518,830,45,45,90,
6519,830,71,50,121,
6520,816,69,51,120,
6521,797,59,42,101,
6522,760,47,42,89,
6523,831,62,51,113,
6524,831,52,53,105,
6525,780,55,51,106,
6526,879,67,47,114,
6527,806,58,45,103,
6528,821,53,54,107,
6529,783,51,57,108,
6530,787,61,45,106,
6531,830,61,46,107,
6532,832,58,59,117,
6533,811,66,49,115,
6534,812,69,47,116,
6535,833,48,43,91,
6536,825,60,59,119,
6537,823,51,42,93,
6538,814,58,49,107,
6539,727,60,47,107,
6540,801,66,41,107,
6541,814,59,43,102,
6542,858,57,56,113,
6543,808,62,42,104,
6544,874,70,44,114,
6545,774,50,37,87,
6546,858,78,49,127,
6547,844,54,55,109,
6548,843,66,52,118,
6549,774,54,46,100,
6550,791,60,45,105,
6551,844,70,50,120,
6552,830,64,52,116,
6553,875,52,62,114,
6554,793,48,42,90,
6555,870,63,41,104,
6556,795,52,45,97,
6557,810,64,62,126,
6558,803,47,59,106,
6559,819,68,35,103,
6560,848,75,43,118,
6561,818,50,41,91,
6562,877,76,54,130,
6563,846,47,47,94,
6564,878,54,45,99,
6565,848,52,55,107,
6566,834,47,55,102,
6567,814,52,43,95,
6568,845,63,49,112,
6569,826,71,55,126,
6570,821,60,53,113,
6571,753,58,35,93,
6572,830,56,48,104,
6573,797,66,48,114,
6574,851,60,53,113,
6575,825,62,42,104,
6576,803,74,35,109,
6577,873,58,56,114,
6578,845,53,39,92,
6579,858,49,55,104,
6580,822,67,52,119,
6581,810,53,52,105,
6582,806,52,46,98,
6583,818,65,47,112,
6584,794,54,43,97,
6585,865,53,44,97,
6586,796,70,41,111,
6587,820,55,43,98,
6588,792,52,51,103,
6589,792,47,42,89,
6590,814,61,38,99,
6591,858,50,50,100,
6592,846,66,42,108,
6593,841,56,41,97,
6594,802,64,51,115,
6595,784,60,49,109,
6596,846,64,54,118,
6597,811,67,40,107,
6598,842,59,48,107,
6599,815,63,45,108,
6600,840,56,43,99,
6601,787,46,57,103,
6602,837,64,50,114,
6603,840,66,47,113,
6604,814,70,60,130,
6605,810,50,51,101,
6606,815,66,47,113,
6607,771,39,47,86,
6608,827,70,32,102,
6609,787,47,57,104,
6610,880,56,52,108,
6611,807,65,46,111,
6612,873,65,58,123,
6613,793,42,41,83,
6614,780,68,50,118,
6615,848,64,41,105,
6616,825,64,46,110,
6617,798,52,45,97,
6618,805,53,49,102,
6619,838,60,54,114,
6620,807,61,50,111,
6621,816,64,45,109,
6622,882,77,50,127,
6623,834,65,56,121,
6624,835,51,53,104,
6625,810,42,53,95,
6626,791,54,34,88,
6627,864,60,55,115,
6628,832,64,45,109,
6629,861,62,40,102,
6630,834,67,49,116,
6631,806,65,38,103,
6632,813,51,42,93,
6633,815,54,40,94,
6634,793,57,50,107,
6635,798,55,56,111,
6636,856,62,44,106,
6637,788,60,41,101,
6638,800,50,57,107,
6639,844,65,56,121,
6640,810,59,49,108,
6641,815,65,41,106,
6642,852,59,53,112,
6643,809,59,39,98,
6644,862,73,47,120,
6645,841,74,42,116,
6646,829,66,47,113,
6647,842,51,46,97,
6648,841,72,53,125,
6649,844,57,43,100,
6650,795,60,37,97,
6651,837,61,57,118,
6652,824,66,49,115,
6653,832,58,54,112,
6654,776,67,38,105,
6655,834,54,40,94,
6656,851,67,44,111,
6657,829,56,38,94,
6658,780,67,46,113,
6659,866,62,53,115,
6660,806,56,41,97,
6661,841,51,49,100,
6662,787,47,43,90,
6663,782,69,40,109,
6664,799,50,57,107,
6665,853,62,47,109,
6666,821,52,49,101,
6667,829,53,55,108,
6668,817,51,52,103,
6669,822,60,47,107,
6670,846,71,33,104,
6671,822,67,58,125,
6672,822,68,53,121,
6673,815,67,41,108,
6674,823,64,52,116,
6675,798,49,43,92,
6676,798,52,44,96,
6677,812,62,44,106,
6678,786,60,47,107,
6679,803,54,41,95,
6680,802,46,43,89,
6681,824,53,47,100,
6682,853,61,41,102,
6683,853,50,44,94,
6684,805,56,52,108,
6685,851,67,54,121,
6686,846,55,48,103,
6687,803,59,50,109,
6688,831,75,45,120,
6689,751,66,43,109,
6690,807,52,50,102,
6691,820,65,48,113,
6692,807,57,38,95,
6693,784,56,50,106,
6694,840,64,57,121,
6695,794,54,42,96,
6696,807,48,42,90,
6697,815,56,47,103,
6698,816,72,48,120,
6699,794,62,35,97,
6700,823,64,44,108,
6701,867,55,56,111,
6702,830,69,41,110,
6703,782,62,36,98,
6704,819,60,55,115,
6705,808,75,36,111,
6706,835,62,47,109,
6707,846,57,57,114,
6708,859,59,44,103,
6709,763,54,43,97,
6710,851,60,56,116,
6711,832,61,52,113,
6712,826,63,60,123,
6713,858,76,54,130,
6714,819,69,52,121,
6715,829,63,45,108,
6716,778,57,48,105,
6717,848,66,40,106,
6718,826,69,41,110,
6719,845,61,55,116,
6720,858,71,55,126,
6721,873,64,58,122,
6722,790,60,55,115,
6723,854,77,46,123,
6724,843,60,43,103,
6725,799,61,41,102,
6726,842,54,43,97,
6727,868,69,46,115,
6728,784,42,51,93,
6729,796,62,57,119,
6730,836,61,60,121,
6731,816,65,54,119,
6732,745,51,38,89,
6733,795,69,49,118,
6734,854,61,41,102,
6735,798,64,51,115,
6736,859,57,60,117,
6737,794,58,39,97,
6738,898,68,53,121,
6739,779,46,43,89,
6740,766,57,52,109,
6741,833,70,52,122,
6742,857,59,42,101,
6743,804,60,47,107,
6744,845,62,45,107,
6745,806,59,48,107,
6746,787,58,43,101,
6747,816,49,40,89,
6748,813,72,54,126,
6749,791,58,48,106,
6750,831,62,49,111,
6751,805,67,44,111,
6752,865,55,56,111,
6753,859,59,48,107,
6754,791,73,50,123,
6755,834,47,45,92,
6756,808,56,55,111,
6757,816,67,43,110,
6758,848,62,48,110,
6759,853,53,45,98,
6760,806,55,45,100,
6761,816,47,48,95,
6762,823,57,54,111,
6763,807,46,45,91,
6764,768,56,46,102,
6765,791,52,41,93,
6766,840,59,60,119,
6767,859,50,58,108,
6768,842,70,60,130,
6769,825,50,38,88,
6770,862,73,41,114,
6771,831,55,54,109,
6772,878,73,38,111,
6773,871,69,41,110,
6774,844,69,50,119,
6775,779,49,29,78,
6776,851,57,37,94,
6777,885,60,46,106,
6778,792,61,43,104,
6779,814,59,52,111,
6780,743,58,34,92,
6781,879,61,41,102,
6782,823,62,38,100,
6783,854,57,69,126,
6784,847,72,41,113,
6785,815,48,39,87,
6786,789,48,59,107,
6787,814,70,43,113,
6788,820,51,44,95,
6789,828,66,49,115,
6790,840,65,45,110,
6791,814,70,43,113,
6792,836,70,46,116,
6793,824,52,50,102,
6794,820,57,45,102,
6795,849,57,50,107,
6796,890,50,52,102,
6797,790,62,47,109,
6798,815,48,42,90,
6799,851,63,54,117,
6800,792,64,32,96,
6801,815,53,43,96,
6802,842,55,51,106,
6803,838,61,54,115,
6804,822,70,49,119,
6805,815,74,51,125,
6806,802,54,46,100,
6807,826,54,47,101,
6808,820,57,55,112,
6809,816,58,33,91,
6810,795,77,50,127,
6811,820,54,36,90,
6812,845,61,52,113,
6813,810,50,60,110,
6814,865,56,42,98,
6815,801,60,44,104,
6816,810,55,62,117,
6817,839,47,48,95,
6818,792,74,34,108,
6819,802,60,33,93,
6820,834,62,53,115,
6821,815,64,31,95,
6822,836,70,48,118,
6823,777,64,36,100,
6824,792,54,53,107,
6825,801,64,49,113,
6826,799,59,36,95,
6827,859,74,45,119,
6828,801,75,39,114,
6829,785,38,46,84,
6830,851,49,53,102,
6831,801,56,50,106,
6832,801,61,50,111,
6833,844,64,54,118,
6834,826,67,42,109,
6835,837,46,46,92,
6836,847,65,48,113,
6837,850,61,51,112,
6838,798,51,44,95,
6839,831,33,41,74,
6840,800,47,43,90,
6841,838,69,44,113,
6842,832,62,54,116,
6843,851,62,41,103,
6844,852,58,48,106,
6845,827,70,44,114,
6846,827,58,41,99,
6847,840,62,56,118,
6848,871,74,56,130,
6849,851,45,50,95,
6850,870,65,59,124,
6851,881,76,48,124,
6852,810,48,51,99,
6853,817,56,51,107,
6854,791,52,47,99,
6855,795,61,46,107,
6856,766,55,49,104,
6857,845,63,62,125,
6858,820,51,51,102,
6859,782,44,33,77,
6860,889,67,57,124,
6861,796,52,37,89,
6862,821,43,39,82,
6863,818,60,42,102,
6864,843,68,47,115,
6865,829,53,47,100,
6866,813,65,53,118,
6867,830,50,42,92,
6868,798,57,37,94,
6869,818,60,40,100,
6870,838,71,47,118,
6871,872,72,44,116,
6872,836,61,48,109,
6873,823,55,46,101,
6874,842,46,48,94,
6875,829,62,51,113,
6876,847,81,43,124,
6877,836,68,36,104,
6878,824,61,53,114,
6879,845,59,50,109,
6880,819,48,48,96,
6881,844,59,63,122,
6882,832,50,46,96,
6883,831,54,42,96,
6884,836,67,48,115,
6885,800,66,51,117,
6886,840,59,49,108,
6887,891,67,39,106,
6888,806,62,54,116,
6889,805,49,49,98,
6890,821,64,46,110,
6891,738,43,57,100,
6892,858,58,49,107,
6893,826,72,42,114,
6894,887,55,59,114,
6895,890,58,52,110,
6896,837,53,45,98,
6897,865,63,51,114,
6898,809,53,52,105,
6899,820,43,52,95,
6900,842,51,43,94,
6901,853,64,64,128,
6902,844,63,48,111,
6903,891,56,46,102,
6904,820,73,38,111,
6905,817,54,66,120,
6906,846,82,40,122,
6907,818,60,50,110,
6908,813,49,55,104,
6909,802,63,56,119,
6910,814,58,57,115,
6911,811,61,45,106,
6912,785,63,54,117,
6913,848,61,47,108,
6914,813,54,35,89,
6915,860,64,56,120,
6916,772,47,44,91,
6917,839,66,48,114,
6918,833,62,51,113,
6919,826,64,44,108,
6920,823,63,55,118,
6921,767,45,41,86,
6922,785,42,49,91,
6923,861,47,51,98,
6924,787,62,50,112,
6925,796,52,48,100,
6926,882,56,54,110,
6927,805,78,42,120,
6928,750,44,32,76,
6929,841,54,53,107,
6930,778,58,42,100,
6931,794,58,43,101,
6932,813,63,41,104,
6933,828,66,50,116,
6934,820,71,50,121,
6935,807,55,45,100,
6936,839,65,50,115,
6937,868,55,53,108,
6938,831,85,53,138,
6939,831,52,51,103,
6940,807,56,52,108,
6941,838,54,54,108,
6942,867,55,47,102,
6943,769,60,51,111,
6944,847,61,54,115,
6945,812,55,48,103,
6946,791,55,42,97,
6947,821,71,46,117,
6948,840,61,47,108,
6949,821,63,37,100,
6950,779,81,47,128,
6951,797,65,42,107,
6952,813,61,38,99,
6953,859,52,47,99,
6954,799,64,47,111,
6955,809,59,52,111,
6956,893,57,52,109,
6957,844,56,50,106,
6958,789,56,37,93,
6959,751,50,40,90,
6960,840,69,50,119,
6961,853,68,44,112,
6962,815,62,49,111,
6963,812,63,52,115,
6964,860,58,57,115,
6965,871,70,69,139,
6966,871,59,53,112,
6967,836,71,57,128,
6968,825,73,45,118,
6969,779,53,51,104,
6970,765,63,32,95,
6971,806,59,55,114,
6972,831,53,44,97,
6973,832,50,36,86,
6974,832,66,45,111,
6975,788,60,45,105,
6976,843,52,40,92,
6977,802,46,40,86,
6978,804,64,51,115,
6979,856,59,51,110,
6980,768,46,36,82,
6981,849,62,47,109,
6982,831,64,41,105,
6983,767,57,59,116,
6984,862,76,49,125,
6985,814,66,52,118,
6986,809,76,43,119,
6987,783,68,45,113,
6988,856,56,47,103,
6989,843,49,61,110,
6990,825,58,50,108,
6991,784,68,39,107,
6992,852,62,55,117,
6993,784,51,42,93,
6994,816,53,55,108,
6995,833,75,41,116,
6996,782,77,42,119,
6997,826,59,55,114,
6998,807,56,49,105,
6999,809,42,52,94,
7000,811,50,49,99,
7001,810,53,40,93,
7002,817,58,46,104,
7003,814,52,52,104,
7004,856,52,51,103,
7005,863,59,56,115,
7006,830,67,47,114,
7007,876,59,59,118,
7008,792,54,53,107,
7009,850,61,57,118,
7010,887,66,44,110,
7011,840,53,54,107,
7012,790,57,44,101,
7013,861,67,52,119,
7014,836,65,42,107,
7015,803,55,49,104,
7016,774,58,42,100,
7017,842,46,52,98,
7018,811,57,56,113,
7019,799,68,59,127,
7020,897,61,51,112,
7021,815,58,55,113,
7022,835,61,52,113,
7023,780,58,45,103,
7024,835,68,59,127,
7025,816,55,54,109,
7026,826,65,47,112,
7027,830,70,43,113,
7028,812,46,43,89,
7029,800,60,53,113,
7030,822,51,57,108,
7031,785,71,44,115,
7032,823,59,57,116,
7033,842,59,53,112,
7034,863,74,58,132,
7035,831,59,45,104,
7036,868,59,38,97,
7037,832,61,49,110,
7038,796,55,47,102,
7039,803,60,40,100,
7040,862,70,36,106,
7041,802,49,39,88,
7042,751,52,52,104,
7043,854,57,40,97,
7044,815,59,42,101,
7045,817,69,40,109,
7046,858,68,43,111,
7047,797,56,47,103,
7048,817,49,40,89,
7049,761,60,45,105,
7050,804,77,42,119,
7051,806,81,55,136,
7052,832,58,39,97,
7053,817,66,40,106,
7054,844,58,56,114,
7055,832,57,60,117,
7056,850,71,49,120,
7057,823,48,44,92,
7058,860,57,49,106,
7059,812,74,39,113,
7060,826,56,50,106,
7061,825,51,44,95,
7062,825,61,58,119,
7063,823,55,52,107,
7064,850,55,45,100,
7065,807,64,54,118,
7066,798,69,34,103,
7067,846,72,43,115,
7068,806,51,38,89,
7069,849,65,52,117,
7070,826,55,45,100,
7071,830,52,51,103,
7072,824,61,44,105,
7073,872,72,53,125,
7074,806,67,43,110,
7075,807,50,43,93,
7076,768,62,39,101,
7077,865,61,40,101,
7078,843,54,45,99,
7079,848,59,47,106,
7080,748,60,44,104,
7081,748,40,38,78,
7082,821,53,43,96,
7083,830,55,51,106,
7084,827,58,50,108,
7085,822,64,43,107,
7086,855,65,60,125,
7087,850,67,49,116,
7088,875,70,50,120,
7089,891,62,49,111,
7090,836,57,43,100,
7091,804,52,47,99,
7092,823,55,45,100,
7093,821,74,51,125,
7094,812,47,47,94,
7095,826,51,51,102,
7096,768,52,40,92,
7097,795,50,49,99,
7098,812,57,52,109,
7099,810,62,46,108,
7100,831,73,37,110,
7101,835,82,48,130,
7102,802,67,38,105,
7103,865,65,41,106,
7104,779,61,44,105,
7105,901,78,55,133,
7106,786,52,46,98,
7107,834,66,47,113,
7108,820,58,41,99,
7109,787,53,40,93,
7110,796,49,41,90,
7111,833,64,57,121,
7112,809,43,45,88,
7113,872,58,59,117,
7114,803,43,60,103,
7115,844,58,38,96,
7116,812,53,53,106,
7117,877,66,48,114,
7118,843,74,45,119,
7119,832,51,41,92,
7120,774,54,48,102,
7121,822,54,37,91,
7122,847,64,49,113,
7123,866,64,51,115,
7124,824,66,36,102,
7125,826,56,54,110,
7126,847,70,40,110,
7127,813,70,47,117,
7128,785,58,39,97,
7129,853,59,53,112,
7130,772,47,35,82,
7131,827,67,65,132,
7132,793,52,51,103,
7133,842,61,35,96,
7134,851,57,47,104,
7135,821,56,48,104,
7136,842,66,50,116,
7137,819,59,62,121,
7138,832,57,38,95,
7139,797,52,55,107,
7140,870,64,47,111,
7141,804,59,43,102,
7142,836,64,53,117,
7143,881,70,44,114,
7144,785,56,58,114,
7145,834,58,39,97,
7146,831,56,46,102,
7147,769,67,32,99,
7148,828,61,52,113,
7149,803,63,36,99,
7150,840,53,45,98,
7151,843,69,61,130,
7152,820,54,44,98,
7153,842,64,45,109,
7154,785,55,35,90,
7155,741,49,46,95,
7156,843,60,47,107,
7157,888,69,48,117,
7158,808,58,54,112,
7159,871,56,46,102,
7160,833,54,47,101,
7161,810,49,50,99,
7162,838,65,54,119,
7163,819,69,46,115,
7164,826,59,40,99,
7165,816,58,48,106,
7166,793,67,61,128,
7167,806,48,33,81,
7168,749,45,49,94,
7169,836,59,40,99,
7170,898,77,53,130,
7171,869,51,53,104,
7172,794,50,50,100,
7173,811,44,49,93,
7174,851,61,53,114,
7175,823,66,42,108,
7176,780,48,56,104,
7177,803,63,46,109,
7178,813,75,59,134,
7179,835,51,52,103,
7180,816,55,41,96,
7181,861,66,43,109,
7182,810,46,38,84,
7183,775,78,41,119,
7184,824,53,55,108,
7185,831,68,55,123,
7186,871,63,66,129,
7187,868,75,39,114,
7188,823,63,58,121,
7189,807,52,43,95,
7190,852,67,45,112,
7191,812,54,41,95,
7192,792,60,55,115,
7193,857,63,52,115,
7194,793,69,37,106,
7195,811,58,38,96,
7196,832,66,29,95,
7197,896,67,45,112,
7198,836,66,62,128,
7199,841,53,54,107,
7200,847,58,53,111,
7201,844,57,49,106,
7202,857,60,62,122,
7203,823,55,50,105,
7204,794,49,33,82,
7205,816,69,47,116,
7206,847,57,57,114,
7207,777,41,34,75,
7208,802,45,37,82,
7209,826,74,46,120,
7210,812,62,42,104,
7211,840,64,58,122,
7212,845,60,42,102,
7213,829,70,51,121,
7214,834,58,46,104,
7215,811,62,55,117,
7216,797,47,44,91,
7217,833,68,51,119,
7218,832,57,53,110,
7219,834,43,49,92,
7220,779,60,47,107,
7221,898,64,50,114,
7222,785,49,40,89,
7223,796,54,41,95,
7224,831,56,54,110,
7225,860,57,45,102,
7226,785,55,51,106,
7227,781,70,52,122,
7228,807,65,50,115,
7229,772,60,47,107,
7230,774,70,59,129,
7231,809,56,48,104,
7232,823,65,45,110,
7233,817,64,43,107,
7234,845,52,46,98,
7235,863,69,46,115,
7236,860,68,48,116,
7237,823,47,49,96,
7238,827,56,51,107,
7239,839,48,43,91,
7240,837,64,38,102,
7241,768,54,35,89,
7242,895,54,70,124,
7243,822,64,47,111,
7244,790,58,45,103,
7245,787,43,32,75,
7246,808,55,40,95,
7247,796,56,50,106,
7248,817,54,46,100,
7249,782,57,33,90,
7250,846,60,48,108,
7251,827,62,36,98,
7252,783,54,50,104,
7253,853,54,47,101,
7254,810,58,38,96,
7255,845,67,48,115,
7256,836,58,53,111,
7257,800,64,50,114,
7258,830,54,48,102,
7259,811,53,39,92,
7260,805,57,47,104,
7261,816,73,37,110,
7262,841,69,52,121,
7263,837,55,44,99,
7264,825,64,58,122,
7265,827,63,59,122,
7266,868,58,43,101,
7267,845,58,40,98,
7268,890,53,47,100,
7269,828,65,58,123,
7270,801,68,45,113,
7271,793,60,39,99,
7272,857,55,58,113,
7273,852,74,51,125,
7274,811,54,36,90,
7275,840,70,43,113,
7276,778,58,51,109,
7277,841,58,42,100,
7278,827,62,45,107,
7279,798,62,38,100,
7280,864,55,56,111,
7281,812,62,35,97,
7282,799,69,38,107,
7283,820,68,46,114,
7284,784,59,34,93,
7285,817,52,54,106,
7286,783,60,60,120,
7287,813,74,43,117,
7288,787,55,36,91,
7289,851,76,58,134,
7290,838,62,42,104,
7291,810,54,50,104,
7292,823,64,38,102,
7293,836,69,49,118,
7294,846,68,44,112,
7295,807,47,32,79,
7296,826,66,50,116,
7297,843,65,40,105,
7298,853,69,50,119,
7299,797,65,47,112,
7300,787,76,33,109,
7301,853,68,65,133,
7302,784,67,42,109,
7303,798,61,41,102,
7304,827,66,46,112,
7305,835,54,55,109,
7306,840,57,51,108,
7307,799,60,46,106,
7308,816,75,48,123,
7309,811,58,38,96,
7310,844,53,44,97,
7311,848,62,44,106,
7312,789,49,37,86,
7313,857,61,49,110,
7314,773,58,54,112,
7315,845,62,46,108,
7316,857,73,39,112,
7317,836,68,38,106,
7318,838,69,45,114,
7319,812,57,38,95,
7320,798,59,44,103,
7321,836,63,40,103,
7322,783,54,39,93,
7323,853,57,37,94,
7324,779,45,42,87,
7325,820,49,48,97,
7326,819,67,48,115,
7327,838,56,54,110,
7328,786,63,37,100,
7329,780,64,48,112,
7330,791,64,51,115,
7331,815,59,39,98,
7332,807,81,57,138,
7333,767,50,51,101,
7334,812,58,39,97,
7335,863,61,40,101,
7336,833,68,47,115,
7337,825,51,54,105,
7338,797,64,42,106,
7339,852,53,38,91,
7340,829,61,44,105,
7341,823,43,56,99,
7342,825,56,45,101,
7343,822,63,43,106,
7344,854,62,47,109,
7345,764,63,51,114,
7346,804,71,41,112,
7347,877,69,45,114,
7348,777,41,46,87,
7349,857,64,47,111,
7350,771,70,46,116,
7351,794,63,45,108,
7352,778,40,49,89,
7353,860,68,57,125,
7354,770,51,47,98,
7355,810,48,44,92,
7356,855,65,43,108,
7357,797,73,49,122,
7358,845,54,51,105,
7359,836,61,52,113,
7360,819,77,49,126,
7361,802,72,51,123,
7362,839,58,42,100,
7363,873,55,47,102,
7364,906,70,55,125,
7365,811,76,50,126,
7366,754,56,45,101,
7367,793,53,46,99,
7368,836,60,43,103,
7369,866,59,44,103,
7370,849,65,56,121,
7371,775,57,29,86,
7372,760,60,42,102,
7373,787,61,46,107,
7374,798,60,37,97,
7375,798,52,34,86,
7376,837,56,37,93,
7377,752,50,48,98,
7378,824,58,41,99,
7379,892,55,41,96,
7380,821,66,47,113,
7381,821,56,60,116,
7382,821,64,57,121,
7383,802,49,49,98,
7384,871,61,55,116,
7385,829,65,44,109,
7386,818,66,44,110,
7387,849,72,52,124,
7388,840,63,40,103,
7389,852,50,60,110,
7390,810,47,55,102,
7391,859,51,50,101,
7392,843,69,46,115,
7393,843,60,48,108,
7394,845,67,48,115,
7395,816,52,47,99,
7396,831,65,30,95,
7397,845,70,56,126,
7398,838,67,43,110,
7399,820,55,51,106,
7400,782,69,59,128,
7401,887,64,51,115,
7402,813,58,41,99,
7403,821,52,43,95,
7404,813,76,43,119,
7405,788,54,47,101,
7406,809,60,47,107,
7407,790,63,50,113,
7408,823,62,44,106,
7409,787,63,41,104,
7410,853,72,55,127,
7411,851,55,44,99,
7412,775,56,52,108,
7413,808,56,47,103,
7414,804,64,40,104,
7415,830,48,45,93,
7416,797,54,43,97,
7417,817,40,50,90,
7418,866,55,53,108,
7419,814,61,48,109,
7420,799,58,37,95,
7421,837,63,50,113,
7422,873,62,56,118,
7423,842,54,61,115,
7424,850,55,40,95,
7425,853,55,45,100,
7426,802,63,51,114,
7427,871,64,46,110,
7428,848,73,47,120,
7429,790,60,52,112,
7430,832,56,49,105,
7431,832,62,44,106,
7432,834,60,43,103,
7433,785,53,39,92,
7434,830,63,42,105,
7435,816,61,53,114,
7436,833,67,56,123,
7437,828,61,47,108,
7438,813,64,44,108,
7439,830,72,50,122,
7440,842,51,65,116,
7441,859,55,33,88,
7442,777,66,52,118,
7443,787,55,39,94,
7444,836,65,43,108,
7445,805,56,53,109,
7446,903,75,51,126,
7447,845,55,48,103,
7448,903,65,57,122,
7449,869,56,60,116,
7450,849,51,45,96,
7451,812,54,40,94,
7452,787,50,44,94,
7453,879,64,38,102,
7454,843,66,61,127,
7455,826,51,40,91,
7456,854,57,39,96,
7457,800,65,45,110,
7458,862,53,53,106,
7459,841,63,50,113,
7460,830,70,43,113,
7461,804,61,53,114,
7462,824,64,53,117,
7463,816,58,43,101,
7464,794,75,35,110,
7465,848,55,56,111,
7466,852,64,52,116,
7467,858,67,45,112,
7468,838,62,39,101,
7469,806,67,52,119,
7470,815,51,48,99,
7471,802,71,48,119,
7472,863,64,56,120,
7473,797,50,45,95,
7474,835,61,44,105,
7475,730,57,46,103,
7476,840,61,46,107,
7477,810,48,53,101,
7478,823,60,47,107,
7479,793,66,46,112,
7480,791,52,48,100,
7481,820,56,60,116,
7482,839,55,50,105,
7483,804,62,49,111,
7484,873,54,51,105,
7485,856,78,39,117,
7486,749,49,39,88,
7487,859,57,54,111,
7488,807,54,47,101,
7489,791,63,40,103,
7490,844,56,50,106,
7491,807,54,44,98,
7492,839,48,50,98,
7493,757,50,34,84,
7494,839,66,41,107,
7495,797,55,47,102,
7496,842,58,47,105,
7497,909,71,55,126,
7498,801,61,44,105,
7499,855,72,32,104,
7500,845,75,47,122,
7501,874,69,62,131,
7502,769,55,43,98,
7503,816,57,43,100,
7504,889,58,51,109,
7505,817,71,46,117,
7506,791,60,39,99,
7507,842,56,51,107,
7508,818,63,48,111,
7509,794,62,51,113,
7510,914,62,54,116,
7511,835,68,48,116,
7512,834,61,45,106,
7513,837,64,54,118,
7514,831,56,47,103,
7515,832,61,66,127,
7516,758,48,39,87,
7517,811,57,37,94,
7518,831,69,58,127,
7519,817,61,36,97,
7520,827,63,49,112,
7521,848,58,51,109,
7522,833,85,39,124,
7523,815,53,48,101,
7524,838,51,57,108,
7525,846,50,49,99,
7526,816,53,46,99,
7527,807,52,58,110,
7528,878,67,52,119,
7529,800,59,48,107,
7530,820,61,52,113,
7531,845,68,58,126,
7532,849,65,49,114,
7533,804,71,53,124,
7534,765,44,36,80,
7535,866,68,60,128,
7536,782,47,51,98,
7537,860,71,46,117,
7538,793,63,49,112,
7539,842,63,43,106,
7540,843,67,41,108,
7541,832,53,43,96,
7542,874,66,54,120,
7543,827,63,56,119,
7544,801,53,41,94,
7545,763,56,39,95,
7546,812,68,41,109,
7547,794,52,42,94,
7548,838,66,50,116,
7549,821,49,45,94,
7550,822,63,47,110,
7551,735,52,46,98,
7552,889,64,39,103,
7553,812,57,43,100,
7554,858,64,46,110,
7555,843,66,46,112,
7556,810,62,40,102,
7557,755,69,52,121,
7558,852,59,44,103,
7559,790,52,45,97,
7560,828,55,49,104,
7561,901,64,54,118,
7562,821,54,51,105,
7563,854,65,42,107,
7564,837,58,45,103,
7565,775,44,33,77,
7566,816,50,40,90,
7567,869,58,47,105,
7568,905,70,60,130,
7569,868,62,44,106,
7570,788,50,46,96,
7571,807,61,39,100,
7572,778,49,53,102,
7573,835,49,44,93,
7574,780,46,41,87,
7575,832,74,50,124,
7576,858,65,46,111,
7577,826,44,38,82,
7578,832,58,58,116,
7579,823,68,50,118,
7580,780,76,36,112,
7581,786,56,52,108,
7582,811,64,48,112,
7583,821,63,38,101,
7584,844,67,58,125,
7585,815,59,42,101,
7586,857,67,45,112,
7587,839,53,49,102,
7588,845,68,51,119,
7589,868,68,58,126,
7590,821,65,57,122,
7591,863,74,56,130,
7592,828,53,43,96,
7593,801,68,49,117,
7594,827,49,56,105,
7595,792,46,41,87,
7596,847,69,48,117,
7597,866,82,52,134,
7598,806,61,43,104,
7599,832,84,53,137,
7600,828,46,42,88,
7601,868,70,50,120,
7602,810,56,40,96,
7603,779,59,51,110,
7604,840,52,44,96,
7605,801,43,55,98,
7606,828,55,51,106,
7607,817,56,43,99,
7608,804,61,44,105,
7609,847,49,54,103,
7610,858,64,38,102,
7611,821,60,44,104,
7612,834,64,48,112,
7613,805,45,48,93,
7614,857,73,43,116,
7615,832,56,45,101,
7616,803,56,44,100,
7617,816,56,42,98,
7618,878,49,60,109,
7619,817,75,41,116,
7620,849,52,49,101,
7621,765,49,31,80,
7622,840,62,57,119,
7623,817,53,45,98,
7624,865,59,58,117,
7625,831,53,36,89,
7626,851,69,52,121,
7627,814,66,47,113,
7628,827,58,50,108,
7629,868,74,45,119,
7630,766,50,45,95,
7631,800,61,51,112,
7632,805,44,62,106,
7633,832,67,54,121,
7634,805,48,55,103,
7635,766,58,41,99,
7636,859,73,68,141,
7637,828,54,44,98,
7638,819,74,42,116,
7639,813,61,49,110,
7640,854,65,59,124,
7641,840,65,66,131,
7642,834,57,61,118,
7643,840,52,51,103,
7644,801,62,46,108,
7645,756,56,42,98,
7646,814,61,44,105,
7647,805,65,57,122,
7648,821,48,60,108,
7649,815,69,44,113,
7650,803,61,49,110,
7651,748,41,39,80,
7652,779,68,64,132,
7653,790,60,41,101,
7654,785,35,56,91,
7655,792,60,62,122,
7656,833,68,46,114,
7657,810,64,48,112,
7658,802,63,38,101,
7659,836,60,55,115,
7660,862,66,48,114,
7661,826,73,56,129,
7662,854,49,53,102,
7663,787,72,46,118,
7664,758,55,51,106,
7665,842,62,63,125,
7666,840,54,50,104,
7667,810,61,45,106,
7668,819,53,44,97,
7669,863,51,57,108,
7670,794,51,48,99,
7671,827,52,33,85,
7672,810,56,54,110,
7673,778,62,40,102,
7674,832,68,47,115,
7675,850,53,38,91,
7676,820,68,46,114,
7677,799,58,47,105,
7678,801,71,41,112,
7679,892,69,40,109,
7680,804,59,55,114,
7681,850,61,49,110,
7682,837,40,50,90,
7683,827,52,55,107,
7684,847,65,59,124,
7685,839,56,55,111,
7686,882,66,49,115,
7687,826,62,49,111,
7688,844,61,52,113,
7689,794,58,36,94,
7690,801,64,44,108,
7691,806,65,38,103,
7692,813,52,48,100,
7693,809,57,60,117,
7694,885,62,53,115,
7695,867,55,54,109,
7696,807,51,43,94,
7697,866,55,56,111,
7698,827,51,47,98,
7699,845,50,48,98,
7700,833,61,51,112,
7701,833,57,53,110,
7702,800,56,40,96,
7703,899,65,50,115,
7704,881,71,42,113,
7705,797,58,56,114,
7706,875,57,51,108,
7707,822,60,56,116,
7708,817,79,44,123,
7709,809,55,53,108,
7710,821,63,33,96,
7711,780,43,36,79,
7712,833,68,57,125,
7713,786,50,44,94,
7714,802,51,42,93,
7715,872,64,41,105,
7716,783,52,49,101,
7717,791,79,39,118,
7718,757,54,44,98,
7719,811,58,45,103,
7720,794,42,41,83,
7721,838,70,45,115,
7722,784,53,61,114,
7723,785,66,46,112,
7724,837,57,48,105,
7725,792,62,47,109,
7726,816,66,44,110,
7727,852,61,46,107,
7728,773,45,45,90,
7729,830,67,48,115,
7730,811,71,56,127,
7731,833,73,44,117,
7732,816,58,45,103,
7733,769,52,33,85,
7734,800,60,58,118,
7735,812,51,47,98,
7736,833,53,44,97,
7737,829,51,50,101,
7738,847,62,54,116,
7739,888,68,53,121,
7740,825,57,47,104,
7741,841,40,47,87,
7742,796,55,48,103,
7743,827,55,46,101,
7744,799,45,45,90,
7745,838,44,49,93,
7746,843,51,37,88,
7747,787,70,37,107,
7748,834,52,47,99,
7749,834,64,44,108,
7750,816,74,51,125,
7751,802,53,49,102,
7752,772,60,39,99,
7753,805,50,39,89,
7754,790,65,44,109,
7755,811,49,50,99,
7756,847,71,46,117,
7757,806,62,52,114,
7758,904,74,62,136,
7759,869,55,58,113,
7760,821,63,44,107,
7761,761,57,43,100,
7762,838,48,45,93,
7763,783,56,41,97,
7764,787,62,44,106,
7765,804,40,47,87,
7766,828,60,43,103,
7767,777,58,45,103,
7768,781,57,46,103,
7769,833,77,46,123,
7770,799,60,49,109,
7771,805,49,45,94,
7772,845,61,49,110,
7773,850,71,38,109,
7774,799,51,42,93,
7775,821,59,49,108,
7776,814,67,56,123,
7777,811,53,33,86,
7778,841,75,36,111,
7779,844,64,47,111,
7780,835,67,46,113,
7781,848,73,44,117,
7782,805,70,44,114,
7783,809,66,50,116,
7784,832,57,43,100,
7785,802,50,47,97,
7786,845,67,45,112,
7787,785,46,42,88,
7788,792,49,48,97,
7789,853,66,40,106,
7790,814,54,48,102,
7791,756,51,42,93,
7792,802,52,40,92,
7793,847,57,46,103,
7794,833,57,40,97,
7795,804,51,53,104,
7796,795,52,49,101,
7797,869,73,46,119,
7798,844,62,52,114,
7799,888,57,56,113,
7800,853,65,42,107,
7801,837,63,49,112,
7802,842,67,51,118,
7803,811,51,44,95,
7804,776,51,47,98,
7805,791,63,42,105,
7806,820,53,57,110,
7807,841,60,41,101,
7808,840,61,33,94,
7809,807,59,44,103,
7810,812,53,46,99,
7811,830,67,43,110,
7812,830,63,48,111,
7813,767,48,37,85,
7814,791,59,40,99,
7815,861,70,38,108,
7816,860,66,59,125,
7817,810,54,48,102,
7818,826,54,47,101,
7819,831,57,45,102,
7820,816,57,50,107,
7821,772,64,42,106,
7822,848,80,44,124,
7823,790,51,49,100,
7824,821,52,40,92,
7825,771,62,46,108,
7826,783,52,47,99,
7827,835,65,59,124,
7828,790,58,54,112,
7829,805,54,48,102,
7830,803,60,48,108,
7831,810,66,39,105,
7832,806,67,42,109,
7833,825,56,65,121,
7834,801,58,54,112,
7835,854,56,44,100,
7836,782,47,45,92,
7837,772,50,43,93,
7838,791,54,43,97,
7839,845,58,43,101,
7840,797,70,39,109,
7841,870,59,55,114,
7842,830,69,50,119,
7843,806,72,34,106,
7844,830,58,42,100,
7845,754,49,36,85,
7846,765,54,40,94,
7847,774,54,40,94,
7848,817,59,50,109,
7849,780,57,42,99,
7850,810,52,43,95,
7851,860,58,28,86,
7852,833,56,49,105,
7853,801,65,39,104,
7854,807,47,49,96,
7855,798,59,48,107,
7856,834,65,54,119,
7857,846,56,42,98,
7858,805,62,46,108,
7859,875,60,52,112,
7860,837,63,49,112,
7861,774,66,45,111,
7862,803,48,43,91,
7863,872,61,45,106,
7864,767,48,52,100,
7865,832,43,42,85,
7866,858,62,42,104,
7867,829,63,44,107,
7868,847,64,45,109,
7869,799,66,44,110,
7870,785,55,46,101,
7871,817,47,43,90,
7872,817,46,55,101,
7873,784,63,44,107,
7874,839,64,35,99,
7875,824,69,52,121,
7876,852,58,44,102,
7877,761,60,38,98,
7878,765,49,52,101,
7879,797,60,53,113,
7880,881,58,59,117,
7881,811,62,55,117,
7882,824,46,50,96,
7883,827,63,51,114,
7884,844,61,38,99,
7885,858,64,54,118,
7886,804,45,41,86,
7887,835,51,51,102,
7888,831,50,43,93,
7889,830,52,45,97,
7890,836,58,45,103,
7891,821,74,47,121,
7892,821,68,47,115,
7893,810,48,47,95,
7894,849,46,53,99,
7895,823,62,53,115,
7896,844,54,43,97,
7897,806,45,51,96,
7898,892,64,53,117,
7899,766,59,48,107,
7900,807,57,54,111,
7901,849,47,43,90,
7902,858,58,58,116,
7903,819,55,39,94,
7904,836,58,53,111,
7905,851,53,39,92,
7906,850,63,49,112,
7907,827,62,43,105,
7908,766,62,43,105,
7909,793,52,41,93,
7910,860,66,50,116,
7911,820,45,53,98,
7912,822,67,39,106,
7913,817,67,46,113,
7914,833,55,49,104,
7915,815,74,63,137,
7916,809,62,38,100,
7917,904,62,53,115,
7918,740,58,42,100,
7919,823,70,47,117,
7920,843,64,65,129,
7921,804,59,39,98,
7922,791,56,33,89,
7923,814,55,45,100,
7924,830,54,41,95,
7925,795,72,38,110,
7926,830,62,55,117,
7927,840,58,44,102,
7928,809,66,54,120,
7929,792,59,48,107,
7930,823,53,52,105,
7931,848,68,40,108,
7932,853,54,47,101,
7933,867,61,48,109,
7934,828,56,62,118,
7935,890,55,49,104,
7936,783,60,40,100,
7937,790,54,41,95,
7938,793,65,48,113,
7939,869,71,56,127,
7940,821,63,48,111,
7941,844,58,47,105,
7942,860,62,50,112,
7943,832,65,38,103,
7944,811,50,49,99,
7945,837,68,59,127,
7946,822,70,51,121,
7947,853,62,39,101,
7948,825,47,50,97,
7949,821,68,30,98,
7950,798,44,39,83,
7951,818,47,48,95,
7952,773,65,49,114,
7953,833,59,41,100,
7954,793,60,45,105,
7955,851,65,51,116,
7956,816,65,51,116,
7957,870,67,50,117,
7958,828,70,44,114,
7959,783,58,37,95,
7960,830,59,39,98,
7961,816,67,46,113,
7962,855,54,44,98,
7963,825,69,48,117,
7964,875,62,64,126,
7965,842,68,42,110,
7966,814,63,47,110,
7967,814,41,59,100,
7968,821,62,35,97,
7969,842,73,46,119,
7970,830,67,49,116,
7971,824,52,47,99,
7972,824,51,52,103,
7973,845,53,49,102,
7974,787,61,39,100,
7975,810,58,44,102,
7976,820,59,42,101,
7977,840,51,45,96,
7978,812,60,42,102,
7979,838,57,61,118,
7980,836,55,43,98,
7981,834,59,44,103,
7982,823,49,40,89,
7983,812,48,46,94,
7984,767,64,41,105,
7985,823,47,35,82,
7986,826,74,46,120,
7987,850,56,50,106,
7988,853,58,65,123,
7989,818,60,50,110,
7990,779,44,40,84,
7991,799,60,48,108,
7992,851,60,35,95,
7993,799,46,46,92,
7994,901,63,42,105,
7995,786,44,53,97,
7996,799,62,51,113,
7997,818,54,38,92,
7998,860,58,53,111,
7999,840,52,55,107,
8000,828,67,39,106,
8001,837,46,37,83,
8002,823,66,42,108,
8003,820,52,59,111,
8004,803,68,48,116,
8005,847,59,41,100,
8006,817,59,45,104,
8007,841,69,57,126,
8008,820,56,57,113,
8009,831,55,43,98,
8010,839,56,45,101,
8011,822,58,39,97,
8012,815,51,50,101,
8013,876,54,43,97,
8014,824,70,49,119,
8015,828,65,42,107,
8016,842,68,44,112,
8017,848,64,48,112,
8018,782,58,50,108,
8019,848,68,54,122,
8020,803,61,45,106,
8021,854,48,53,101,
8022,815,52,50,102,
8023,820,73,51,124,
8024,847,66,43,109,
8025,844,54,50,104,
8026,785,67,39,106,
8027,841,54,46,100,
8028,787,58,38,96,
8029,769,48,51,99,
8030,803,87,44,131,
8031,788,50,41,91,
8032,797,60,49,109,
8033,820,58,47,105,
8034,872,58,47,105,
8035,823,53,40,93,
8036,782,59,49,108,
8037,874,49,40,89,
8038,867,73,53,126,
8039,834,69,40,109,
8040,810,56,46,102,
8041,793,55,46,101,
8042,864,72,52,124,
8043,817,59,52,111,
8044,870,53,53,106,
8045,840,59,60,119,
8046,805,62,45,107,
8047,760,48,51,99,
8048,818,51,53,104,
8049,810,65,46,111,
8050,854,63,50,113,
8051,816,51,61,112,
8052,790,48,39,87,
8053,826,56,48,104,
8054,906,66,65,131,
8055,821,66,37,103,
8056,833,56,48,104,
8057,875,75,54,129,
8058,821,54,47,101,
8059,824,60,46,106,
8060,753,60,40,100,
8061,789,51,46,97,
8062,845,66,47,113,
8063,837,68,36,104,
8064,829,53,51,104,
8065,846,67,41,108,
8066,818,56,45,101,
8067,821,66,46,112,
8068,773,53,39,92,
8069,878,73,48,121,
8070,822,54,51,105,
8071,763,54,40,94,
8072,810,58,56,114,
8073,821,61,39,100,
8074,808,74,56,130,
8075,852,78,42,120,
8076,825,59,41,100,
8077,786,65,44,109,
8078,836,62,39,101,
8079,834,60,53,113,
8080,827,52,56,108,
8081,865,67,46,113,
8082,844,61,44,105,
8083,813,54,39,93,
8084,861,57,44,101,
8085,862,60,47,107,
8086,833,78,57,135,
8087,834,55,57,112,
8088,817,57,44,101,
8089,797,56,53,109,
8090,820,53,38,91,
8091,846,65,43,108,
8092,741,53,46,99,
8093,851,71,53,124,
8094,898,59,60,119,
8095,767,68,48,116,
8096,789,46,47,93,
8097,820,61,40,101,
8098,816,66,43,109,
8099,825,57,53,110,
8100,855,62,42,104,
8101,793,58,43,101,
8102,845,58,53,111,
8103,821,62,40,102,
8104,841,82,45,127,
8105,833,69,29,98,
8106,801,61,41,102,
8107,859,52,46,98,
8108,810,70,47,117,
8109,826,67,55,122,
8110,812,46,52,98,
8111,847,67,57,124,
8112,851,70,38,108,
8113,809,59,24,83,
8114,806,67,57,124,
8115,856,65,58,123,
8116,795,55,40,95,
8117,834,78,51,129,
8118,879,55,55,110,
8119,806,59,51,110,
8120,772,42,37,79,
8121,842,59,56,115,
8122,793,61,52,113,
8123,820,54,42,96,
8124,811,68,38,106,
8125,798,47,57,104,
8126,813,56,46,102,
8127,820,52,51,103,
8128,845,69,37,106,
8129,812,57,48,105,
8130,808,51,37,88,
8131,818,59,43,102,
8132,849,63,49,112,
8133,828,61,51,112,
8134,881,57,46,103,
8135,805,62,44,106,
8136,807,58,50,108,
8137,806,47,45,92,
8138,827,57,51,108,
8139,839,62,42,104,
8140,780,57,36,93,
8141,789,51,49,100,
8142,785,59,37,96,
8143,901,54,63,117,
8144,860,53,41,94,
8145,808,60,44,104,
8146,848,74,44,118,
8147,856,64,62,126,
8148,799,61,40,101,
8149,801,49,31,80,
8150,822,64,44,108,
8151,869,67,55,122,
8152,828,50,48,98,
8153,770,63,47,110,
8154,878,60,59,119,
8155,792,57,38,95,
8156,822,63,54,117,
8157,824,60,45,105,
8158,809,55,43,98,
8159,816,53,35,88,
8160,830,56,52,108,
8161,834,45,41,86,
8162,808,46,46,92,
8163,882,71,45,116,
8164,880,59,45,104,
8165,790,42,45,87,
8166,790,54,50,104,
8167,808,58,47,105,
8168,841,53,59,112,
8169,871,82,60,142,
8170,886,50,48,98,
8171,870,61,46,107,
8172,825,53,50,103,
8173,814,58,29,87,
8174,842,57,46,103,
8175,789,63,32,95,
8176,818,68,32,100,
8177,885,58,39,97,
8178,794,54,49,103,
8179,835,62,55,117,
8180,799,49,57,106,
8181,766,53,34,87,
8182,799,56,52,108,
8183,829,50,37,87,
8184,808,62,38,100,
8185,806,68,46,114,
8186,845,68,50,118,
8187,840,53,38,91,
8188,869,50,57,107,
8189,816,63,48,111,
8190,793,50,42,92,
8191,837,59,40,99,
8192,736,56,42,98,
8193,773,49,45,94,
8194,799,56,37,93,
8195,855,65,44,109,
8196,867,63,42,105,
8197,827,50,35,85,
8198,824,65,48,113,
8199,825,57,38,95,
8200,813,55,45,100,
8201,793,53,49,102,
8202,825,67,38,105,
8203,828,53,38,91,
8204,840,66,41,107,
8205,784,62,48,110,
8206,873,58,44,102,
8207,788,75,43,118,
8208,839,63,49,112,
8209,829,55,47,102,
8210,883,50,46,96,
8211,838,58,57,115,
8212,820,50,48,98,
8213,848,59,38,97,
8214,835,58,52,110,
8215,760,49,43,92,
8216,801,51,38,89,
8217,835,71,54,125,
8218,808,60,33,93,
8219,834,52,59,111,
8220,791,49,49,98,
8221,819,60,48,108,
8222,829,79,52,131,
8223,852,71,46,117,
8224,807,56,57,113,
8225,811,58,55,113,
8226,812,58,41,99,
8227,779,43,48,91,
8228,856,56,46,102,
8229,826,62,41,103,
8230,856,50,47,97,
8231,870,69,58,127,
8232,812,66,47,113,
8233,815,50,44,94,
8234,867,62,48,110,
8235,843,80,42,122,
8236,822,76,61,137,
8237,841,53,52,105,
8238,817,59,45,104,
8239,820,54,51,105,
8240,837,60,51,111,
8241,790,48,58,106,
8242,776,63,42,105,
8243,788,67,42,109,
8244,818,71,41,112,
8245,815,54,48,102,
8246,788,50,50,100,
8247,873,67,52,119,
8248,844,49,56,105,
8249,868,59,48,107,
8250,810,60,40,100,
8251,808,64,43,107,
8252,874,48,44,92,
8253,813,57,49,106,
8254,829,50,50,100,
8255,869,71,49,120,
8256,798,69,49,118,
8257,813,54,52,106,
8258,792,54,55,109,
8259,797,57,41,98,
8260,802,68,46,114,
8261,834,62,46,108,
8262,789,46,40,86,
8263,849,64,46,110,
8264,794,73,48,121,
8265,781,59,45,104,
8266,880,68,53,121,
8267,843,63,34,97,
8268,810,60,39,99,
8269,873,57,41,98,
8270,779,50,54,104,
8271,806,50,46,96,
8272,822,60,53,113,
8273,836,54,53,107,
8274,837,56,45,101,
8275,815,54,36,90,
8276,794,55,46,101,
8277,791,59,44,103,
8278,833,53,40,93,
8279,868,52,43,95,
8280,809,66,48,114,
8281,885,71,50,121,
8282,788,54,37,91,
8283,840,50,48,98,
8284,841,55,44,99,
8285,837,55,39,94,
8286,834,59,38,97,
8287,862,55,47,102,
8288,792,58,43,101,
8289,795,64,61,125,
8290,743,49,46,95,
8291,816,47,56,103,
8292,812,63,41,104,
8293,828,58,49,107,
8294,843,63,60,123,
8295,829,69,43,112,
8296,831,54,45,99,
8297,820,59,53,112,
8298,815,53,52,105,
8299,811,61,41,102,
8300,810,57,43,100,
8301,808,70,47,117,
8302,825,52,51,103,
8303,893,64,45,109,
8304,827,47,37,84,
8305,846,52,49,101,
8306,857,76,40,116,
8307,855,54,46,100,
8308,836,60,42,102,
8309,800,46,51,97,
8310,825,41,54,95,
8311,858,59,26,85,
8312,860,61,44,105,
8313,784,45,32,77,
8314,850,58,54,112,
8315,834,48,59,107,
8316,843,86,60,146,
8317,769,58,38,96,
8318,888,58,59,117,
8319,815,56,49,105,
8320,762,53,38,91,
8321,788,58,37,95,
8322,840,72,51,123,
8323,874,58,55,113,
8324,808,50,44,94,
8325,856,59,41,100,
8326,820,54,46,100,
8327,867,52,65,117,
8328,825,44,55,99,
8329,818,58,49,107,
8330,845,60,37,97,
8331,784,49,42,91,
8332,801,60,42,102,
8333,862,65,46,111,
8334,834,76,49,125,
8335,812,59,55,114,
8336,838,63,47,110,
8337,838,69,49,118,
8338,841,71,58,129,
8339,812,62,47,109,
8340,790,65,38,103,
8341,798,61,37,98,
8342,775,62,38,100,
8343,818,49,67,116,
8344,847,57,45,102,
8345,838,50,39,89,
8346,872,61,36,97,
8347,862,70,47,117,
8348,863,54,48,102,
8349,853,59,54,113,
8350,788,68,38,106,
8351,823,64,45,109,
8352,862,64,38,102,
8353,848,66,47,113,
8354,819,69,62,131,
8355,840,49,62,111,
8356,823,45,38,83,
8357,810,44,45,89,
8358,800,67,39,106,
8359,765,55,40,95,
8360,807,65,45,110,
8361,791,55,44,99,
8362,780,64,31,95,
8363,823,55,45,100,
8364,809,50,61,111,
8365,816,56,51,107,
8366,836,62,62,124,
8367,780,69,39,108,
8368,750,61,42,103,
8369,804,52,57,109,
8370,821,74,44,118,
8371,803,60,50,110,
8372,874,60,50,110,
8373,804,42,57,99,
8374,815,51,46,97,
8375,860,57,51,108,
8376,870,63,43,106,
8377,786,54,41,95,
8378,881,63,50,113,
8379,818,67,37,104,
8380,864,78,44,122,
8381,802,65,54,119,
8382,813,61,47,108,
8383,812,53,61,114,
8384,870,67,43,110,
8385,834,63,54,117,
8386,785,59,42,101,
8387,798,51,49,100,
8388,848,72,43,115,
8389,800,47,51,98,
8390,776,73,39,112,
8391,830,57,51,108,
8392,748,49,45,94,
8393,829,64,41,105,
8394,809,48,55,103,
8395,806,60,49,109,
8396,849,57,44,101,
8397,802,68,51,119,
8398,848,62,46,108,
8399,758,44,37,81,
8400,840,66,45,111,
8401,816,57,44,101,
8402,901,64,62,126,
8403,862,79,51,130,
8404,830,49,49,98,
8405,825,67,55,122,
8406,859,71,59,130,
8407,802,59,46,105,
8408,820,66,53,119,
8409,867,72,50,122,
8410,828,65,40,105,
8411,814,55,54,109,
8412,801,66,43,109,
8413,825,68,48,116,
8414,832,49,53,102,
8415,831,51,41,92,
8416,832,62,44,106,
8417,842,64,35,99,
8418,789,64,41,105,
8419,876,66,46,112,
8420,863,62,59,121,
8421,870,62,61,123,
8422,832,71,41,112,
8423,813,49,39,88,
8424,804,42,41,83,
8425,817,52,37,89,
8426,834,47,46,93,
8427,822,61,52,113,
8428,851,70,63,133,
8429,848,66,48,114,
8430,848,66,56,122,
8431,812,47,36,83,
8432,841,69,43,112,
8433,885,74,48,122,
8434,828,58,40,98,
8435,830,61,43,104,
8436,830,53,41,94,
8437,802,49,42,91,
8438,867,66,51,117,
8439,787,49,42,91,
8440,877,65,38,103,
8441,807,66,39,105,
8442,815,58,38,96,
8443,819,54,40,94,
8444,823,57,41,98,
8445,821,58,47,105,
8446,865,57,46,103,
8447,830,75,46,121,
8448,824,74,47,121,
8449,793,62,46,108,
8450,776,61,43,104,
8451,783,60,36,96,
8452,823,78,38,116,
8453,869,56,59,115,
8454,793,57,34,91,
8455,840,58,48,106,
8456,877,44,46,90,
8457,850,65,51,116,
8458,826,48,51,99,
8459,806,60,59,119,
8460,804,48,41,89,
8461,822,69,49,118,
8462,828,67,41,108,
8463,807,68,46,114,
8464,844,50,43,93,
8465,792,58,47,105,
8466,871,66,58,124,
8467,873,59,51,110,
8468,814,55,49,104,
8469,794,52,41,93,
8470,803,62,56,118,
8471,894,60,42,102,
8472,837,62,49,111,
8473,804,59,31,90,
8474,799,60,48,108,
8475,763,61,43,104,
8476,830,68,51,119,
8477,808,47,54,101,
8478,878,62,50,112,
8479,805,80,46,126,
8480,809,49,34,83,
8481,833,59,48,107,
8482,871,77,57,134,
8483,846,39,47,86,
8484,783,54,45,99,
8485,756,49,46,95,
8486,778,64,51,115,
8487,807,58,40,98,
8488,859,67,57,124,
8489,827,68,54,122,
8490,834,77,38,115,
8491,791,38,43,81,
8492,843,62,39,101,
8493,838,62,50,112,
8494,805,54,44,98,
8495,803,53,37,90,
8496,858,60,56,116,
8497,839,55,51,106,
8498,828,56,43,99,
8499,807,52,41,93,
8500,831,57,50,107,
8501,846,60,47,107,
8502,835,67,47,114,
8503,829,65,38,103,
8504,850,58,45,103,
8505,814,54,42,96,
8506,850,56,56,112,
8507,813,71,49,120,
8508,859,61,43,104,
8509,793,61,47,108,
8510,821,53,43,96,
8511,779,70,58,128,
8512,766,50,43,93,
8513,829,65,39,104,
8514,877,52,60,112,
8515,805,77,53,130,
8516,843,74,48,122,
8517,844,77,51,128,
8518,849,58,63,121,
8519,801,53,32,85,
8520,823,53,45,98,
8521,811,50,40,90,
8522,809,70,41,111,
8523,829,62,46,108,
8524,811,54,46,100,
8525,831,62,47,109,
8526,792,48,53,101,
8527,809,55,40,95,
8528,878,61,53,114,
8529,884,67,51,118,
8530,850,71,53,124,
8531,833,69,47,116,
8532,778,61,37,98,
8533,780,56,44,100,
8534,798,67,49,116,
8535,800,61,40,101,
8536,801,68,45,113,
8537,818,46,45,91,
8538,775,47,48,95,
8539,835,44,36,80,
8540,838,75,45,120,
8541,785,51,33,84,
8542,856,69,43,112,
8543,833,64,49,113,
8544,798,67,42,109,
8545,790,51,40,91,
8546,873,62,39,101,
8547,808,69,32,101,
8548,793,55,41,96,
8549,862,62,60,122,
8550,831,56,50,106,
8551,821,72,49,121,
8552,831,56,39,95,
8553,830,45,46,91,
8554,759,48,43,91,
8555,797,55,43,98,
8556,845,61,43,104,
8557,828,50,40,90,
8558,759,61,40,101,
8559,836,63,41,104,
8560,804,70,53,123,
8561,765,58,40,98,
8562,806,60,47,107,
8563,835,46,39,85,
8564,804,53,45,98,
8565,757,64,39,103,
8566,849,51,53,104,
8567,812,53,44,97,
8568,768,52,35,87,
8569,802,42,56,98,
8570,777,49,47,96,
8571,866,57,58,115,
8572,806,47,56,103,
8573,795,62,49,111,
8574,851,61,43,104,
8575,814,52,52,104,
8576,845,66,45,111,
8577,836,49,51,100,
8578,837,51,58,109,
8579,808,49,49,98,
8580,829,67,47,114,
8581,845,43,52,95,
8582,829,52,50,102,
8583,842,63,36,99,
8584,844,44,64,108,
8585,832,56,63,119,
8586,806,53,42,95,
8587,817,63,49,112,
8588,824,63,59,122,
8589,824,65,50,115,
8590,798,57,50,107,
8591,844,60,50,110,
8592,777,59,43,102,
8593,870,64,44,108,
8594,797,48,55,103,
8595,832,62,66,128,
8596,810,60,51,111,
8597,839,61,54,115,
8598,839,57,49,106,
8599,788,67,38,105,
8600,777,52,43,95,
8601,797,44,38,82,
8602,803,57,35,92,
8603,798,72,48,120,
8604,840,64,56,120,
8605,828,71,56,127,
8606,888,55,54,109,
8607,828,54,49,103,
8608,777,44,31,75,
8609,849,59,42,101,
8610,862,62,56,118,
8611,844,78,56,134,
8612,852,69,56,125,
8613,834,66,41,107,
8614,834,60,40,100,
8615,836,62,50,112,
8616,849,80,57,137,
8617,808,67,39,106,
8618,821,69,66,135,
8619,783,50,38,88,
8620,835,47,50,97,
8621,816,49,60,109,
8622,836,58,67,125,
8623,814,61,39,100,
8624,787,55,40,95,
8625,795,66,39,105,
8626,825,55,43,98,
8627,838,64,45,109,
8628,787,53,44,97,
8629,854,51,51,102,
8630,841,72,50,122,
8631,828,66,51,117,
8632,758,63,40,103,
8633,788,44,49,93,
8634,822,66,58,124,
8635,797,66,50,116,
8636,854,67,52,119,
8637,791,52,45,97,
8638,860,59,49,108,
8639,815,54,58,112,
8640,869,68,52,120,
8641,792,45,41,86,
8642,861,57,38,95,
8643,796,63,36,99,
8644,820,68,48,116,
8645,844,66,39,105,
8646,855,68,48,116,
8647,860,68,47,115,
8648,841,55,53,108,
8649,804,65,48,113,
8650,869,60,44,104,
8651,776,62,32,94,
8652,823,47,41,88,
8653,846,84,44,128,
8654,834,58,56,114,
8655,832,56,36,92,
8656,847,67,41,108,
8657,819,59,48,107,
8658,855,54,55,109,
8659,792,50,40,90,
8660,777,66,42,108,
8661,782,55,53,108,
8662,822,52,44,96,
8663,825,79,40,119,
8664,819,56,50,106,
8665,836,69,50,119,
8666,821,59,49,108,
8667,885,64,54,118,
8668,758,60,45,105,
8669,858,76,43,119,
8670,837,59,44,103,
8671,809,59,44,103,
8672,803,68,49,117,
8673,878,73,49,122,
8674,902,71,55,126,
8675,732,51,45,96,
8676,815,71,48,119,
8677,833,72,42,114,
8678,814,64,51,115,
8679,766,51,47,98,
8680,826,53,54,107,
8681,819,64,36,100,
8682,813,64,55,119,
8683,815,57,56,113,
8684,814,50,42,92,
8685,817,69,49,118,
8686,831,51,43,94,
8687,830,46,58,104,
8688,821,60,45,105,
8689,803,65,56,121,
8690,861,66,51,117,
8691,859,69,47,116,
8692,799,54,45,99,
8693,807,65,54,119,
8694,854,63,56,119,
8695,880,70,50,120,
8696,880,70,46,116,
8697,826,69,48,117,
8698,790,54,28,82,
8699,801,51,38,89,
8700,835,68,43,111,
8701,816,68,51,119,
8702,800,55,47,102,
8703,820,67,47,114,
8704,855,63,35,98,
8705,794,43,54,97,
8706,816,45,36,81,
8707,768,49,38,87,
8708,888,63,59,122,
8709,817,58,49,107,
8710,856,56,43,99,
8711,872,68,46,114,
8712,827,60,51,111,
8713,771,57,39,96,
8714,863,68,51,119,
8715,829,45,51,96,
8716,780,58,45,103,
8717,759,50,46,96,
8718,817,56,40,96,
8719,862,55,42,97,
8720,830,60,54,114,
8721,820,69,41,110,
8722,831,55,62,117,
8723,916,68,54,122,
8724,837,60,57,117,
8725,812,61,37,98,
8726,829,48,47,95,
8727,814,62,48,110,
8728,821,61,54,115,
8729,835,66,50,116,
8730,843,68,46,114,
8731,817,72,47,119,
8732,801,59,36,95,
8733,845,67,43,110,
8734,876,85,55,140,
8735,836,62,54,116,
8736,765,61,42,103,
8737,832,59,40,99,
8738,806,43,49,92,
8739,818,65,45,110,
8740,798,52,51,103,
8741,805,51,42,93,
8742,808,58,43,101,
8743,849,68,46,114,
8744,830,69,54,123,
8745,819,65,51,116,
8746,800,60,49,109,
8747,880,55,41,96,
8748,869,67,59,126,
8749,779,63,39,102,
8750,844,51,53,104,
8751,818,63,49,112,
8752,816,57,49,106,
8753,799,58,31,89,
8754,810,63,55,118,
8755,871,69,44,113,
8756,828,73,45,118,
8757,827,78,42,120,
8758,886,58,46,104,
8759,838,54,43,97,
8760,820,61,48,109,
8761,868,65,51,116,
8762,766,71,55,126,
8763,806,58,55,113,
8764,812,56,38,94,
8765,812,72,46,118,
8766,780,48,47,95,
8767,836,62,39,101,
8768,826,56,50,106,
8769,792,44,49,93,
8770,821,60,48,108,
8771,800,58,54,112,
8772,799,57,45,102,
8773,816,54,59,113,
8774,803,49,42,91,
8775,797,51,55,106,
8776,863,56,43,99,
8777,811,51,58,109,
8778,809,55,57,112,
8779,828,58,50,108,
8780,833,53,55,108,
8781,803,61,39,100,
8782,772,63,48,111,
8783,829,57,45,102,
8784,846,61,50,111,
8785,848,64,50,114,
8786,802,53,61,114,
8787,785,47,47,94,
8788,766,52,51,103,
8789,832,63,43,106,
8790,842,61,42,103,
8791,863,59,43,102,
8792,841,64,37,101,
8793,828,72,48,120,
8794,818,61,48,109,
8795,826,59,37,96,
8796,816,56,54,110,
8797,834,62,41,103,
8798,856,61,45,106,
8799,828,62,42,104,
8800,888,69,41,110,
8801,826,59,62,121,
8802,816,52,42,94,
8803,877,59,60,119,
8804,785,62,48,110,
8805,789,60,60,120,
8806,751,54,38,92,
8807,852,60,51,111,
8808,832,59,38,97,
8809,854,55,54,109,
8810,812,49,52,101,
8811,849,68,50,118,
8812,777,51,36,87,
8813,831,75,46,121,
8814,793,71,44,115,
8815,832,67,59,126,
8816,782,75,38,113,
8817,817,61,48,109,
8818,822,68,36,104,
8819,820,53,39,92,
8820,827,51,49,100,
8821,801,59,40,99,
8822,762,69,49,118,
8823,866,62,39,101,
8824,803,67,46,113,
8825,852,67,59,126,
8826,793,49,45,94,
8827,854,57,56,113,
8828,859,59,52,111,
8829,842,63,57,120,
8830,760,66,41,107,
8831,833,67,38,105,
8832,836,74,40,114,
8833,789,45,42,87,
8834,767,55,46,101,
8835,826,60,50,110,
8836,844,61,45,106,
8837,871,65,37,102,
8838,832,57,41,98,
8839,832,63,53,116,
8840,786,53,42,95,
8841,856,53,58,111,
8842,836,67,44,111,
8843,801,65,47,112,
8844,809,61,47,108,
8845,836,69,58,127,
8846,832,62,44,106,
8847,807,64,45,109,
8848,818,71,28,99,
8849,840,61,63,124,
8850,852,67,68,135,
8851,826,72,33,105,
8852,808,66,45,111,
8853,816,54,48,102,
8854,816,54,51,105,
8855,820,60,45,105,
8856,821,45,47,92,
8857,871,61,45,106,
8858,832,70,45,115,
8859,776,45,45,90,
8860,833,57,46,103,
8861,829,56,49,105,
8862,828,63,42,105,
8863,825,51,44,95,
8864,834,61,39,100,
8865,788,56,46,102,
8866,814,65,51,116,
8867,808,55,45,100,
8868,808,50,35,85,
8869,850,67,51,118,
8870,846,57,54,111,
8871,819,55,53,108,
8872,857,64,48,112,
8873,858,71,36,107,
8874,831,49,43,92,
8875,808,73,40,113,
8876,836,63,50,113,
8877,782,55,44,99,
8878,877,61,56,117,
8879,864,76,42,118,
8880,834,62,43,105,
8881,856,54,54,108,
8882,842,50,54,104,
8883,801,68,41,109,
8884,818,67,48,115,
8885,840,55,56,111,
8886,859,58,43,101,
8887,798,51,54,105,
8888,806,64,34,98,
8889,844,70,52,122,
8890,819,54,48,102,
8891,794,61,46,107,
8892,858,69,49,118,
8893,907,66,58,124,
8894,838,69,52,121,
8895,795,52,50,102,
8896,782,51,47,98,
8897,815,55,61,116,
8898,804,58,41,99,
8899,826,51,50,101,
8900,867,51,55,106,
8901,849,65,48,113,
8902,803,50,46,96,
8903,827,61,53,114,
8904,769,57,42,99,
8905,811,56,40,96,
8906,838,58,40,98,
8907,835,63,41,104,
8908,815,64,36,100,
8909,845,73,50,123,
8910,851,53,49,102,
8911,763,48,37,85,
8912,821,54,47,101,
8913,839,65,56,121,
8914,835,52,55,107,
8915,903,66,53,119,
8916,855,67,37,104,
8917,862,58,45,103,
8918,857,56,44,100,
8919,848,52,48,100,
8920,811,60,39,99,
8921,795,51,44,95,
8922,841,67,43,110,
8923,828,69,46,115,
8924,825,59,59,118,
8925,753,44,50,94,
8926,850,67,49,116,
8927,795,60,41,101,
8928,826,41,55,96,
8929,812,61,56,117,
8930,768,60,39,99,
8931,825,62,50,112,
8932,764,52,57,109,
8933,796,61,54,115,
8934,822,59,43,102,
8935,795,67,41,108,
8936,798,51,47,98,
8937,802,47,51,98,
8938,835,63,50,113,
8939,795,63,45,108,
8940,830,63,44,107,
8941,794,73,49,122,
8942,862,58,54,112,
8943,840,67,46,113,
8944,819,54,50,104,
8945,830,48,51,99,
8946,843,59,47,106,
8947,809,56,37,93,
8948,806,68,47,115,
8949,862,60,56,116,
8950,829,69,55,124,
8951,840,58,42,100,
8952,823,56,49,105,
8953,825,51,42,93,
8954,789,45,46,91,
8955,810,60,49,109,
8956,809,63,41,104,
8957,856,77,49,126,
8958,784,48,49,97,
8959,819,59,50,109,
8960,857,66,56,122,
8961,863,61,42,103,
8962,835,57,39,96,
8963,865,59,53,112,
8964,807,60,36,96,
8965,810,59,44,103,
8966,800,61,38,99,
8967,890,62,38,100,
8968,865,74,42,116,
8969,801,58,52,110,
8970,804,66,46,112,
8971,872,62,60,122,
8972,820,73,49,122,
8973,790,59,46,105,
8974,769,49,49,98,
8975,817,63,49,112,
8976,832,62,46,108,
8977,840,67,40,107,
8978,764,64,50,114,
8979,867,72,43,115,
8980,828,69,46,115,
8981,832,65,39,104,
8982,766,40,35,75,
8983,849,63,51,114,
8984,888,57,60,117,
8985,783,60,34,94,
8986,847,51,36,87,
8987,864,51,59,110,
8988,817,65,47,112,
8989,764,59,61,120,
8990,851,65,53,118,
8991,846,80,46,126,
8992,770,57,45,102,
8993,805,57,44,101,
8994,850,54,55,109,
8995,851,71,52,123,
8996,860,58,53,111,
8997,767,52,47,99,
8998,829,53,43,96,
8999,794,42,49,91,
9000,807,70,40,110,
9001,820,64,45,109,
9002,832,53,52,105,
9003,816,58,41,99,
9004,836,55,48,103,
9005,799,55,52,107,
9006,806,52,56,108,
9007,797,52,46,98,
9008,819,70,44,114,
9009,878,68,47,115,
9010,797,56,42,98,
9011,860,54,43,97,
9012,863,55,41,96,
9013,830,73,46,119,
9014,772,60,40,100,
9015,780,56,38,94,
9016,838,49,42,91,
9017,823,56,49,105,
9018,799,52,51,103,
9019,808,58,37,95,
9020,822,55,40,95,
9021,827,47,44,91,
9022,819,60,48,108,
9023,799,51,50,101,
9024,806,61,56,117,
9025,848,68,35,103,
9026,799,60,42,102,
9027,886,53,52,105,
9028,900,76,33,109,
9029,857,51,49,100,
9030,820,63,42,105,
9031,839,63,41,104,
9032,836,53,57,110,
9033,805,46,41,87,
9034,837,56,58,114,
9035,848,62,41,103,
9036,842,58,46,104,
9037,829,59,47,106,
9038,847,62,62,124,
9039,834,63,51,114,
9040,825,51,41,92,
9041,832,55,52,107,
9042,812,82,56,138,
9043,859,58,54,112,
9044,835,51,36,87,
9045,860,57,52,109,
9046,836,62,51,113,
9047,849,69,51,120,
9048,874,63,42,105,
9049,831,62,55,117,
9050,837,57,43,100,
9051,802,48,50,98,
9052,866,69,57,126,
9053,898,75,43,118,
9054,873,57,45,102,
9055,848,68,46,114,
9056,865,52,56,108,
9057,833,65,54,119,
9058,847,71,45,116,
9059,775,59,42,101,
9060,834,57,58,115,
9061,845,78,49,127,
9062,818,52,43,95,
9063,830,61,55,116,
9064,811,72,44,116,
9065,807,58,46,104,
9066,802,75,28,103,
9067,842,73,56,129,
9068,810,54,48,102,
9069,793,56,42,98,
9070,845,53,46,99,
9071,882,56,53,109,
9072,846,61,44,105,
9073,800,65,57,122,
9074,810,62,51,113,
9075,780,47,57,104,
9076,817,56,47,103,
9077,859,57,48,105,
9078,794,70,43,113,
9079,777,52,37,89,
9080,845,58,51,109,
9081,797,62,34,96,
9082,814,55,47,102,
9083,831,74,45,119,
9084,800,61,37,98,
9085,855,66,64,130,
9086,814,50,47,97,
9087,886,69,51,120,
9088,833,54,48,102,
9089,795,65,40,105,
9090,812,59,40,99,
9091,767,61,33,94,
9092,848,71,46,117,
9093,874,47,44,91,
9094,875,57,54,111,
9095,790,61,39,100,
9096,855,59,68,127,
9097,791,53,48,101,
9098,786,69,46,115,
9099,798,56,34,90,
9100,822,54,45,99,
9101,812,71,40,111,
9102,826,53,44,97,
9103,841,63,56,119,
9104,814,63,53,116,
9105,840,59,51,110,
9106,853,56,56,112,
9107,842,61,36,97,
9108,808,61,55,116,
9109,840,57,45,102,
9110,872,75,37,112,
9111,796,60,44,104,
9112,815,63,51,114,
9113,850,78,44,122,
9114,827,64,35,99,
9115,864,67,45,112,
9116,817,44,50,94,
9117,803,48,42,90,
9118,802,56,48,104,
9119,905,48,48,96,
9120,882,66,42,108,
9121,831,70,51,121,
9122,762,52,37,89,
9123,871,68,39,107,
9124,797,57,32,89,
9125,849,74,36,110,
9126,782,68,48,116,
9127,818,60,40,100,
9128,845,55,49,104,
9129,803,40,44,84,
9130,805,53,45,98,
9131,842,62,37,99,
9132,794,60,40,100,
9133,870,65,43,108,
9134,829,55,47,102,
9135,845,50,58,108,
9136,873,54,40,94,
9137,828,63,54,117,
9138,802,52,48,100,
9139,803,69,48,117,
9140,832,50,39,89,
9141,823,53,60,113,
9142,853,64,55,119,
9143,776,46,47,93,
9144,844,56,48,104,
9145,813,68,33,101,
9146,860,77,51,128,
9147,836,55,48,103,
9148,861,60,53,113,
9149,829,63,39,102,
9150,864,55,41,96,
9151,795,60,33,93,
9152,826,66,49,115,
9153,830,59,37,96,
9154,851,57,45,102,
9155,817,50,43,93,
9156,837,71,53,124,
9157,827,67,44,111,
9158,867,76,56,132,
9159,816,62,37,99,
9160,868,61,49,110,
9161,784,61,39,100,
9162,864,61,49,110,
9163,847,66,43,109,
9164,854,62,39,101,
9165,890,56,46,102,
9166,776,46,52,98,
9167,850,54,48,102,
9168,816,60,49,109,
9169,820,65,48,113,
9170,819,53,41,94,
9171,828,70,46,116,
9172,813,51,37,88,
9173,842,58,48,106,
9174,815,53,45,98,
9175,879,81,54,135,
9176,804,55,37,92,
9177,869,62,46,108,
9178,865,55,45,100,
9179,847,58,46,104,
9180,872,54,49,103,
9181,822,66,39,105,
9182,857,55,57,112,
9183,820,63,44,107,
9184,804,49,43,92,
9185,804,51,48,99,
9186,847,67,51,118,
9187,811,59,46,105,
9188,785,70,41,111,
9189,862,61,50,111,
9190,821,58,44,102,
9191,831,45,51,96,
9192,839,68,48,116,
9193,793,55,44,99,
9194,834,69,52,121,
9195,853,58,42,100,
9196,809,59,45,104,
9197,818,47,44,91,
9198,857,56,56,112,
9199,828,59,35,94,
9200,863,48,47,95,
9201,790,61,37,98,
9202,788,53,45,98,
9203,814,56,39,95,
9204,829,63,42,105,
9205,873,72,45,117,
9206,799,62,39,101,
9207,767,64,49,113,
9208,831,63,52,115,
9209,767,60,41,101,
9210,798,54,47,101,
9211,712,52,42,94,
9212,852,63,55,118,
9213,837,62,49,111,
9214,839,66,47,113,
9215,831,63,55,118,
9216,856,61,63,124,
9217,845,64,57,121,
9218,866,64,43,107,
9219,841,60,59,119,
9220,838,50,52,102,
9221,801,63,44,107,
9222,846,69,43,112,
9223,887,56,50,106,
9224,827,58,53,111,
9225,815,68,46,114,
9226,851,55,42,97,
9227,809,73,52,125,
9228,879,57,40,97,
9229,817,56,44,100,
9230,780,47,37,84,
9231,771,53,43,96,
9232,852,81,44,125,
9233,845,56,56,112,
9234,822,50,42,92,
9235,836,59,53,112,
9236,856,63,40,103,
9237,804,65,40,105,
9238,791,52,47,99,
9239,856,51,41,92,
9240,796,73,50,123,
9241,870,67,45,112,
9242,788,48,48,96,
9243,854,58,49,107,
9244,899,68,63,131,
9245,905,61,59,120,
9246,759,67,45,112,
9247,861,63,56,119,
9248,837,59,47,106,
9249,833,59,42,101,
9250,849,61,58,119,
9251,795,54,45,99,
9252,781,50,46,96,
9253,825,58,48,106,
9254,815,55,44,99,
9255,824,43,44,87,
9256,817,52,58,110,
9257,831,76,44,120,
9258,802,58,49,107,
9259,819,62,42,104,
9260,817,61,33,94,
9261,799,58,55,113,
9262,809,64,45,109,
9263,814,58,36,94,
9264,853,71,55,126,
9265,853,67,41,108,
9266,816,69,49,118,
9267,832,67,48,115,
9268,827,66,44,110,
9269,881,57,48,105,
9270,827,56,47,103,
9271,812,46,40,86,
9272,831,70,49,119,
9273,840,50,30,80,
9274,811,51,42,93,
9275,826,54,32,86,
9276,832,53,32,85,
9277,778,58,58,116,
9278,845,57,40,97,
9279,849,57,43,100,
9280,852,55,47,102,
9281,855,64,47,111,
9282,823,50,48,98,
9283,885,61,50,111,
9284,813,59,51,110,
9285,860,80,49,129,
9286,860,66,65,131,
9287,843,57,50,107,
9288,787,46,45,91,
9289,821,54,39,93,
9290,799,56,54,110,
9291,859,60,47,107,
9292,765,62,43,105,
9293,832,80,44,124,
9294,814,66,42,108,
9295,844,51,55,106,
9296,834,57,53,110,
9297,816,60,61,121,
9298,839,50,49,99,
9299,831,58,48,106,
9300,786,54,41,95,
9301,856,69,56,125,
9302,845,60,34,94,
9303,856,75,54,129,
9304,795,45,53,98,
9305,790,55,40,95,
9306,820,72,43,115,
9307,821,49,52,101,
9308,803,42,47,89,
9309,839,55,52,107,
9310,778,66,46,112,
9311,784,54,52,106,
9312,820,42,57,99,
9313,794,58,48,106,
9314,783,59,57,116,
9315,832,52,47,99,
9316,818,56,49,105,
9317,849,64,56,120,
9318,835,56,46,102,
9319,821,65,53,118,
9320,872,55,50,105,
9321,853,71,58,129,
9322,802,63,50,113,
9323,812,63,47,110,
9324,877,66,39,105,
9325,858,71,48,119,
9326,811,62,40,102,
9327,834,76,55,131,
9328,828,69,43,112,
9329,785,74,36,110,
9330,857,79,42,121,
9331,829,57,49,106,
9332,829,73,41,114,
9333,792,74,48,122,
9334,818,61,41,102,
9335,866,74,52,126,
9336,843,67,46,113,
9337,835,58,56,114,
9338,814,65,32,97,
9339,774,69,55,124,
9340,860,61,52,113,
9341,804,59,39,98,
9342,867,57,57,114,
9343,782,61,40,101,
9344,807,67,44,111,
9345,794,64,50,114,
9346,853,56,54,110,
9347,814,61,47,108,
9348,770,59,30,89,
9349,818,61,40,101,
9350,803,54,49,103,
9351,830,53,48,101,
9352,804,54,53,107,
9353,808,60,37,97,
9354,801,67,43,110,
9355,830,63,31,94,
9356,781,57,46,103,
9357,835,64,52,116,
9358,824,62,40,102,
9359,839,76,44,120,
9360,829,63,49,112,
9361,856,60,41,101,
9362,851,66,56,122,
9363,807,68,43,111,
9364,822,56,47,103,
9365,774,50,48,98,
9366,810,72,45,117,
9367,820,60,46,106,
9368,864,62,59,121,
9369,872,67,49,116,
9370,817,61,45,106,
9371,821,67,51,118,
9372,844,68,58,126,
9373,865,77,59,136,
9374,807,71,38,109,
9375,799,52,50,102,
9376,776,42,43,85,
9377,855,70,47,117,
9378,814,48,46,94,
9379,862,72,56,128,
9380,829,64,53,117,
9381,814,51,49,100,
9382,830,54,51,105,
9383,871,72,56,128,
9384,771,49,35,84,
9385,801,49,40,89,
9386,793,63,41,104,
9387,808,49,58,107,
9388,813,52,51,103,
9389,856,58,43,101,
9390,865,73,53,126,
9391,789,55,46,101,
9392,821,66,38,104,
9393,837,61,48,109,
9394,831,65,41,106,
9395,871,62,52,114,
9396,793,44,41,85,
9397,803,68,50,118,
9398,842,52,48,100,
9399,870,64,50,114,
9400,836,49,58,107,
9401,817,58,36,94,
9402,847,64,56,120,
9403,805,63,47,110,
9404,822,59,57,116,
9405,827,55,48,103,
9406,897,80,47,127,
9407,789,53,45,98,
9408,870,71,39,110,
9409,811,66,54,120,
9410,831,58,35,93,
9411,820,62,42,104,
9412,894,57,52,109,
9413,799,43,57,100,
9414,762,69,44,113,
9415,780,57,54,111,
9416,861,63,53,116,
9417,791,65,43,108,
9418,828,58,43,101,
9419,865,63,61,124,
9420,866,65,51,116,
9421,770,52,46,98,
9422,843,64,42,106,
9423,877,53,39,92,
9424,875,64,46,110,
9425,848,60,46,106,
9426,813,66,47,113,
9427,853,65,43,108,
9428,843,75,47,122,
9429,842,62,43,105,
9430,770,45,33,78,
9431,795,68,44,112,
9432,893,62,57,119,
9433,829,65,40,105,
9434,797,66,55,121,
9435,814,52,39,91,
9436,814,65,44,109,
9437,815,69,45,114,
9438,828,61,44,105,
9439,792,44,45,89,
9440,796,55,46,101,
9441,798,72,40,112,
9442,792,57,43,100,
9443,849,63,38,101,
9444,828,74,47,121,
9445,809,61,33,94,
9446,806,49,50,99,
9447,779,59,49,108,
9448,829,61,44,105,
9449,833,63,41,104,
9450,850,58,42,100,
9451,808,50,46,96,
9452,810,75,44,119,
9453,797,67,45,112,
9454,819,53,52,105,
9455,791,70,48,118,
9456,809,60,45,105,
9457,797,61,39,100,
9458,893,68,49,117,
9459,787,69,47,116,
9460,785,57,40,97,
9461,838,61,50,111,
9462,810,50,45,95,
9463,820,62,61,123,
9464,819,58,54,112,
9465,799,65,45,110,
9466,806,59,54,113,
9467,809,55,40,95,
9468,856,55,66,121,
9469,863,63,49,112,
9470,827,61,47,108,
9471,829,60,45,105,
9472,841,70,47,117,
9473,885,60,48,108,
9474,848,54,49,103,
9475,823,66,52,118,
9476,824,71,36,107,
9477,798,47,41,88,
9478,844,66,41,107,
9479,805,58,50,108,
9480,783,51,37,88,
9481,804,58,43,101,
9482,813,58,53,111,
9483,805,66,41,107,
9484,810,60,49,109,
9485,867,70,50,120,
9486,830,66,59,125,
9487,804,60,34,94,
9488,837,62,46,108,
9489,874,74,64,138,
9490,860,71,49,120,
9491,835,60,48,108,
9492,789,64,57,121,
9493,818,52,41,93,
9494,824,61,59,120,
9495,835,53,41,94,
9496,791,53,32,85,
9497,831,50,47,97,
9498,829,72,52,124,
9499,780,64,38,102,
9500,872,42,43,85,
9501,828,53,58,111,
9502,832,61,44,105,
9503,856,47,45,92,
9504,829,64,39,103,
9505,792,70,50,120,
9506,799,62,46,108,
9507,803,74,37,111,
9508,801,56,48,104,
9509,860,67,40,107,
9510,807,62,42,104,
9511,827,69,40,109,
9512,822,76,54,130,
9513,811,57,61,118,
9514,836,54,45,99,
9515,799,76,46,122,
9516,822,61,43,104,
9517,798,49,47,96,
9518,797,60,55,115,
9519,806,51,61,112,
9520,814,49,41,90,
9521,889,61,51,112,
9522,898,67,50,117,
9523,830,58,44,102,
9524,806,53,37,90,
9525,782,45,47,92,
9526,858,57,45,102,
9527,889,68,37,105,
9528,821,59,48,107,
9529,748,56,43,99,
9530,833,53,59,112,
9531,834,61,41,102,
9532,878,59,52,111,
9533,816,51,33,84,
9534,813,71,47,118,
9535,820,55,41,96,
9536,823,70,53,123,
9537,856,53,60,113,
9538,808,58,47,105,
9539,804,66,39,105,
9540,806,52,61,113,
9541,840,69,42,111,
9542,800,48,47,95,
9543,807,68,50,118,
9544,833,68,42,110,
9545,813,56,31,87,
9546,877,85,57,142,
9547,861,51,54,105,
9548,828,51,45,96,
9549,797,69,46,115,
9550,734,53,49,102,
9551,771,62,41,103,
9552,793,49,40,89,
9553,809,60,47,107,
9554,817,52,42,94,
9555,826,70,38,108,
9556,817,54,58,112,
9557,813,62,51,113,
9558,866,57,60,117,
9559,802,63,54,117,
9560,818,55,42,97,
9561,821,65,44,109,
9562,816,59,47,106,
9563,801,75,45,120,
9564,802,57,55,112,
9565,853,69,49,118,
9566,842,56,45,101,
9567,841,63,43,106,
9568,839,60,40,100,
9569,787,62,39,101,
9570,854,60,45,105,
9571,794,58,42,100,
9572,768,43,47,90,
9573,852,55,50,105,
9574,834,60,39,99,
9575,805,56,52,108,
9576,818,61,34,95,
9577,835,61,64,125,
9578,841,56,40,96,
9579,842,51,56,107,
9580,842,63,54,117,
9581,800,57,63,120,
9582,850,73,36,109,
9583,837,59,35,94,
9584,834,48,40,88,
9585,856,71,42,113,
9586,810,54,49,103,
9587,807,52,41,93,
9588,831,54,57,111,
9589,892,59,62,121,
9590,845,67,52,119,
9591,836,77,46,123,
9592,840,55,34,89,
9593,818,50,49,99,
9594,829,54,52,106,
9595,810,72,42,114,
9596,839,60,50,110,
9597,845,79,52,131,
9598,849,74,49,123,
9599,802,58,34,92,
9600,849,61,48,109,
9601,845,66,41,107,
9602,862,65,36,101,
9603,781,41,47,88,
9604,814,66,38,104,
9605,841,66,56,122,
9606,803,71,49,120,
9607,762,57,35,92,
9608,798,64,40,104,
9609,818,71,48,119,
9610,780,62,33,95,
9611,815,47,53,100,
9612,804,56,49,105,
9613,837,59,53,112,
9614,789,63,38,101,
9615,860,52,46,98,
9616,854,67,44,111,
9617,816,47,39,86,
9618,778,54,49,103,
9619,803,43,52,95,
9620,780,62,39,101,
9621,776,65,38,103,
9622,858,58,54,112,
9623,793,57,48,105,
9624,835,61,50,111,
9625,853,55,46,101,
9626,774,54,35,89,
9627,825,49,48,97,
9628,769,54,44,98,
9629,831,60,66,126,
9630,804,59,54,113,
9631,840,61,54,115,
9632,831,61,53,114,
9633,871,73,57,130,
9634,826,52,40,92,
9635,807,63,44,107,
9636,841,60,39,99,
9637,837,52,58,110,
9638,802,63,48,111,
9639,838,63,44,107,
9640,840,63,59,122,
9641,892,55,45,100,
9642,782,57,46,103,
9643,823,48,43,91,
9644,785,60,40,100,
9645,828,63,59,122,
9646,880,64,43,107,
9647,835,59,38,97,
9648,827,53,48,101,
9649,830,48,49,97,
9650,837,62,44,106,
9651,818,70,37,107,
9652,839,41,65,106,
9653,829,51,44,95,
9654,823,58,38,96,
9655,792,67,49,116,
9656,886,63,45,108,
9657,870,59,49,108,
9658,849,62,50,112,
9659,784,65,49,114,
9660,813,57,47,104,
9661,835,65,52,117,
9662,806,75,45,120,
9663,787,57,43,100,
9664,832,55,37,92,
9665,812,55,41,96,
9666,809,49,51,100,
9667,810,58,46,104,
9668,768,50,37,87,
9669,817,60,44,104,
9670,838,58,49,107,
9671,871,59,47,106,
9672,845,46,49,95,
9673,806,52,40,92,
9674,839,60,40,100,
9675,800,52,43,95,
9676,837,55,43,98,
9677,866,50,52,102,
9678,849,48,51,99,
9679,847,60,49,109,
9680,833,63,52,115,
9681,813,46,48,94,
9682,824,57,50,107,
9683,836,63,46,109,
9684,846,56,50,106,
9685,840,70,48,118,
9686,855,63,51,114,
9687,833,66,46,112,
9688,819,69,29,98,
9689,804,73,47,120,
9690,817,55,54,109,
9691,838,51,47,98,
9692,798,60,55,115,
9693,843,63,43,106,
9694,818,59,57,116,
9695,821,62,55,117,
9696,791,53,55,108,
9697,848,69,42,111,
9698,833,64,43,107,
9699,846,70,43,113,
9700,808,63,43,106,
9701,818,43,65,108,
9702,764,59,39,98,
9703,790,74,46,120,
9704,799,46,56,102,
9705,837,60,43,103,
9706,826,55,52,107,
9707,831,69,43,112,
9708,835,46,54,100,
9709,863,66,45,111,
9710,808,70,50,120,
9711,833,54,56,110,
9712,873,57,53,110,
9713,843,66,49,115,
9714,798,68,36,104,
9715,816,48,50,98,
9716,825,56,55,111,
9717,838,53,44,97,
9718,803,50,54,104,
9719,813,54,46,100,
9720,839,70,44,114,
9721,817,76,40,116,
9722,840,68,45,113,
9723,844,50,53,103,
9724,845,61,46,107,
9725,798,66,46,112,
9726,843,56,43,99,
9727,801,40,39,79,
9728,801,68,41,109,
9729,812,58,47,105,
9730,797,57,49,106,
9731,849,58,56,114,
9732,796,58,30,88,
9733,843,67,42,109,
9734,829,69,42,111,
9735,785,53,39,92,
9736,838,64,39,103,
9737,804,65,43,108,
9738,807,60,55,115,
9739,850,66,43,109,
9740,859,63,47,110,
9741,835,63,57,120,
9742,837,53,43,96,
9743,797,63,46,109,
9744,828,64,52,116,
9745,823,62,42,104,
9746,823,57,56,113,
9747,828,58,42,100,
9748,827,61,46,107,
9749,912,65,48,113,
9750,808,65,46,111,
9751,842,75,51,126,
9752,818,50,55,105,
9753,806,56,55,111,
9754,795,61,45,106,
9755,820,55,40,95,
9756,836,51,42,93,
9757,794,64,49,113,
9758,820,50,37,87,
9759,896,67,42,109,
9760,841,61,48,109,
9761,829,59,48,107,
9762,782,56,47,103,
9763,774,52,44,96,
9764,778,44,43,87,
9765,835,59,52,111,
9766,801,61,33,94,
9767,845,58,47,105,
9768,809,54,50,104,
9769,862,69,59,128,
9770,790,59,53,112,
9771,818,61,46,107,
9772,790,61,46,107,
9773,843,68,46,114,
9774,849,69,34,103,
9775,825,45,54,99,
9776,815,55,42,97,
9777,853,57,57,114,
9778,799,59,50,109,
9779,804,48,47,95,
9780,811,64,60,124,
9781,807,42,54,96,
9782,828,53,50,103,
9783,804,53,51,104,
9784,805,55,35,90,
9785,848,62,44,106,
9786,787,63,45,108,
9787,824,58,47,105,
9788,828,64,46,110,
9789,840,69,56,125,
9790,854,58,55,113,
9791,811,54,36,90,
9792,872,70,47,117,
9793,855,69,50,119,
9794,831,40,64,104,
9795,855,59,41,100,
9796,850,55,46,101,
9797,817,66,39,105,
9798,820,65,59,124,
9799,810,62,32,94,
9800,837,61,52,113,
9801,918,76,61,137,
9802,806,48,40,88,
9803,779,61,39,100,
9804,774,55,53,108,
9805,879,50,44,94,
9806,832,47,38,85,
9807,827,57,42,99,
9808,821,63,45,108,
9809,775,56,39,95,
9810,845,65,45,110,
9811,817,48,52,100,
9812,799,59,39,98,
9813,843,64,45,109,
9814,787,43,48,91,
9815,846,65,50,115,
9816,809,52,46,98,
9817,843,49,45,94,
9818,816,64,43,107,
9819,879,67,58,125,
9820,805,59,50,109,
9821,859,56,39,95,
9822,873,70,53,123,
9823,844,60,37,97,
9824,799,60,49,109,
9825,775,57,37,94,
9826,817,57,46,103,
9827,785,54,40,94,
9828,853,61,48,109,
9829,881,66,55,121,
9830,808,61,45,106,
9831,829,55,44,99,
9832,781,60,39,99,
9833,821,67,45,112,
9834,802,48,41,89,
9835,769,66,38,104,
9836,848,59,55,114,
9837,835,58,34,92,
9838,774,65,36,101,
9839,806,62,54,116,
9840,846,64,52,116,
9841,817,63,48,111,
9842,833,65,47,112,
9843,845,71,44,115,
9844,874,56,52,108,
9845,808,49,49,98,
9846,814,72,57,129,
9847,845,73,44,117,
9848,851,55,54,109,
9849,821,63,44,107,
9850,834,68,48,116,
9851,772,50,45,95,
9852,786,59,44,103,
9853,791,56,50,106,
9854,834,61,47,108,
9855,846,54,55,109,
9856,777,55,39,94,
9857,838,68,48,116,
9858,801,56,50,106,
9859,830,63,58,121,
9860,785,60,48,108,
9861,843,62,43,105,
9862,825,55,51,106,
9863,786,52,46,98,
9864,822,63,46,109,
9865,855,62,38,100,
9866,824,47,50,97,
9867,832,66,42,108,
9868,826,55,51,106,
9869,833,45,51,96,
9870,821,59,44,103,
9871,825,67,51,118,
9872,831,69,54,123,
9873,795,55,48,103,
9874,847,70,44,114,
9875,850,67,47,114,
9876,774,45,38,83,
9877,842,54,43,97,
9878,835,69,43,112,
9879,897,73,45,118,
9880,837,57,46,103,
9881,827,45,40,85,
9882,873,61,53,114,
9883,784,55,46,101,
9884,876,78,44,122,
9885,757,57,48,105,
9886,899,70,47,117,
9887,808,42,45,87,
9888,794,79,42,121,
9889,793,66,50,116,
9890,826,52,45,97,
9891,814,55,49,104,
9892,820,47,50,97,
9893,821,74,47,121,
9894,831,51,42,93,
9895,838,63,46,109,
9896,839,73,43,116,
9897,814,54,48,102,
9898,819,71,44,115,
9899,796,48,42,90,
9900,842,55,34,89,
9901,854,56,49,105,
9902,847,69,50,119,
9903,840,59,51,110,
9904,859,69,57,126,
9905,786,62,49,111,
9906,795,59,39,98,
9907,831,63,42,105,
9908,807,60,55,115,
9909,847,71,50,121,
9910,816,41,42,83,
9911,830,54,47,101,
9912,830,58,44,102,
9913,839,58,53,111,
9914,906,66,48,114,
9915,806,48,43,91,
9916,879,55,44,99,
9917,856,56,56,112,
9918,800,78,51,129,
9919,791,67,47,114,
9920,804,61,43,104,
9921,831,57,45,102,
9922,808,56,48,104,
9923,820,56,50,106,
9924,849,60,55,115,
9925,790,55,60,115,
9926,832,59,50,109,
9927,837,54,49,103,
9928,836,51,47,98,
9929,846,60,37,97,
9930,815,57,37,94,
9931,791,61,51,112,
9932,854,53,43,96,
9933,885,69,54,123,
9934,804,52,48,100,
9935,823,55,46,101,
9936,803,50,56,106,
9937,838,62,55,117,
9938,777,49,56,105,
9939,797,54,44,98,
9940,807,68,45,113,
9941,827,51,45,96,
9942,825,63,53,116,
9943,831,64,45,109,
9944,912,75,67,142,
9945,770,57,44,101,
9946,845,67,42,109,
9947,782,59,47,106,
9948,815,69,39,108,
9949,801,60,46,106,
9950,835,69,60,129,
9951,870,50,50,100,
9952,838,58,57,115,
9953,811,60,51,111,
9954,833,56,40,96,
9955,858,58,48,106,
9956,806,47,52,99,
9957,816,52,39,91,
9958,811,52,54,106,
9959,875,75,63,138,
9960,828,50,45,95,
9961,869,64,60,124,
9962,844,56,35,91,
9963,843,37,57,94,
9964,809,59,54,113,
9965,848,63,43,106,
9966,861,60,54,114,
9967,808,69,50,119,
9968,833,70,45,115,
9969,864,66,46,112,
9970,868,54,48,102,
9971,817,61,37,98,
9972,821,66,57,123,
9973,830,68,51,119,
9974,794,50,49,99,
9975,824,64,51,115,
9976,777,56,46,102,
9977,878,62,46,108,
9978,849,62,49,111,
9979,857,64,42,106,
9980,834,66,49,115,
9981,784,60,45,105,
9982,858,51,57,108,
9983,833,64,50,114,
9984,775,50,44,94,
9985,801,54,42,96,
9986,790,56,40,96,
9987,846,65,39,104,
9988,865,70,42,112,
9989,836,60,48,108,
9990,848,57,42,99,
9991,838,64,43,107,
9992,797,57,34,91,
9993,815,53,48,101,
9994,770,61,50,111,
9995,775,55,47,102,
9996,809,61,49,110,
9997,842,72,57,129,
9998,786,45,45,90,
9999,864,71,45,116,
