eventID,numPhotons,numReachedDown,numReachedUp,numPE,
0,300,19,13,32,
1,288,21,13,34,
2,304,19,16,35,
3,309,26,22,48,
4,325,30,16,46,
5,304,27,16,43,
6,285,19,14,33,
7,308,22,17,39,
8,290,19,14,33,
9,279,20,16,36,
10,282,18,22,40,
11,302,22,18,40,
12,315,25,18,43,
13,263,18,9,27,
14,260,28,15,43,
15,260,19,19,38,
16,313,32,12,44,
17,308,25,17,42,
18,303,13,22,35,
19,276,23,26,49,
20,304,29,21,50,
21,290,20,12,32,
22,324,26,20,46,
23,279,13,15,28,
24,307,32,25,57,
25,292,28,20,48,
26,328,22,19,41,
27,285,11,17,28,
28,278,13,18,31,
29,299,30,8,38,
30,313,13,15,28,
31,294,25,18,43,
32,288,19,17,36,
33,278,17,16,33,
34,307,16,16,32,
35,328,22,17,39,
36,301,16,13,29,
37,303,28,17,45,
38,324,21,22,43,
39,287,10,21,31,
40,305,18,25,43,
41,292,28,12,40,
42,287,22,14,36,
43,285,27,13,40,
44,300,18,21,39,
45,318,24,18,42,
46,333,31,14,45,
47,312,22,16,38,
48,290,22,20,42,
49,277,20,13,33,
50,275,21,10,31,
51,296,22,13,35,
52,281,20,11,31,
53,276,22,11,33,
54,285,24,14,38,
55,292,20,25,45,
56,301,18,20,38,
57,289,23,20,43,
58,268,26,16,42,
59,306,29,15,44,
60,335,23,24,47,
61,295,13,22,35,
62,297,17,10,27,
63,304,22,17,39,
64,295,16,23,39,
65,277,24,18,42,
66,302,28,16,44,
67,301,26,18,44,
68,303,21,15,36,
69,286,29,11,40,
70,311,29,18,47,
71,288,20,15,35,
72,296,26,15,41,
73,290,21,15,36,
74,299,24,21,45,
75,283,22,14,36,
76,287,26,13,39,
77,306,16,10,26,
78,290,21,14,35,
79,303,21,13,34,
80,288,13,14,27,
81,307,23,17,40,
82,292,18,18,36,
83,303,19,10,29,
84,305,27,12,39,
85,302,14,21,35,
86,262,17,9,26,
87,296,14,9,23,
88,280,18,13,31,
89,318,18,20,38,
90,286,22,8,30,
91,293,26,10,36,
92,293,25,16,41,
93,317,19,22,41,
94,291,18,20,38,
95,277,22,16,38,
96,294,16,15,31,
97,307,26,21,47,
98,278,13,18,31,
99,294,24,12,36,
100,333,24,17,41,
101,315,22,16,38,
102,299,13,15,28,
103,291,18,7,25,
104,300,25,18,43,
105,271,19,15,34,
106,295,26,20,46,
107,291,26,10,36,
108,324,27,18,45,
109,298,17,12,29,
110,326,15,16,31,
111,344,27,25,52,
112,291,22,18,40,
113,323,31,22,53,
114,293,19,18,37,
115,304,34,22,56,
116,315,23,15,38,
117,267,18,22,40,
118,294,18,14,32,
119,266,20,13,33,
120,317,32,21,53,
121,283,21,18,39,
122,299,26,19,45,
123,273,16,13,29,
124,275,26,11,37,
125,296,23,21,44,
126,286,15,18,33,
127,279,19,15,34,
128,312,17,14,31,
129,289,24,17,41,
130,269,22,6,28,
131,294,18,16,34,
132,274,25,10,35,
133,297,20,19,39,
134,310,22,12,34,
135,291,33,17,50,
136,338,17,21,38,
137,297,22,17,39,
138,304,23,19,42,
139,264,26,15,41,
140,299,17,17,34,
141,285,26,17,43,
142,337,27,23,50,
143,313,14,15,29,
144,323,26,20,46,
145,308,29,11,40,
146,288,28,14,42,
147,308,33,19,52,
148,289,22,27,49,
149,286,21,18,39,
150,316,32,20,52,
151,304,21,15,36,
152,309,19,24,43,
153,285,21,20,41,
154,315,20,21,41,
155,303,24,13,37,
156,282,25,14,39,
157,267,13,11,24,
158,326,18,22,40,
159,311,30,15,45,
160,313,20,17,37,
161,280,22,22,44,
162,298,26,10,36,
163,266,20,15,35,
164,298,26,14,40,
165,288,19,21,40,
166,297,20,17,37,
167,328,28,13,41,
168,321,21,22,43,
169,289,19,10,29,
170,294,24,14,38,
171,301,30,16,46,
172,315,25,11,36,
173,293,17,22,39,
174,331,26,21,47,
175,298,22,27,49,
176,306,21,20,41,
177,278,18,22,40,
178,309,21,17,38,
179,295,23,14,37,
180,260,21,11,32,
181,238,18,11,29,
182,298,22,23,45,
183,308,14,20,34,
184,294,25,10,35,
185,285,23,17,40,
186,289,22,10,32,
187,290,18,17,35,
188,320,20,18,38,
189,305,18,8,26,
190,292,17,11,28,
191,309,18,13,31,
192,276,15,12,27,
193,329,19,21,40,
194,299,29,18,47,
195,282,24,10,34,
196,273,15,16,31,
197,276,23,5,28,
198,299,19,19,38,
199,318,26,21,47,
200,295,23,21,44,
201,283,28,8,36,
202,280,23,11,34,
203,300,18,17,35,
204,286,26,23,49,
205,298,14,19,33,
206,277,18,21,39,
207,298,31,22,53,
208,294,21,13,34,
209,313,17,24,41,
210,283,16,8,24,
211,300,25,12,37,
212,275,26,14,40,
213,313,24,19,43,
214,287,22,15,37,
215,315,17,14,31,
216,293,16,10,26,
217,305,24,22,46,
218,300,16,19,35,
219,284,21,23,44,
220,276,23,19,42,
221,306,19,14,33,
222,300,23,15,38,
223,271,20,12,32,
224,310,19,24,43,
225,295,23,20,43,
226,308,23,15,38,
227,311,29,9,38,
228,285,21,26,47,
229,287,20,17,37,
230,326,19,17,36,
231,296,29,17,46,
232,330,15,21,36,
233,315,25,22,47,
234,274,20,22,42,
235,317,21,24,45,
236,286,14,22,36,
237,286,16,17,33,
238,278,16,10,26,
239,286,27,16,43,
240,304,21,17,38,
241,288,20,15,35,
242,317,22,18,40,
243,313,22,19,41,
244,305,20,16,36,
245,270,22,15,37,
246,318,6,20,26,
247,303,24,17,41,
248,287,28,21,49,
249,289,29,19,48,
250,276,22,16,38,
251,299,23,15,38,
252,335,26,14,40,
253,301,28,20,48,
254,295,27,14,41,
255,325,27,22,49,
256,301,20,21,41,
257,309,27,23,50,
258,373,30,14,44,
259,319,28,17,45,
260,293,29,10,39,
261,271,26,18,44,
262,347,25,20,45,
263,314,24,17,41,
264,303,18,13,31,
265,283,25,16,41,
266,314,30,15,45,
267,303,14,22,36,
268,287,20,20,40,
269,331,24,19,43,
270,262,17,9,26,
271,281,19,15,34,
272,317,24,24,48,
273,294,18,20,38,
274,293,24,16,40,
275,291,24,17,41,
276,312,27,16,43,
277,279,23,14,37,
278,295,22,13,35,
279,307,23,10,33,
280,293,18,10,28,
281,281,23,19,42,
282,299,20,16,36,
283,275,18,16,34,
284,325,16,12,28,
285,303,17,24,41,
286,279,15,13,28,
287,291,15,17,32,
288,305,22,16,38,
289,314,18,15,33,
290,302,15,17,32,
291,285,21,19,40,
292,336,29,14,43,
293,274,16,12,28,
294,318,28,16,44,
295,306,31,7,38,
296,320,24,20,44,
297,291,24,25,49,
298,316,23,18,41,
299,285,17,14,31,
300,287,25,16,41,
301,318,41,20,61,
302,283,19,11,30,
303,259,21,10,31,
304,321,27,27,54,
305,290,17,16,33,
306,318,23,14,37,
307,310,26,18,44,
308,280,24,16,40,
309,299,20,23,43,
310,308,26,11,37,
311,323,8,17,25,
312,295,25,16,41,
313,271,25,17,42,
314,310,17,17,34,
315,267,12,17,29,
316,314,22,14,36,
317,307,22,18,40,
318,334,23,12,35,
319,309,20,13,33,
320,289,20,17,37,
321,282,25,13,38,
322,303,31,19,50,
323,299,27,15,42,
324,263,19,18,37,
325,302,20,25,45,
326,296,16,23,39,
327,319,27,17,44,
328,288,17,17,34,
329,276,24,17,41,
330,285,21,16,37,
331,292,26,21,47,
332,301,26,14,40,
333,290,25,20,45,
334,266,24,12,36,
335,321,26,19,45,
336,280,24,12,36,
337,311,19,12,31,
338,308,28,23,51,
339,263,17,16,33,
340,275,18,22,40,
341,278,16,12,28,
342,313,25,27,52,
343,308,22,20,42,
344,277,13,13,26,
345,288,22,15,37,
346,286,16,12,28,
347,307,18,17,35,
348,288,20,16,36,
349,313,21,18,39,
350,302,20,13,33,
351,307,20,21,41,
352,289,22,11,33,
353,312,28,14,42,
354,298,20,18,38,
355,306,31,26,57,
356,307,25,13,38,
357,314,26,18,44,
358,323,20,20,40,
359,293,21,13,34,
360,335,24,11,35,
361,270,23,16,39,
362,304,20,9,29,
363,254,19,15,34,
364,272,19,18,37,
365,308,20,8,28,
366,310,22,16,38,
367,283,23,16,39,
368,301,19,22,41,
369,315,15,14,29,
370,281,18,18,36,
371,295,28,19,47,
372,317,33,15,48,
373,303,19,13,32,
374,304,15,18,33,
375,287,21,19,40,
376,267,19,12,31,
377,312,20,14,34,
378,291,22,14,36,
379,303,19,15,34,
380,306,16,22,38,
381,315,18,24,42,
382,313,13,17,30,
383,247,23,13,36,
384,332,25,16,41,
385,296,20,17,37,
386,307,23,23,46,
387,309,16,12,28,
388,280,20,14,34,
389,291,23,20,43,
390,296,19,17,36,
391,305,16,17,33,
392,289,14,14,28,
393,278,24,13,37,
394,280,25,18,43,
395,285,19,20,39,
396,319,18,19,37,
397,316,29,18,47,
398,277,19,8,27,
399,305,16,17,33,
400,248,18,12,30,
401,288,18,18,36,
402,283,23,12,35,
403,297,18,12,30,
404,318,22,23,45,
405,328,22,14,36,
406,294,23,13,36,
407,317,23,23,46,
408,297,24,16,40,
409,303,16,25,41,
410,287,19,20,39,
411,284,19,14,33,
412,269,28,20,48,
413,280,13,20,33,
414,294,16,21,37,
415,286,20,14,34,
416,299,29,21,50,
417,282,19,15,34,
418,283,30,15,45,
419,287,17,11,28,
420,270,18,18,36,
421,305,17,16,33,
422,300,18,18,36,
423,291,18,16,34,
424,327,22,16,38,
425,262,16,13,29,
426,303,18,18,36,
427,293,17,19,36,
428,287,28,12,40,
429,289,20,14,34,
430,308,21,18,39,
431,271,15,12,27,
432,304,22,19,41,
433,310,32,15,47,
434,335,18,21,39,
435,268,14,14,28,
436,311,22,33,55,
437,293,17,17,34,
438,325,27,19,46,
439,264,22,16,38,
440,303,24,16,40,
441,309,28,11,39,
442,297,19,15,34,
443,338,19,17,36,
444,296,25,18,43,
445,298,34,8,42,
446,303,20,17,37,
447,266,17,18,35,
448,290,19,19,38,
449,297,21,16,37,
450,299,23,32,55,
451,270,19,10,29,
452,328,24,15,39,
453,304,27,20,47,
454,298,30,18,48,
455,296,14,15,29,
456,280,18,17,35,
457,286,28,10,38,
458,279,19,20,39,
459,279,18,17,35,
460,305,16,17,33,
461,301,22,23,45,
462,300,25,12,37,
463,305,33,22,55,
464,287,24,14,38,
465,297,19,24,43,
466,301,19,24,43,
467,276,20,20,40,
468,318,18,24,42,
469,284,16,13,29,
470,277,26,16,42,
471,305,17,16,33,
472,336,20,16,36,
473,262,22,18,40,
474,278,16,19,35,
475,279,20,11,31,
476,344,19,28,47,
477,286,22,18,40,
478,276,18,13,31,
479,319,16,15,31,
480,293,22,11,33,
481,291,18,16,34,
482,273,32,7,39,
483,280,22,18,40,
484,272,18,14,32,
485,322,33,21,54,
486,284,22,17,39,
487,303,18,15,33,
488,280,24,14,38,
489,315,27,20,47,
490,307,24,23,47,
491,261,20,10,30,
492,298,15,16,31,
493,280,22,16,38,
494,284,18,16,34,
495,344,15,22,37,
496,284,26,15,41,
497,293,13,18,31,
498,283,27,16,43,
499,257,15,15,30,
500,277,19,14,33,
501,297,19,15,34,
502,318,23,19,42,
503,286,23,15,38,
504,298,21,17,38,
505,295,22,12,34,
506,245,17,13,30,
507,295,19,15,34,
508,281,20,21,41,
509,314,21,17,38,
510,274,29,5,34,
511,279,17,14,31,
512,301,25,13,38,
513,303,13,20,33,
514,276,25,14,39,
515,288,21,13,34,
516,303,23,18,41,
517,307,20,7,27,
518,295,31,16,47,
519,317,24,14,38,
520,299,25,14,39,
521,320,22,23,45,
522,291,24,14,38,
523,295,21,19,40,
524,299,20,27,47,
525,289,21,19,40,
526,301,24,15,39,
527,277,21,20,41,
528,267,17,18,35,
529,287,20,13,33,
530,309,21,15,36,
531,309,22,23,45,
532,305,26,13,39,
533,302,22,20,42,
534,294,27,19,46,
535,300,26,14,40,
536,304,27,14,41,
537,287,20,15,35,
538,338,25,21,46,
539,279,20,14,34,
540,250,19,14,33,
541,278,17,13,30,
542,306,23,19,42,
543,323,24,15,39,
544,264,19,20,39,
545,248,21,10,31,
546,307,22,17,39,
547,302,25,16,41,
548,273,21,15,36,
549,290,24,17,41,
550,285,21,13,34,
551,298,21,23,44,
552,295,23,20,43,
553,279,24,11,35,
554,312,23,15,38,
555,283,24,12,36,
556,269,24,20,44,
557,310,21,18,39,
558,272,23,18,41,
559,319,19,21,40,
560,265,28,10,38,
561,291,21,21,42,
562,310,16,16,32,
563,307,29,16,45,
564,310,23,9,32,
565,278,11,13,24,
566,279,12,19,31,
567,356,26,13,39,
568,296,21,16,37,
569,262,21,16,37,
570,327,29,18,47,
571,292,21,13,34,
572,298,19,19,38,
573,262,30,15,45,
574,348,22,22,44,
575,336,33,13,46,
576,283,19,22,41,
577,289,19,16,35,
578,298,29,19,48,
579,297,16,17,33,
580,280,16,14,30,
581,294,23,13,36,
582,291,18,25,43,
583,304,18,20,38,
584,256,21,17,38,
585,298,21,7,28,
586,322,21,15,36,
587,329,28,26,54,
588,327,24,15,39,
589,290,22,17,39,
590,292,28,16,44,
591,278,25,22,47,
592,279,28,13,41,
593,324,25,16,41,
594,304,22,24,46,
595,292,21,13,34,
596,277,23,15,38,
597,302,19,17,36,
598,283,23,16,39,
599,305,22,13,35,
600,312,17,23,40,
601,273,28,17,45,
602,298,20,16,36,
603,283,19,14,33,
604,294,17,18,35,
605,265,18,12,30,
606,321,29,19,48,
607,305,25,20,45,
608,302,24,23,47,
609,299,22,17,39,
610,293,25,17,42,
611,281,20,17,37,
612,265,23,16,39,
613,254,15,19,34,
614,330,21,19,40,
615,264,17,10,27,
616,311,20,16,36,
617,300,20,20,40,
618,280,22,16,38,
619,277,24,24,48,
620,276,12,21,33,
621,299,22,13,35,
622,274,16,16,32,
623,330,36,22,58,
624,255,23,11,34,
625,307,23,17,40,
626,290,18,14,32,
627,336,36,16,52,
628,310,26,13,39,
629,315,24,20,44,
630,299,17,18,35,
631,281,20,8,28,
632,321,22,22,44,
633,343,20,21,41,
634,303,32,16,48,
635,305,14,18,32,
636,330,20,14,34,
637,291,25,11,36,
638,320,26,25,51,
639,304,19,18,37,
640,318,23,22,45,
641,302,22,14,36,
642,303,22,19,41,
643,300,27,15,42,
644,332,18,17,35,
645,274,21,16,37,
646,298,22,14,36,
647,296,16,23,39,
648,315,32,14,46,
649,318,16,24,40,
650,251,6,14,20,
651,304,21,14,35,
652,297,29,13,42,
653,288,22,14,36,
654,273,20,22,42,
655,307,31,19,50,
656,297,19,19,38,
657,294,17,14,31,
658,279,22,17,39,
659,284,22,16,38,
660,261,29,14,43,
661,315,26,15,41,
662,275,21,16,37,
663,299,25,15,40,
664,275,25,13,38,
665,300,18,16,34,
666,316,23,16,39,
667,289,13,12,25,
668,297,29,23,52,
669,329,13,21,34,
670,297,17,13,30,
671,259,18,15,33,
672,290,23,12,35,
673,317,25,15,40,
674,325,24,25,49,
675,303,19,14,33,
676,324,23,12,35,
677,292,20,15,35,
678,283,22,17,39,
679,294,27,17,44,
680,287,22,19,41,
681,309,24,12,36,
682,312,18,17,35,
683,327,22,16,38,
684,288,23,24,47,
685,294,20,17,37,
686,286,18,12,30,
687,279,21,17,38,
688,267,20,13,33,
689,300,23,18,41,
690,308,31,20,51,
691,263,15,10,25,
692,340,30,22,52,
693,277,17,25,42,
694,323,36,13,49,
695,286,17,26,43,
696,313,21,20,41,
697,286,23,20,43,
698,310,22,13,35,
699,304,21,19,40,
700,286,21,24,45,
701,311,23,15,38,
702,300,17,13,30,
703,313,20,21,41,
704,272,18,15,33,
705,331,24,15,39,
706,286,23,12,35,
707,296,22,15,37,
708,304,20,17,37,
709,305,22,11,33,
710,263,19,13,32,
711,298,22,17,39,
712,294,19,14,33,
713,303,21,13,34,
714,280,22,19,41,
715,341,28,22,50,
716,285,19,16,35,
717,257,22,20,42,
718,300,24,16,40,
719,287,25,21,46,
720,290,20,17,37,
721,319,26,18,44,
722,280,9,12,21,
723,314,18,16,34,
724,288,22,7,29,
725,277,17,20,37,
726,283,22,14,36,
727,321,29,20,49,
728,306,22,10,32,
729,284,18,11,29,
730,330,24,23,47,
731,290,28,19,47,
732,283,20,17,37,
733,269,14,11,25,
734,342,30,18,48,
735,314,22,20,42,
736,297,20,11,31,
737,294,14,12,26,
738,300,31,7,38,
739,295,18,16,34,
740,289,26,13,39,
741,282,20,20,40,
742,293,15,18,33,
743,286,17,19,36,
744,297,17,13,30,
745,281,18,10,28,
746,297,24,26,50,
747,287,16,13,29,
748,301,12,14,26,
749,311,25,15,40,
750,309,10,16,26,
751,275,28,14,42,
752,268,17,23,40,
753,279,24,18,42,
754,305,20,21,41,
755,296,28,16,44,
756,271,18,14,32,
757,294,26,18,44,
758,345,26,20,46,
759,312,15,13,28,
760,303,26,20,46,
761,342,27,23,50,
762,326,22,21,43,
763,270,22,10,32,
764,298,21,13,34,
765,279,33,9,42,
766,306,17,12,29,
767,277,14,16,30,
768,304,22,10,32,
769,334,22,17,39,
770,299,21,13,34,
771,286,24,16,40,
772,275,18,11,29,
773,306,21,16,37,
774,320,27,19,46,
775,307,24,17,41,
776,297,25,13,38,
777,293,23,15,38,
778,340,28,19,47,
779,304,24,9,33,
780,301,10,23,33,
781,278,25,15,40,
782,287,19,11,30,
783,291,23,21,44,
784,284,20,17,37,
785,269,21,10,31,
786,295,23,18,41,
787,307,16,19,35,
788,285,28,17,45,
789,295,28,24,52,
790,369,29,19,48,
791,297,17,15,32,
792,276,23,10,33,
793,290,23,24,47,
794,281,20,8,28,
795,314,18,19,37,
796,298,27,14,41,
797,295,20,22,42,
798,291,27,13,40,
799,292,14,18,32,
800,325,24,18,42,
801,286,24,19,43,
802,306,26,16,42,
803,283,17,23,40,
804,277,16,19,35,
805,325,18,15,33,
806,313,31,14,45,
807,301,26,20,46,
808,277,22,21,43,
809,305,20,16,36,
810,292,18,11,29,
811,340,25,23,48,
812,302,15,13,28,
813,279,17,17,34,
814,277,22,12,34,
815,303,31,22,53,
816,288,18,23,41,
817,272,12,11,23,
818,329,36,19,55,
819,300,20,13,33,
820,274,17,15,32,
821,282,25,13,38,
822,311,21,23,44,
823,289,21,26,47,
824,308,17,23,40,
825,284,22,19,41,
826,330,22,25,47,
827,285,14,15,29,
828,307,28,16,44,
829,271,18,17,35,
830,303,22,14,36,
831,294,16,26,42,
832,298,18,22,40,
833,306,20,22,42,
834,292,16,7,23,
835,285,21,13,34,
836,312,27,15,42,
837,311,25,8,33,
838,304,21,15,36,
839,276,16,21,37,
840,276,17,15,32,
841,300,25,15,40,
842,295,16,21,37,
843,301,9,18,27,
844,299,28,17,45,
845,292,20,14,34,
846,296,23,13,36,
847,318,21,14,35,
848,276,23,15,38,
849,307,23,22,45,
850,288,23,19,42,
851,295,22,16,38,
852,284,15,22,37,
853,263,21,18,39,
854,306,24,12,36,
855,280,18,22,40,
856,286,26,9,35,
857,312,22,20,42,
858,314,19,15,34,
859,309,27,20,47,
860,301,20,24,44,
861,336,20,23,43,
862,270,28,14,42,
863,302,22,17,39,
864,287,27,23,50,
865,306,25,19,44,
866,312,25,25,50,
867,287,22,23,45,
868,283,25,19,44,
869,281,21,19,40,
870,316,23,14,37,
871,282,18,20,38,
872,308,26,27,53,
873,314,15,14,29,
874,297,24,15,39,
875,320,23,20,43,
876,279,18,18,36,
877,292,22,10,32,
878,304,27,21,48,
879,294,27,11,38,
880,318,25,19,44,
881,280,11,22,33,
882,307,26,13,39,
883,299,15,14,29,
884,324,29,17,46,
885,296,20,12,32,
886,322,19,27,46,
887,299,19,24,43,
888,322,23,15,38,
889,297,19,20,39,
890,314,25,21,46,
891,311,29,23,52,
892,269,15,20,35,
893,285,22,15,37,
894,310,16,17,33,
895,266,18,14,32,
896,283,21,14,35,
897,291,25,17,42,
898,302,19,13,32,
899,309,16,19,35,
900,300,19,16,35,
901,293,17,17,34,
902,279,21,14,35,
903,288,21,16,37,
904,281,22,7,29,
905,328,25,24,49,
906,313,21,23,44,
907,291,19,18,37,
908,300,22,16,38,
909,310,30,13,43,
910,303,24,23,47,
911,292,19,10,29,
912,292,25,18,43,
913,330,27,19,46,
914,275,19,16,35,
915,296,27,19,46,
916,280,13,14,27,
917,311,24,19,43,
918,294,21,18,39,
919,307,23,16,39,
920,287,23,13,36,
921,305,24,22,46,
922,271,22,12,34,
923,308,26,12,38,
924,277,21,15,36,
925,298,24,22,46,
926,317,22,15,37,
927,281,21,17,38,
928,278,23,14,37,
929,304,29,18,47,
930,284,26,16,42,
931,326,30,18,48,
932,287,17,18,35,
933,302,24,15,39,
934,279,21,13,34,
935,341,23,22,45,
936,279,12,12,24,
937,312,25,13,38,
938,277,19,14,33,
939,310,29,18,47,
940,277,22,17,39,
941,326,32,12,44,
942,282,26,16,42,
943,277,24,7,31,
944,310,21,16,37,
945,273,22,20,42,
946,337,23,13,36,
947,285,25,13,38,
948,310,29,20,49,
949,279,19,13,32,
950,306,18,17,35,
951,281,22,17,39,
952,266,10,12,22,
953,321,19,16,35,
954,312,23,21,44,
955,280,15,10,25,
956,317,24,21,45,
957,308,25,10,35,
958,328,20,17,37,
959,314,23,18,41,
960,284,25,15,40,
961,293,20,17,37,
962,300,16,15,31,
963,287,21,20,41,
964,314,20,13,33,
965,301,25,17,42,
966,288,19,16,35,
967,274,19,15,34,
968,273,21,19,40,
969,328,26,16,42,
970,352,24,19,43,
971,285,21,20,41,
972,291,18,19,37,
973,345,23,25,48,
974,314,32,27,59,
975,295,19,15,34,
976,255,18,14,32,
977,286,21,15,36,
978,296,26,14,40,
979,267,15,17,32,
980,306,24,14,38,
981,291,19,13,32,
982,299,15,19,34,
983,260,24,16,40,
984,316,17,19,36,
985,295,23,13,36,
986,297,25,11,36,
987,305,18,19,37,
988,279,21,20,41,
989,303,27,14,41,
990,301,24,13,37,
991,275,26,12,38,
992,309,26,17,43,
993,298,19,20,39,
994,290,21,19,40,
995,313,23,17,40,
996,286,21,20,41,
997,308,17,22,39,
998,322,25,19,44,
999,290,19,16,35,
1000,317,30,17,47,
1001,339,21,17,38,
1002,287,19,13,32,
1003,309,19,17,36,
1004,289,26,15,41,
1005,287,25,18,43,
1006,305,23,21,44,
1007,261,21,12,33,
1008,281,21,15,36,
1009,286,26,18,44,
1010,289,23,15,38,
1011,310,27,19,46,
1012,329,28,17,45,
1013,284,30,22,52,
1014,274,22,17,39,
1015,320,17,17,34,
1016,282,23,19,42,
1017,291,18,14,32,
1018,259,15,14,29,
1019,324,29,19,48,
1020,324,26,20,46,
1021,287,35,21,56,
1022,302,22,21,43,
1023,281,20,11,31,
1024,298,20,16,36,
1025,310,19,12,31,
1026,293,21,19,40,
1027,297,23,19,42,
1028,316,17,14,31,
1029,302,24,17,41,
1030,334,23,29,52,
1031,308,20,20,40,
1032,293,20,14,34,
1033,312,31,18,49,
1034,302,23,21,44,
1035,291,27,14,41,
1036,270,18,16,34,
1037,297,24,17,41,
1038,296,21,13,34,
1039,321,33,18,51,
1040,292,26,13,39,
1041,271,22,18,40,
1042,299,30,17,47,
1043,295,20,21,41,
1044,308,23,20,43,
1045,325,28,14,42,
1046,297,20,16,36,
1047,304,30,26,56,
1048,305,18,14,32,
1049,250,25,15,40,
1050,303,22,18,40,
1051,314,25,18,43,
1052,298,23,20,43,
1053,291,25,14,39,
1054,304,16,14,30,
1055,264,16,21,37,
1056,293,22,16,38,
1057,306,26,19,45,
1058,311,25,16,41,
1059,320,23,18,41,
1060,297,26,23,49,
1061,309,17,23,40,
1062,305,34,17,51,
1063,313,22,13,35,
1064,313,26,17,43,
1065,270,11,10,21,
1066,302,27,7,34,
1067,305,28,18,46,
1068,310,26,12,38,
1069,297,27,16,43,
1070,300,22,18,40,
1071,288,25,20,45,
1072,319,29,18,47,
1073,274,18,18,36,
1074,309,22,18,40,
1075,268,17,13,30,
1076,280,19,14,33,
1077,278,17,20,37,
1078,300,21,11,32,
1079,306,23,16,39,
1080,274,14,26,40,
1081,291,13,20,33,
1082,298,19,22,41,
1083,305,21,16,37,
1084,302,21,21,42,
1085,285,23,15,38,
1086,292,20,17,37,
1087,275,18,16,34,
1088,270,16,15,31,
1089,300,20,19,39,
1090,290,22,8,30,
1091,288,28,15,43,
1092,315,37,12,49,
1093,280,19,19,38,
1094,283,20,13,33,
1095,272,22,16,38,
1096,310,26,11,37,
1097,311,34,19,53,
1098,279,15,18,33,
1099,300,26,14,40,
1100,277,26,26,52,
1101,293,17,16,33,
1102,303,23,14,37,
1103,287,15,19,34,
1104,276,19,24,43,
1105,283,14,16,30,
1106,268,19,14,33,
1107,306,27,10,37,
1108,269,13,16,29,
1109,261,25,14,39,
1110,301,20,14,34,
1111,261,15,21,36,
1112,286,17,11,28,
1113,302,25,14,39,
1114,309,21,26,47,
1115,296,19,9,28,
1116,302,19,17,36,
1117,300,25,21,46,
1118,296,27,14,41,
1119,308,28,13,41,
1120,310,31,31,62,
1121,293,25,11,36,
1122,270,20,11,31,
1123,317,25,27,52,
1124,307,18,16,34,
1125,316,22,16,38,
1126,291,22,15,37,
1127,297,20,7,27,
1128,314,14,21,35,
1129,308,21,17,38,
1130,289,19,11,30,
1131,297,27,13,40,
1132,330,16,21,37,
1133,292,30,11,41,
1134,310,28,20,48,
1135,275,23,14,37,
1136,336,25,20,45,
1137,298,24,10,34,
1138,285,22,10,32,
1139,291,26,12,38,
1140,298,30,18,48,
1141,307,23,13,36,
1142,274,20,18,38,
1143,303,16,23,39,
1144,280,18,19,37,
1145,318,22,15,37,
1146,361,22,19,41,
1147,257,16,22,38,
1148,268,13,17,30,
1149,334,31,19,50,
1150,310,20,16,36,
1151,291,26,16,42,
1152,312,19,21,40,
1153,280,17,17,34,
1154,344,23,22,45,
1155,314,22,17,39,
1156,298,21,16,37,
1157,305,28,23,51,
1158,300,19,16,35,
1159,286,21,16,37,
1160,282,13,20,33,
1161,289,19,24,43,
1162,305,21,19,40,
1163,303,18,14,32,
1164,319,22,25,47,
1165,317,17,17,34,
1166,323,22,13,35,
1167,321,20,25,45,
1168,290,18,18,36,
1169,282,17,18,35,
1170,314,23,18,41,
1171,278,20,13,33,
1172,303,25,18,43,
1173,307,30,16,46,
1174,312,25,20,45,
1175,302,14,23,37,
1176,289,21,15,36,
1177,302,28,18,46,
1178,300,25,17,42,
1179,283,17,10,27,
1180,322,25,20,45,
1181,282,25,19,44,
1182,299,22,15,37,
1183,309,13,18,31,
1184,285,17,15,32,
1185,301,21,19,40,
1186,322,24,19,43,
1187,307,26,24,50,
1188,310,17,20,37,
1189,305,21,18,39,
1190,309,27,7,34,
1191,310,22,24,46,
1192,314,23,16,39,
1193,296,24,18,42,
1194,301,25,19,44,
1195,279,15,20,35,
1196,307,16,9,25,
1197,307,20,15,35,
1198,271,18,21,39,
1199,320,19,18,37,
1200,291,23,23,46,
1201,277,27,18,45,
1202,311,18,9,27,
1203,324,20,17,37,
1204,304,16,14,30,
1205,295,23,11,34,
1206,308,22,16,38,
1207,327,17,22,39,
1208,307,15,17,32,
1209,285,24,20,44,
1210,272,24,12,36,
1211,288,23,21,44,
1212,276,16,10,26,
1213,297,19,11,30,
1214,305,19,16,35,
1215,301,22,21,43,
1216,302,17,22,39,
1217,281,24,15,39,
1218,295,16,18,34,
1219,305,29,19,48,
1220,280,26,14,40,
1221,293,24,20,44,
1222,299,15,15,30,
1223,266,17,13,30,
1224,267,27,22,49,
1225,301,15,27,42,
1226,270,21,13,34,
1227,330,23,13,36,
1228,329,18,17,35,
1229,239,13,13,26,
1230,315,23,18,41,
1231,303,21,19,40,
1232,316,21,24,45,
1233,320,24,18,42,
1234,328,22,10,32,
1235,320,21,13,34,
1236,287,20,12,32,
1237,318,23,16,39,
1238,322,18,18,36,
1239,336,32,16,48,
1240,319,26,20,46,
1241,304,34,14,48,
1242,298,17,16,33,
1243,269,23,15,38,
1244,295,27,14,41,
1245,275,22,18,40,
1246,290,25,20,45,
1247,264,15,15,30,
1248,323,20,14,34,
1249,323,19,22,41,
1250,330,18,18,36,
1251,274,15,18,33,
1252,274,16,11,27,
1253,301,22,17,39,
1254,283,19,20,39,
1255,295,28,17,45,
1256,299,14,11,25,
1257,289,23,14,37,
1258,323,29,14,43,
1259,289,16,20,36,
1260,282,16,15,31,
1261,276,20,11,31,
1262,270,20,22,42,
1263,321,25,19,44,
1264,308,15,12,27,
1265,293,22,13,35,
1266,293,19,19,38,
1267,297,20,21,41,
1268,277,28,11,39,
1269,290,28,14,42,
1270,292,10,20,30,
1271,325,30,20,50,
1272,286,29,14,43,
1273,293,25,8,33,
1274,298,24,15,39,
1275,274,20,13,33,
1276,277,29,18,47,
1277,280,20,23,43,
1278,308,16,25,41,
1279,304,29,22,51,
1280,267,23,23,46,
1281,295,29,20,49,
1282,308,26,16,42,
1283,301,25,20,45,
1284,288,25,10,35,
1285,261,19,9,28,
1286,256,13,16,29,
1287,304,21,15,36,
1288,303,22,12,34,
1289,294,18,13,31,
1290,303,25,21,46,
1291,277,16,9,25,
1292,292,21,12,33,
1293,314,24,21,45,
1294,312,18,19,37,
1295,279,14,18,32,
1296,302,23,17,40,
1297,302,25,17,42,
1298,271,28,18,46,
1299,278,22,22,44,
1300,293,17,12,29,
1301,294,14,14,28,
1302,341,25,20,45,
1303,303,27,16,43,
1304,323,25,21,46,
1305,345,25,18,43,
1306,297,20,13,33,
1307,304,19,11,30,
1308,277,16,20,36,
1309,305,22,17,39,
1310,276,21,18,39,
1311,281,19,21,40,
1312,290,21,15,36,
1313,289,21,18,39,
1314,297,16,11,27,
1315,317,17,19,36,
1316,308,26,22,48,
1317,274,15,17,32,
1318,293,19,13,32,
1319,292,26,19,45,
1320,288,22,18,40,
1321,278,26,16,42,
1322,300,21,18,39,
1323,306,20,20,40,
1324,337,29,14,43,
1325,305,25,18,43,
1326,303,22,24,46,
1327,282,25,21,46,
1328,288,32,15,47,
1329,283,19,14,33,
1330,288,18,13,31,
1331,273,13,13,26,
1332,320,23,26,49,
1333,307,22,19,41,
1334,312,22,13,35,
1335,317,17,20,37,
1336,293,20,20,40,
1337,325,25,15,40,
1338,320,11,22,33,
1339,300,13,19,32,
1340,277,20,13,33,
1341,285,9,26,35,
1342,280,14,14,28,
1343,264,17,23,40,
1344,311,25,17,42,
1345,269,19,17,36,
1346,275,20,12,32,
1347,255,22,13,35,
1348,312,23,15,38,
1349,336,22,27,49,
1350,329,22,18,40,
1351,273,20,14,34,
1352,283,20,5,25,
1353,323,29,20,49,
1354,305,27,13,40,
1355,288,18,15,33,
1356,309,18,16,34,
1357,249,15,19,34,
1358,261,26,13,39,
1359,289,23,11,34,
1360,301,15,20,35,
1361,296,12,29,41,
1362,300,20,22,42,
1363,297,21,25,46,
1364,279,26,18,44,
1365,267,14,18,32,
1366,285,17,18,35,
1367,300,21,18,39,
1368,280,21,15,36,
1369,279,36,9,45,
1370,271,21,11,32,
1371,294,22,21,43,
1372,293,26,14,40,
1373,291,24,11,35,
1374,270,16,9,25,
1375,298,21,15,36,
1376,287,22,16,38,
1377,273,13,11,24,
1378,288,24,6,30,
1379,295,26,18,44,
1380,333,25,22,47,
1381,255,15,14,29,
1382,288,21,15,36,
1383,331,27,25,52,
1384,312,30,15,45,
1385,309,20,19,39,
1386,319,20,18,38,
1387,319,31,14,45,
1388,316,18,15,33,
1389,309,23,20,43,
1390,300,28,17,45,
1391,324,26,23,49,
1392,297,13,20,33,
1393,305,19,12,31,
1394,304,24,17,41,
1395,302,18,17,35,
1396,270,13,14,27,
1397,285,21,18,39,
1398,302,22,10,32,
1399,322,23,11,34,
1400,290,21,15,36,
1401,290,20,9,29,
1402,298,17,18,35,
1403,306,34,13,47,
1404,295,25,15,40,
1405,264,14,21,35,
1406,278,22,17,39,
1407,288,18,19,37,
1408,280,29,19,48,
1409,260,17,12,29,
1410,284,20,20,40,
1411,341,27,18,45,
1412,267,21,15,36,
1413,307,24,12,36,
1414,299,27,20,47,
1415,279,16,11,27,
1416,326,15,27,42,
1417,298,24,12,36,
1418,296,21,13,34,
1419,260,19,18,37,
1420,291,23,22,45,
1421,281,16,20,36,
1422,279,24,14,38,
1423,339,16,24,40,
1424,304,14,15,29,
1425,252,24,16,40,
1426,289,17,26,43,
1427,285,22,9,31,
1428,292,24,13,37,
1429,310,13,12,25,
1430,273,21,10,31,
1431,279,20,12,32,
1432,342,23,22,45,
1433,304,18,10,28,
1434,293,16,13,29,
1435,295,20,15,35,
1436,325,36,20,56,
1437,283,20,14,34,
1438,298,21,15,36,
1439,310,22,19,41,
1440,278,19,9,28,
1441,306,24,16,40,
1442,294,23,23,46,
1443,311,23,14,37,
1444,293,21,15,36,
1445,277,22,15,37,
1446,307,20,11,31,
1447,323,14,15,29,
1448,294,27,18,45,
1449,307,18,9,27,
1450,320,18,14,32,
1451,301,22,24,46,
1452,272,16,14,30,
1453,284,19,10,29,
1454,292,14,15,29,
1455,262,26,13,39,
1456,318,31,14,45,
1457,288,17,19,36,
1458,296,24,16,40,
1459,296,22,20,42,
1460,303,27,26,53,
1461,295,26,14,40,
1462,321,13,24,37,
1463,285,26,18,44,
1464,287,17,13,30,
1465,292,20,12,32,
1466,277,11,19,30,
1467,296,17,12,29,
1468,285,33,19,52,
1469,318,18,18,36,
1470,273,19,10,29,
1471,327,21,11,32,
1472,303,26,19,45,
1473,284,19,21,40,
1474,288,20,16,36,
1475,289,17,11,28,
1476,275,16,11,27,
1477,291,22,17,39,
1478,286,23,24,47,
1479,288,24,20,44,
1480,290,15,19,34,
1481,264,15,10,25,
1482,300,21,12,33,
1483,299,17,14,31,
1484,310,22,20,42,
1485,303,23,18,41,
1486,297,24,21,45,
1487,264,17,16,33,
1488,268,25,17,42,
1489,290,15,22,37,
1490,292,24,15,39,
1491,316,23,12,35,
1492,276,14,18,32,
1493,287,16,16,32,
1494,345,32,19,51,
1495,325,21,23,44,
1496,290,28,13,41,
1497,286,26,13,39,
1498,297,21,19,40,
1499,297,20,15,35,
1500,306,23,19,42,
1501,304,19,13,32,
1502,292,17,17,34,
1503,320,27,25,52,
1504,301,32,23,55,
1505,289,20,13,33,
1506,295,15,17,32,
1507,276,21,16,37,
1508,306,29,9,38,
1509,348,36,15,51,
1510,307,25,17,42,
1511,322,34,15,49,
1512,304,23,15,38,
1513,312,27,17,44,
1514,305,24,19,43,
1515,306,19,18,37,
1516,282,22,8,30,
1517,287,25,17,42,
1518,287,22,18,40,
1519,293,17,11,28,
1520,286,16,20,36,
1521,302,22,14,36,
1522,308,24,15,39,
1523,285,20,15,35,
1524,282,23,19,42,
1525,284,25,13,38,
1526,316,22,21,43,
1527,273,25,14,39,
1528,302,24,16,40,
1529,309,24,20,44,
1530,312,25,27,52,
1531,274,19,8,27,
1532,286,21,17,38,
1533,300,24,10,34,
1534,286,33,14,47,
1535,301,22,22,44,
1536,305,22,17,39,
1537,287,15,12,27,
1538,274,15,13,28,
1539,289,23,20,43,
1540,273,18,12,30,
1541,288,21,16,37,
1542,314,27,7,34,
1543,294,22,16,38,
1544,310,22,16,38,
1545,285,18,20,38,
1546,305,19,21,40,
1547,297,24,20,44,
1548,307,29,13,42,
1549,271,22,20,42,
1550,288,23,14,37,
1551,276,23,14,37,
1552,286,20,14,34,
1553,261,16,10,26,
1554,344,28,21,49,
1555,316,17,18,35,
1556,304,19,17,36,
1557,326,23,21,44,
1558,324,19,22,41,
1559,296,16,18,34,
1560,282,16,13,29,
1561,306,23,13,36,
1562,302,23,11,34,
1563,333,24,21,45,
1564,286,15,15,30,
1565,314,33,15,48,
1566,273,17,19,36,
1567,290,16,29,45,
1568,268,23,15,38,
1569,322,16,20,36,
1570,302,27,19,46,
1571,308,16,13,29,
1572,303,21,19,40,
1573,294,17,17,34,
1574,279,16,17,33,
1575,331,23,18,41,
1576,275,16,12,28,
1577,306,12,26,38,
1578,301,21,17,38,
1579,308,21,19,40,
1580,275,27,14,41,
1581,287,25,26,51,
1582,312,17,16,33,
1583,252,22,16,38,
1584,275,20,12,32,
1585,307,27,18,45,
1586,259,13,12,25,
1587,295,20,19,39,
1588,288,21,24,45,
1589,300,26,22,48,
1590,332,21,17,38,
1591,303,24,16,40,
1592,298,22,13,35,
1593,271,22,15,37,
1594,295,18,16,34,
1595,286,22,19,41,
1596,297,15,13,28,
1597,292,14,15,29,
1598,295,27,15,42,
1599,288,18,16,34,
1600,303,22,14,36,
1601,287,19,15,34,
1602,272,10,16,26,
1603,263,18,16,34,
1604,297,24,21,45,
1605,278,16,20,36,
1606,277,17,20,37,
1607,320,22,17,39,
1608,287,21,14,35,
1609,268,18,12,30,
1610,266,21,18,39,
1611,321,32,21,53,
1612,311,23,22,45,
1613,291,22,14,36,
1614,293,22,18,40,
1615,296,25,14,39,
1616,367,22,24,46,
1617,311,23,13,36,
1618,269,18,15,33,
1619,285,17,17,34,
1620,304,22,18,40,
1621,333,25,24,49,
1622,322,20,21,41,
1623,283,20,21,41,
1624,314,25,22,47,
1625,273,21,14,35,
1626,253,20,11,31,
1627,233,17,14,31,
1628,309,28,16,44,
1629,275,32,16,48,
1630,301,18,17,35,
1631,301,24,19,43,
1632,293,17,14,31,
1633,272,21,19,40,
1634,285,26,14,40,
1635,327,18,12,30,
1636,262,16,12,28,
1637,275,22,18,40,
1638,299,23,18,41,
1639,301,18,16,34,
1640,333,25,15,40,
1641,298,19,21,40,
1642,296,23,12,35,
1643,307,24,20,44,
1644,295,22,23,45,
1645,270,19,11,30,
1646,309,21,23,44,
1647,283,15,17,32,
1648,321,29,14,43,
1649,287,23,12,35,
1650,312,25,19,44,
1651,312,21,14,35,
1652,326,27,20,47,
1653,313,34,12,46,
1654,298,22,27,49,
1655,281,14,20,34,
1656,296,24,18,42,
1657,279,9,18,27,
1658,300,20,15,35,
1659,285,13,22,35,
1660,309,16,17,33,
1661,291,17,17,34,
1662,292,17,17,34,
1663,302,21,13,34,
1664,294,22,13,35,
1665,289,26,13,39,
1666,309,23,11,34,
1667,323,20,25,45,
1668,313,35,13,48,
1669,295,30,12,42,
1670,292,24,19,43,
1671,277,25,12,37,
1672,274,18,12,30,
1673,328,24,15,39,
1674,265,19,11,30,
1675,287,25,11,36,
1676,336,26,18,44,
1677,319,24,13,37,
1678,313,23,21,44,
1679,272,24,14,38,
1680,276,24,18,42,
1681,269,16,12,28,
1682,330,25,22,47,
1683,276,16,19,35,
1684,306,20,17,37,
1685,292,15,17,32,
1686,311,23,19,42,
1687,306,34,13,47,
1688,322,24,14,38,
1689,303,21,19,40,
1690,295,17,15,32,
1691,262,20,19,39,
1692,310,16,18,34,
1693,330,18,13,31,
1694,306,12,9,21,
1695,298,16,14,30,
1696,282,25,15,40,
1697,306,23,20,43,
1698,278,21,13,34,
1699,284,23,19,42,
1700,303,22,22,44,
1701,294,28,14,42,
1702,295,21,16,37,
1703,263,25,16,41,
1704,256,19,11,30,
1705,300,15,12,27,
1706,317,17,17,34,
1707,279,22,14,36,
1708,307,12,14,26,
1709,292,11,19,30,
1710,299,16,17,33,
1711,296,27,17,44,
1712,298,27,16,43,
1713,306,19,13,32,
1714,303,29,20,49,
1715,316,26,29,55,
1716,285,18,15,33,
1717,313,26,16,42,
1718,308,20,16,36,
1719,310,22,10,32,
1720,279,19,15,34,
1721,294,25,14,39,
1722,287,21,20,41,
1723,270,19,14,33,
1724,299,25,12,37,
1725,299,21,17,38,
1726,316,26,18,44,
1727,308,22,18,40,
1728,309,15,20,35,
1729,294,23,14,37,
1730,270,23,20,43,
1731,304,27,19,46,
1732,319,23,16,39,
1733,280,19,16,35,
1734,302,27,18,45,
1735,268,17,20,37,
1736,308,16,11,27,
1737,285,19,12,31,
1738,270,21,13,34,
1739,305,22,14,36,
1740,305,20,23,43,
1741,296,28,18,46,
1742,287,15,19,34,
1743,311,18,19,37,
1744,268,22,18,40,
1745,287,26,14,40,
1746,279,23,11,34,
1747,301,21,15,36,
1748,307,19,17,36,
1749,280,17,27,44,
1750,284,25,15,40,
1751,311,27,10,37,
1752,329,28,17,45,
1753,322,23,21,44,
1754,295,18,17,35,
1755,292,27,18,45,
1756,306,26,24,50,
1757,270,19,9,28,
1758,280,12,22,34,
1759,304,18,21,39,
1760,297,21,14,35,
1761,296,20,19,39,
1762,320,25,17,42,
1763,341,24,18,42,
1764,318,26,17,43,
1765,268,21,11,32,
1766,295,19,15,34,
1767,294,9,18,27,
1768,254,31,14,45,
1769,340,24,24,48,
1770,338,26,24,50,
1771,301,26,20,46,
1772,266,11,18,29,
1773,270,17,13,30,
1774,321,21,14,35,
1775,294,25,17,42,
1776,280,18,16,34,
1777,271,27,9,36,
1778,308,28,16,44,
1779,314,22,21,43,
1780,294,23,15,38,
1781,312,26,20,46,
1782,294,19,16,35,
1783,311,20,19,39,
1784,305,29,22,51,
1785,356,27,21,48,
1786,298,23,8,31,
1787,328,21,16,37,
1788,279,26,6,32,
1789,256,18,20,38,
1790,294,20,12,32,
1791,331,21,22,43,
1792,317,34,15,49,
1793,315,26,22,48,
1794,311,24,17,41,
1795,243,14,13,27,
1796,290,26,17,43,
1797,276,24,18,42,
1798,291,24,22,46,
1799,291,29,17,46,
1800,281,24,22,46,
1801,293,19,13,32,
1802,310,24,17,41,
1803,282,20,15,35,
1804,291,21,12,33,
1805,317,23,25,48,
1806,302,20,18,38,
1807,310,20,10,30,
1808,308,25,17,42,
1809,294,25,27,52,
1810,297,19,17,36,
1811,304,19,12,31,
1812,310,17,21,38,
1813,292,17,12,29,
1814,318,25,20,45,
1815,278,27,12,39,
1816,301,24,15,39,
1817,318,23,28,51,
1818,287,17,14,31,
1819,296,19,21,40,
1820,306,16,24,40,
1821,273,21,13,34,
1822,322,18,13,31,
1823,297,21,19,40,
1824,292,25,22,47,
1825,323,23,19,42,
1826,282,29,15,44,
1827,283,22,19,41,
1828,296,22,18,40,
1829,301,16,11,27,
1830,268,27,16,43,
1831,305,21,12,33,
1832,262,32,15,47,
1833,276,25,20,45,
1834,276,16,25,41,
1835,303,25,17,42,
1836,325,19,21,40,
1837,305,27,17,44,
1838,252,15,12,27,
1839,284,20,17,37,
1840,293,13,12,25,
1841,330,23,18,41,
1842,316,23,14,37,
1843,272,13,8,21,
1844,304,22,16,38,
1845,252,14,17,31,
1846,285,18,7,25,
1847,309,22,19,41,
1848,317,28,14,42,
1849,308,18,16,34,
1850,322,19,15,34,
1851,302,20,16,36,
1852,280,28,18,46,
1853,304,17,12,29,
1854,344,23,13,36,
1855,277,28,19,47,
1856,290,23,17,40,
1857,313,29,16,45,
1858,296,28,11,39,
1859,283,19,11,30,
1860,277,22,9,31,
1861,293,19,21,40,
1862,275,23,14,37,
1863,299,16,9,25,
1864,288,17,22,39,
1865,278,20,15,35,
1866,274,17,14,31,
1867,261,19,15,34,
1868,266,21,14,35,
1869,299,24,18,42,
1870,271,25,21,46,
1871,310,20,16,36,
1872,296,18,17,35,
1873,300,18,21,39,
1874,269,22,14,36,
1875,307,13,14,27,
1876,282,22,16,38,
1877,297,26,18,44,
1878,281,23,13,36,
1879,287,20,15,35,
1880,287,19,16,35,
1881,304,27,16,43,
1882,304,26,16,42,
1883,295,20,20,40,
1884,322,23,17,40,
1885,233,19,11,30,
1886,308,25,16,41,
1887,298,20,19,39,
1888,275,19,13,32,
1889,296,23,20,43,
1890,281,18,17,35,
1891,334,21,25,46,
1892,273,16,21,37,
1893,272,17,22,39,
1894,302,22,17,39,
1895,330,23,18,41,
1896,320,20,14,34,
1897,314,21,12,33,
1898,304,21,11,32,
1899,293,19,9,28,
1900,279,25,12,37,
1901,320,31,13,44,
1902,339,27,17,44,
1903,297,26,12,38,
1904,308,27,19,46,
1905,281,19,19,38,
1906,280,16,14,30,
1907,302,34,17,51,
1908,323,24,29,53,
1909,297,24,11,35,
1910,311,21,17,38,
1911,291,22,17,39,
1912,296,17,14,31,
1913,297,21,19,40,
1914,332,29,17,46,
1915,307,30,20,50,
1916,300,25,17,42,
1917,314,17,21,38,
1918,285,28,16,44,
1919,269,19,15,34,
1920,308,21,14,35,
1921,309,27,19,46,
1922,295,20,20,40,
1923,295,22,7,29,
1924,295,15,17,32,
1925,302,28,16,44,
1926,269,16,23,39,
1927,315,18,16,34,
1928,280,17,16,33,
1929,252,17,18,35,
1930,299,11,24,35,
1931,259,25,10,35,
1932,263,24,16,40,
1933,309,30,22,52,
1934,263,21,14,35,
1935,313,28,19,47,
1936,317,27,20,47,
1937,302,25,13,38,
1938,299,19,20,39,
1939,280,23,16,39,
1940,313,30,17,47,
1941,278,16,15,31,
1942,330,18,18,36,
1943,285,16,13,29,
1944,294,27,17,44,
1945,286,25,9,34,
1946,288,29,12,41,
1947,293,22,20,42,
1948,306,26,25,51,
1949,282,14,14,28,
1950,322,24,20,44,
1951,315,25,20,45,
1952,325,25,19,44,
1953,304,22,14,36,
1954,308,21,18,39,
1955,276,25,12,37,
1956,314,23,14,37,
1957,317,24,14,38,
1958,304,11,23,34,
1959,305,16,18,34,
1960,330,23,23,46,
1961,309,29,18,47,
1962,311,31,10,41,
1963,320,26,20,46,
1964,301,19,20,39,
1965,284,20,20,40,
1966,313,24,18,42,
1967,288,20,13,33,
1968,262,9,25,34,
1969,299,22,13,35,
1970,302,23,20,43,
1971,298,19,13,32,
1972,293,21,16,37,
1973,270,28,12,40,
1974,283,21,18,39,
1975,310,19,18,37,
1976,291,30,21,51,
1977,332,26,19,45,
1978,276,19,18,37,
1979,281,13,22,35,
1980,285,16,15,31,
1981,284,19,12,31,
1982,288,20,13,33,
1983,275,17,14,31,
1984,301,31,23,54,
1985,305,22,20,42,
1986,299,15,18,33,
1987,294,31,22,53,
1988,306,21,16,37,
1989,293,22,12,34,
1990,321,27,27,54,
1991,279,21,14,35,
1992,343,20,21,41,
1993,280,17,17,34,
1994,309,25,18,43,
1995,301,18,9,27,
1996,287,17,15,32,
1997,280,15,19,34,
1998,302,22,23,45,
1999,288,31,10,41,
2000,288,26,17,43,
2001,290,19,18,37,
2002,322,27,15,42,
2003,293,22,19,41,
2004,326,19,17,36,
2005,322,25,18,43,
2006,279,14,17,31,
2007,303,26,23,49,
2008,307,28,19,47,
2009,309,20,21,41,
2010,284,14,14,28,
2011,293,21,21,42,
2012,265,22,23,45,
2013,306,19,19,38,
2014,331,24,18,42,
2015,296,21,17,38,
2016,317,21,18,39,
2017,302,19,17,36,
2018,283,9,18,27,
2019,290,23,21,44,
2020,320,28,15,43,
2021,296,19,18,37,
2022,293,24,11,35,
2023,272,18,9,27,
2024,293,25,7,32,
2025,290,18,17,35,
2026,286,16,15,31,
2027,324,30,15,45,
2028,303,17,18,35,
2029,318,20,24,44,
2030,300,28,15,43,
2031,330,26,15,41,
2032,300,36,16,52,
2033,305,17,15,32,
2034,296,25,9,34,
2035,290,20,15,35,
2036,265,26,13,39,
2037,292,21,17,38,
2038,299,26,9,35,
2039,280,19,15,34,
2040,293,25,11,36,
2041,321,18,25,43,
2042,305,24,15,39,
2043,293,25,15,40,
2044,310,18,21,39,
2045,292,17,19,36,
2046,292,25,14,39,
2047,290,19,15,34,
2048,314,28,15,43,
2049,283,15,14,29,
2050,310,21,17,38,
2051,298,17,19,36,
2052,281,17,21,38,
2053,292,19,12,31,
2054,288,23,12,35,
2055,300,22,16,38,
2056,291,22,15,37,
2057,293,15,22,37,
2058,270,20,16,36,
2059,305,22,16,38,
2060,301,25,16,41,
2061,288,31,11,42,
2062,298,24,25,49,
2063,296,26,10,36,
2064,293,17,16,33,
2065,285,22,10,32,
2066,262,19,19,38,
2067,287,24,13,37,
2068,277,16,20,36,
2069,314,28,19,47,
2070,282,15,19,34,
2071,314,25,12,37,
2072,293,20,16,36,
2073,306,12,17,29,
2074,300,27,19,46,
2075,321,33,13,46,
2076,301,21,13,34,
2077,244,17,9,26,
2078,290,23,16,39,
2079,289,19,17,36,
2080,303,19,13,32,
2081,278,13,21,34,
2082,295,23,16,39,
2083,308,19,15,34,
2084,303,20,20,40,
2085,275,15,20,35,
2086,303,19,20,39,
2087,298,14,29,43,
2088,319,19,17,36,
2089,299,22,21,43,
2090,316,11,21,32,
2091,301,20,12,32,
2092,297,21,18,39,
2093,297,24,22,46,
2094,303,22,11,33,
2095,299,23,9,32,
2096,300,18,14,32,
2097,300,17,12,29,
2098,301,26,17,43,
2099,327,26,17,43,
2100,264,17,12,29,
2101,310,28,19,47,
2102,326,24,19,43,
2103,293,22,13,35,
2104,285,15,14,29,
2105,299,26,19,45,
2106,285,15,17,32,
2107,286,26,11,37,
2108,293,21,15,36,
2109,305,24,15,39,
2110,307,26,16,42,
2111,308,28,18,46,
2112,287,23,19,42,
2113,297,25,20,45,
2114,260,20,12,32,
2115,313,18,12,30,
2116,292,23,12,35,
2117,262,15,15,30,
2118,288,32,10,42,
2119,293,16,11,27,
2120,296,20,15,35,
2121,291,19,20,39,
2122,293,15,20,35,
2123,268,20,19,39,
2124,288,25,11,36,
2125,310,25,16,41,
2126,291,16,14,30,
2127,238,13,8,21,
2128,289,22,11,33,
2129,340,32,21,53,
2130,284,13,13,26,
2131,302,19,19,38,
2132,273,20,10,30,
2133,277,18,18,36,
2134,300,23,14,37,
2135,317,19,22,41,
2136,295,19,22,41,
2137,304,16,8,24,
2138,297,27,20,47,
2139,312,18,24,42,
2140,299,20,12,32,
2141,291,21,14,35,
2142,292,16,14,30,
2143,293,17,11,28,
2144,291,16,18,34,
2145,312,21,19,40,
2146,308,18,18,36,
2147,297,24,17,41,
2148,302,23,7,30,
2149,291,16,16,32,
2150,307,21,13,34,
2151,309,19,19,38,
2152,291,28,10,38,
2153,300,16,17,33,
2154,345,23,15,38,
2155,288,20,11,31,
2156,319,27,20,47,
2157,306,21,16,37,
2158,286,23,19,42,
2159,257,12,18,30,
2160,313,20,18,38,
2161,299,24,19,43,
2162,287,29,19,48,
2163,305,14,20,34,
2164,295,19,12,31,
2165,319,22,13,35,
2166,311,24,17,41,
2167,298,20,11,31,
2168,291,16,17,33,
2169,317,31,23,54,
2170,281,20,14,34,
2171,293,18,17,35,
2172,295,23,22,45,
2173,288,23,18,41,
2174,267,13,20,33,
2175,309,18,23,41,
2176,297,23,22,45,
2177,277,17,14,31,
2178,324,29,10,39,
2179,289,28,22,50,
2180,269,18,15,33,
2181,264,18,15,33,
2182,290,23,13,36,
2183,271,15,10,25,
2184,289,26,16,42,
2185,298,21,20,41,
2186,294,20,21,41,
2187,313,16,18,34,
2188,308,16,18,34,
2189,309,21,19,40,
2190,265,21,10,31,
2191,327,27,16,43,
2192,295,21,16,37,
2193,279,15,19,34,
2194,320,24,18,42,
2195,310,23,16,39,
2196,308,18,16,34,
2197,280,26,23,49,
2198,290,19,16,35,
2199,274,19,26,45,
2200,312,19,17,36,
2201,278,16,9,25,
2202,307,24,10,34,
2203,290,15,19,34,
2204,311,14,16,30,
2205,303,25,16,41,
2206,285,19,17,36,
2207,323,21,17,38,
2208,319,22,16,38,
2209,284,15,17,32,
2210,297,19,28,47,
2211,310,18,20,38,
2212,308,29,16,45,
2213,303,22,22,44,
2214,329,18,18,36,
2215,302,19,23,42,
2216,308,23,15,38,
2217,318,28,18,46,
2218,330,21,22,43,
2219,312,21,17,38,
2220,310,19,26,45,
2221,286,10,18,28,
2222,287,20,13,33,
2223,284,21,8,29,
2224,320,15,22,37,
2225,286,27,17,44,
2226,298,20,12,32,
2227,300,25,16,41,
2228,293,22,20,42,
2229,284,15,19,34,
2230,261,20,18,38,
2231,274,15,15,30,
2232,263,15,21,36,
2233,315,19,22,41,
2234,301,18,15,33,
2235,276,16,14,30,
2236,284,32,15,47,
2237,298,21,19,40,
2238,271,17,25,42,
2239,321,35,17,52,
2240,317,28,26,54,
2241,325,33,18,51,
2242,299,16,15,31,
2243,291,19,22,41,
2244,318,27,15,42,
2245,294,18,25,43,
2246,300,28,14,42,
2247,284,19,16,35,
2248,296,23,16,39,
2249,270,20,12,32,
2250,302,24,23,47,
2251,266,18,14,32,
2252,303,23,18,41,
2253,332,21,17,38,
2254,279,26,19,45,
2255,263,13,21,34,
2256,270,6,22,28,
2257,295,16,25,41,
2258,316,14,12,26,
2259,294,33,16,49,
2260,262,21,17,38,
2261,298,25,21,46,
2262,305,17,18,35,
2263,281,18,16,34,
2264,290,13,12,25,
2265,274,19,22,41,
2266,307,22,16,38,
2267,286,18,23,41,
2268,303,22,19,41,
2269,264,18,16,34,
2270,308,25,15,40,
2271,313,21,25,46,
2272,318,26,20,46,
2273,297,26,18,44,
2274,298,26,11,37,
2275,292,19,15,34,
2276,271,26,12,38,
2277,345,29,27,56,
2278,305,16,20,36,
2279,287,21,20,41,
2280,271,16,19,35,
2281,309,19,29,48,
2282,316,19,16,35,
2283,329,21,17,38,
2284,306,19,21,40,
2285,264,14,18,32,
2286,319,28,12,40,
2287,312,24,17,41,
2288,314,24,20,44,
2289,316,25,14,39,
2290,285,24,19,43,
2291,316,27,18,45,
2292,266,16,16,32,
2293,301,16,13,29,
2294,310,20,25,45,
2295,284,16,17,33,
2296,314,26,17,43,
2297,285,19,27,46,
2298,303,17,22,39,
2299,331,27,31,58,
2300,302,32,20,52,
2301,299,22,15,37,
2302,296,22,13,35,
2303,336,32,28,60,
2304,278,23,15,38,
2305,278,16,17,33,
2306,278,25,17,42,
2307,291,18,13,31,
2308,301,29,13,42,
2309,285,29,19,48,
2310,295,24,21,45,
2311,293,18,18,36,
2312,285,19,17,36,
2313,284,19,18,37,
2314,275,28,14,42,
2315,309,26,16,42,
2316,300,21,12,33,
2317,272,17,19,36,
2318,318,21,21,42,
2319,280,17,18,35,
2320,305,24,18,42,
2321,295,26,14,40,
2322,281,15,13,28,
2323,304,15,19,34,
2324,315,28,19,47,
2325,316,17,8,25,
2326,343,24,16,40,
2327,279,29,16,45,
2328,297,22,19,41,
2329,270,22,8,30,
2330,276,21,10,31,
2331,300,20,22,42,
2332,267,25,12,37,
2333,328,22,19,41,
2334,293,21,19,40,
2335,268,23,9,32,
2336,297,21,11,32,
2337,324,26,20,46,
2338,307,22,18,40,
2339,290,14,14,28,
2340,300,27,23,50,
2341,303,24,17,41,
2342,295,19,17,36,
2343,271,19,14,33,
2344,262,21,11,32,
2345,301,22,15,37,
2346,310,16,21,37,
2347,313,19,16,35,
2348,278,21,14,35,
2349,291,20,20,40,
2350,280,17,16,33,
2351,319,16,18,34,
2352,282,27,21,48,
2353,290,29,21,50,
2354,284,24,17,41,
2355,295,16,14,30,
2356,313,32,14,46,
2357,331,28,16,44,
2358,297,23,14,37,
2359,280,22,10,32,
2360,320,25,20,45,
2361,298,19,17,36,
2362,291,16,22,38,
2363,303,23,13,36,
2364,298,27,17,44,
2365,346,18,23,41,
2366,296,18,13,31,
2367,264,19,11,30,
2368,292,30,18,48,
2369,287,20,15,35,
2370,313,21,20,41,
2371,300,25,13,38,
2372,312,25,12,37,
2373,291,21,16,37,
2374,306,17,13,30,
2375,302,25,16,41,
2376,271,15,18,33,
2377,291,16,19,35,
2378,290,23,14,37,
2379,274,20,13,33,
2380,295,20,23,43,
2381,305,17,15,32,
2382,305,24,15,39,
2383,299,26,11,37,
2384,284,17,19,36,
2385,304,22,18,40,
2386,269,20,16,36,
2387,292,23,14,37,
2388,302,19,10,29,
2389,259,19,14,33,
2390,273,24,16,40,
2391,306,29,22,51,
2392,311,18,15,33,
2393,301,19,9,28,
2394,291,27,15,42,
2395,286,22,20,42,
2396,310,22,11,33,
2397,290,20,12,32,
2398,294,18,16,34,
2399,313,31,19,50,
2400,306,19,19,38,
2401,297,27,12,39,
2402,265,15,21,36,
2403,300,33,24,57,
2404,300,13,21,34,
2405,277,35,19,54,
2406,305,23,17,40,
2407,273,22,23,45,
2408,291,18,13,31,
2409,294,19,19,38,
2410,276,15,18,33,
2411,283,18,21,39,
2412,330,27,22,49,
2413,314,25,10,35,
2414,274,24,17,41,
2415,252,16,14,30,
2416,288,23,20,43,
2417,265,23,13,36,
2418,286,22,11,33,
2419,298,26,25,51,
2420,291,29,15,44,
2421,288,17,17,34,
2422,286,22,19,41,
2423,330,24,17,41,
2424,294,28,9,37,
2425,288,16,19,35,
2426,298,19,16,35,
2427,312,26,17,43,
2428,284,23,15,38,
2429,299,16,18,34,
2430,284,18,21,39,
2431,332,26,15,41,
2432,299,15,12,27,
2433,300,30,14,44,
2434,274,18,13,31,
2435,301,19,17,36,
2436,278,15,11,26,
2437,277,31,12,43,
2438,305,21,14,35,
2439,323,24,16,40,
2440,268,17,16,33,
2441,310,20,22,42,
2442,276,26,15,41,
2443,306,26,17,43,
2444,337,27,15,42,
2445,282,25,20,45,
2446,285,10,14,24,
2447,275,22,15,37,
2448,282,22,16,38,
2449,286,15,14,29,
2450,288,23,19,42,
2451,286,28,18,46,
2452,295,19,21,40,
2453,320,20,23,43,
2454,285,24,17,41,
2455,282,29,20,49,
2456,311,13,21,34,
2457,310,22,24,46,
2458,327,21,16,37,
2459,313,29,11,40,
2460,301,16,22,38,
2461,260,25,17,42,
2462,286,22,15,37,
2463,285,27,18,45,
2464,295,21,17,38,
2465,300,24,15,39,
2466,291,17,17,34,
2467,265,17,21,38,
2468,269,20,14,34,
2469,304,37,19,56,
2470,309,21,23,44,
2471,294,20,21,41,
2472,325,26,25,51,
2473,313,20,25,45,
2474,306,28,19,47,
2475,285,21,16,37,
2476,318,17,20,37,
2477,306,24,21,45,
2478,287,22,21,43,
2479,311,25,15,40,
2480,300,17,14,31,
2481,282,16,22,38,
2482,316,21,28,49,
2483,307,16,24,40,
2484,306,12,15,27,
2485,247,12,17,29,
2486,293,23,15,38,
2487,290,24,15,39,
2488,314,27,13,40,
2489,328,26,15,41,
2490,327,28,18,46,
2491,316,21,28,49,
2492,283,29,16,45,
2493,305,29,17,46,
2494,305,20,19,39,
2495,291,21,12,33,
2496,284,26,14,40,
2497,301,21,16,37,
2498,305,19,22,41,
2499,295,19,22,41,
2500,286,17,20,37,
2501,319,19,22,41,
2502,303,19,17,36,
2503,286,24,14,38,
2504,295,27,14,41,
2505,280,21,9,30,
2506,287,25,17,42,
2507,297,17,19,36,
2508,303,23,18,41,
2509,281,23,12,35,
2510,306,17,21,38,
2511,325,29,19,48,
2512,306,25,22,47,
2513,287,16,21,37,
2514,328,25,16,41,
2515,291,19,16,35,
2516,310,16,18,34,
2517,342,25,19,44,
2518,296,23,23,46,
2519,289,30,16,46,
2520,284,20,14,34,
2521,290,27,11,38,
2522,282,19,10,29,
2523,314,21,21,42,
2524,299,25,19,44,
2525,312,19,15,34,
2526,319,18,16,34,
2527,275,30,17,47,
2528,285,23,14,37,
2529,289,24,10,34,
2530,320,31,12,43,
2531,304,20,15,35,
2532,292,20,13,33,
2533,265,29,11,40,
2534,292,26,14,40,
2535,302,13,20,33,
2536,315,20,17,37,
2537,319,18,15,33,
2538,305,18,29,47,
2539,293,18,17,35,
2540,294,26,12,38,
2541,317,25,16,41,
2542,290,20,17,37,
2543,326,19,21,40,
2544,302,22,15,37,
2545,308,11,17,28,
2546,336,17,20,37,
2547,296,28,12,40,
2548,266,17,18,35,
2549,295,15,21,36,
2550,320,27,18,45,
2551,291,26,13,39,
2552,302,14,11,25,
2553,307,17,27,44,
2554,305,23,14,37,
2555,343,28,23,51,
2556,319,23,18,41,
2557,298,25,17,42,
2558,326,17,12,29,
2559,302,20,17,37,
2560,265,13,21,34,
2561,323,18,12,30,
2562,350,22,22,44,
2563,274,16,19,35,
2564,303,16,20,36,
2565,283,17,12,29,
2566,319,32,18,50,
2567,274,13,13,26,
2568,302,24,15,39,
2569,317,25,31,56,
2570,302,21,11,32,
2571,285,19,16,35,
2572,277,24,15,39,
2573,329,25,16,41,
2574,290,15,14,29,
2575,284,18,23,41,
2576,282,23,19,42,
2577,291,28,12,40,
2578,300,23,11,34,
2579,302,23,22,45,
2580,316,28,21,49,
2581,321,24,18,42,
2582,285,21,21,42,
2583,315,23,24,47,
2584,311,23,23,46,
2585,289,19,16,35,
2586,295,18,19,37,
2587,292,16,14,30,
2588,310,22,21,43,
2589,290,21,19,40,
2590,319,21,15,36,
2591,301,16,14,30,
2592,278,20,18,38,
2593,280,21,11,32,
2594,290,30,16,46,
2595,302,23,15,38,
2596,319,24,18,42,
2597,280,23,17,40,
2598,317,24,20,44,
2599,307,29,15,44,
2600,305,20,14,34,
2601,314,27,11,38,
2602,345,20,15,35,
2603,280,19,13,32,
2604,300,16,18,34,
2605,284,24,15,39,
2606,307,22,13,35,
2607,295,22,17,39,
2608,310,28,15,43,
2609,297,20,19,39,
2610,279,26,19,45,
2611,281,21,11,32,
2612,304,25,20,45,
2613,306,16,18,34,
2614,313,20,17,37,
2615,296,23,25,48,
2616,307,22,19,41,
2617,293,19,17,36,
2618,288,16,15,31,
2619,309,21,11,32,
2620,301,24,20,44,
2621,297,28,20,48,
2622,291,14,13,27,
2623,293,28,16,44,
2624,304,29,14,43,
2625,293,24,18,42,
2626,293,26,15,41,
2627,327,20,22,42,
2628,303,19,21,40,
2629,273,17,12,29,
2630,339,17,17,34,
2631,297,16,13,29,
2632,286,16,18,34,
2633,293,23,19,42,
2634,331,24,22,46,
2635,308,30,23,53,
2636,316,20,17,37,
2637,309,23,16,39,
2638,271,19,23,42,
2639,284,15,11,26,
2640,302,28,20,48,
2641,273,16,13,29,
2642,313,21,15,36,
2643,316,20,18,38,
2644,290,26,13,39,
2645,265,18,19,37,
2646,278,24,18,42,
2647,306,27,18,45,
2648,304,24,9,33,
2649,288,21,20,41,
2650,265,23,13,36,
2651,282,26,16,42,
2652,285,19,20,39,
2653,287,23,20,43,
2654,300,13,18,31,
2655,302,22,17,39,
2656,313,20,8,28,
2657,321,29,15,44,
2658,268,28,10,38,
2659,310,24,14,38,
2660,286,22,17,39,
2661,274,17,12,29,
2662,291,22,16,38,
2663,291,22,20,42,
2664,286,17,15,32,
2665,320,19,24,43,
2666,286,27,10,37,
2667,305,22,11,33,
2668,293,24,17,41,
2669,281,24,20,44,
2670,317,23,16,39,
2671,280,20,21,41,
2672,295,13,22,35,
2673,318,26,19,45,
2674,295,28,9,37,
2675,360,24,26,50,
2676,297,14,13,27,
2677,309,21,14,35,
2678,301,22,20,42,
2679,276,15,9,24,
2680,277,14,19,33,
2681,281,16,20,36,
2682,291,20,13,33,
2683,287,19,18,37,
2684,291,15,19,34,
2685,300,20,16,36,
2686,306,22,17,39,
2687,301,18,23,41,
2688,278,22,16,38,
2689,283,19,17,36,
2690,360,25,26,51,
2691,322,30,16,46,
2692,311,24,22,46,
2693,294,21,20,41,
2694,278,22,23,45,
2695,288,22,23,45,
2696,309,24,15,39,
2697,307,19,24,43,
2698,284,26,15,41,
2699,280,17,13,30,
2700,281,30,17,47,
2701,333,34,24,58,
2702,316,25,23,48,
2703,301,23,23,46,
2704,328,22,22,44,
2705,305,25,15,40,
2706,303,21,13,34,
2707,321,23,19,42,
2708,308,30,13,43,
2709,300,19,20,39,
2710,314,21,18,39,
2711,292,21,15,36,
2712,305,29,11,40,
2713,298,19,20,39,
2714,275,19,18,37,
2715,277,11,20,31,
2716,295,22,16,38,
2717,290,24,15,39,
2718,308,16,15,31,
2719,287,18,16,34,
2720,284,16,18,34,
2721,297,18,18,36,
2722,294,21,19,40,
2723,279,17,14,31,
2724,270,17,14,31,
2725,325,28,20,48,
2726,264,17,15,32,
2727,321,20,17,37,
2728,302,21,14,35,
2729,281,18,24,42,
2730,305,17,19,36,
2731,311,24,14,38,
2732,288,22,16,38,
2733,309,17,17,34,
2734,265,22,19,41,
2735,315,25,10,35,
2736,305,23,18,41,
2737,341,24,17,41,
2738,300,21,22,43,
2739,316,22,18,40,
2740,303,23,17,40,
2741,301,21,19,40,
2742,343,25,15,40,
2743,303,21,24,45,
2744,302,20,17,37,
2745,267,19,18,37,
2746,303,18,17,35,
2747,279,22,13,35,
2748,327,21,15,36,
2749,294,25,23,48,
2750,278,24,12,36,
2751,286,21,22,43,
2752,278,23,17,40,
2753,318,28,17,45,
2754,319,24,14,38,
2755,290,18,17,35,
2756,286,13,16,29,
2757,303,19,15,34,
2758,292,18,11,29,
2759,311,28,18,46,
2760,297,17,14,31,
2761,278,24,14,38,
2762,294,19,20,39,
2763,307,26,17,43,
2764,300,22,17,39,
2765,312,20,8,28,
2766,278,19,11,30,
2767,281,20,14,34,
2768,292,9,12,21,
2769,323,33,18,51,
2770,314,27,17,44,
2771,317,22,18,40,
2772,295,22,17,39,
2773,302,18,15,33,
2774,299,23,13,36,
2775,290,17,17,34,
2776,306,21,18,39,
2777,315,32,21,53,
2778,277,26,19,45,
2779,273,29,16,45,
2780,323,24,22,46,
2781,300,25,20,45,
2782,270,17,21,38,
2783,308,22,13,35,
2784,304,24,23,47,
2785,310,25,16,41,
2786,270,23,14,37,
2787,322,26,12,38,
2788,292,17,19,36,
2789,273,18,21,39,
2790,304,20,15,35,
2791,325,22,19,41,
2792,271,17,18,35,
2793,333,19,18,37,
2794,306,21,19,40,
2795,272,22,12,34,
2796,328,27,14,41,
2797,284,17,15,32,
2798,276,25,21,46,
2799,319,20,17,37,
2800,312,19,23,42,
2801,269,22,11,33,
2802,335,26,19,45,
2803,299,22,27,49,
2804,277,21,16,37,
2805,303,27,22,49,
2806,307,23,20,43,
2807,312,24,19,43,
2808,273,26,16,42,
2809,291,24,20,44,
2810,297,17,10,27,
2811,291,22,22,44,
2812,272,22,18,40,
2813,268,17,13,30,
2814,294,18,15,33,
2815,326,29,9,38,
2816,315,27,23,50,
2817,280,19,14,33,
2818,321,22,12,34,
2819,296,26,17,43,
2820,284,24,16,40,
2821,257,14,17,31,
2822,307,13,22,35,
2823,274,19,16,35,
2824,274,18,16,34,
2825,296,22,22,44,
2826,266,25,16,41,
2827,334,22,13,35,
2828,354,20,30,50,
2829,301,18,25,43,
2830,309,26,18,44,
2831,294,20,21,41,
2832,304,24,15,39,
2833,294,16,12,28,
2834,317,22,21,43,
2835,287,18,17,35,
2836,272,23,10,33,
2837,291,21,20,41,
2838,292,26,14,40,
2839,294,12,15,27,
2840,304,26,22,48,
2841,302,34,18,52,
2842,327,30,17,47,
2843,281,23,18,41,
2844,292,23,15,38,
2845,273,14,13,27,
2846,309,21,14,35,
2847,308,15,27,42,
2848,311,20,15,35,
2849,298,21,16,37,
2850,272,25,8,33,
2851,284,16,17,33,
2852,255,18,14,32,
2853,306,28,22,50,
2854,298,16,19,35,
2855,257,24,9,33,
2856,319,28,22,50,
2857,280,17,20,37,
2858,309,21,17,38,
2859,304,19,23,42,
2860,310,19,20,39,
2861,266,12,26,38,
2862,316,19,19,38,
2863,297,15,12,27,
2864,310,24,23,47,
2865,300,22,21,43,
2866,314,26,21,47,
2867,298,23,17,40,
2868,269,21,11,32,
2869,292,24,21,45,
2870,296,25,21,46,
2871,293,15,16,31,
2872,308,22,17,39,
2873,334,29,14,43,
2874,301,16,11,27,
2875,259,16,11,27,
2876,302,20,11,31,
2877,307,28,18,46,
2878,292,27,23,50,
2879,306,16,16,32,
2880,287,10,13,23,
2881,307,26,18,44,
2882,318,22,7,29,
2883,281,20,13,33,
2884,273,22,11,33,
2885,327,24,25,49,
2886,277,21,18,39,
2887,278,28,20,48,
2888,310,23,19,42,
2889,292,22,16,38,
2890,311,27,15,42,
2891,304,24,21,45,
2892,336,23,20,43,
2893,311,14,21,35,
2894,311,25,12,37,
2895,297,17,14,31,
2896,309,19,18,37,
2897,280,13,20,33,
2898,294,18,17,35,
2899,309,19,19,38,
2900,291,22,14,36,
2901,282,21,11,32,
2902,324,19,22,41,
2903,285,24,13,37,
2904,294,18,17,35,
2905,295,20,17,37,
2906,272,22,20,42,
2907,291,27,22,49,
2908,290,19,17,36,
2909,294,23,18,41,
2910,284,23,14,37,
2911,315,33,24,57,
2912,291,28,13,41,
2913,296,27,14,41,
2914,315,32,18,50,
2915,303,19,17,36,
2916,293,19,22,41,
2917,310,22,19,41,
2918,283,17,20,37,
2919,295,22,9,31,
2920,314,27,12,39,
2921,286,28,12,40,
2922,312,19,18,37,
2923,303,27,19,46,
2924,294,16,14,30,
2925,311,18,17,35,
2926,308,27,21,48,
2927,276,23,6,29,
2928,302,24,21,45,
2929,281,20,13,33,
2930,317,31,19,50,
2931,273,24,14,38,
2932,277,23,15,38,
2933,328,24,16,40,
2934,310,13,17,30,
2935,306,18,23,41,
2936,317,30,14,44,
2937,290,19,18,37,
2938,289,19,19,38,
2939,339,25,17,42,
2940,299,26,18,44,
2941,322,34,20,54,
2942,284,22,13,35,
2943,287,25,22,47,
2944,271,19,19,38,
2945,292,21,19,40,
2946,302,24,21,45,
2947,306,12,22,34,
2948,270,19,13,32,
2949,296,13,20,33,
2950,266,25,17,42,
2951,288,18,9,27,
2952,301,22,18,40,
2953,269,26,22,48,
2954,248,33,11,44,
2955,318,22,20,42,
2956,285,24,18,42,
2957,311,22,17,39,
2958,276,22,16,38,
2959,276,16,17,33,
2960,285,20,16,36,
2961,284,24,15,39,
2962,341,26,19,45,
2963,334,31,20,51,
2964,310,22,22,44,
2965,337,21,21,42,
2966,266,14,12,26,
2967,310,14,19,33,
2968,323,30,22,52,
2969,284,15,15,30,
2970,291,16,12,28,
2971,305,21,14,35,
2972,322,17,22,39,
2973,294,16,19,35,
2974,314,22,26,48,
2975,291,20,23,43,
2976,277,17,23,40,
2977,298,16,13,29,
2978,291,22,14,36,
2979,303,28,16,44,
2980,295,14,19,33,
2981,295,26,22,48,
2982,296,14,21,35,
2983,290,33,17,50,
2984,292,25,11,36,
2985,325,28,26,54,
2986,259,18,19,37,
2987,282,22,15,37,
2988,265,20,12,32,
2989,287,17,23,40,
2990,326,22,23,45,
2991,293,22,15,37,
2992,308,24,28,52,
2993,322,27,23,50,
2994,295,26,8,34,
2995,277,21,12,33,
2996,286,23,20,43,
2997,286,25,12,37,
2998,321,26,21,47,
2999,293,20,17,37,
3000,261,24,14,38,
3001,354,27,27,54,
3002,318,22,23,45,
3003,288,19,17,36,
3004,301,24,17,41,
3005,327,22,21,43,
3006,295,25,18,43,
3007,267,15,12,27,
3008,303,20,22,42,
3009,298,16,13,29,
3010,272,20,15,35,
3011,297,19,20,39,
3012,335,19,20,39,
3013,309,21,17,38,
3014,337,25,24,49,
3015,325,26,18,44,
3016,320,23,18,41,
3017,275,21,20,41,
3018,320,24,18,42,
3019,288,16,18,34,
3020,298,15,18,33,
3021,277,27,15,42,
3022,284,24,19,43,
3023,288,22,20,42,
3024,297,19,23,42,
3025,303,21,17,38,
3026,323,19,15,34,
3027,291,24,19,43,
3028,304,24,19,43,
3029,327,22,13,35,
3030,291,23,10,33,
3031,293,22,14,36,
3032,307,18,18,36,
3033,318,23,16,39,
3034,296,15,15,30,
3035,320,23,21,44,
3036,328,25,21,46,
3037,321,28,18,46,
3038,293,25,10,35,
3039,339,27,16,43,
3040,297,28,23,51,
3041,298,24,15,39,
3042,309,20,16,36,
3043,296,23,18,41,
3044,267,19,21,40,
3045,286,19,17,36,
3046,282,31,16,47,
3047,295,21,19,40,
3048,282,18,20,38,
3049,316,24,17,41,
3050,298,25,17,42,
3051,322,23,17,40,
3052,296,23,18,41,
3053,317,18,17,35,
3054,321,24,21,45,
3055,263,19,18,37,
3056,317,32,18,50,
3057,292,24,10,34,
3058,337,33,12,45,
3059,292,21,23,44,
3060,319,25,16,41,
3061,301,23,13,36,
3062,291,22,14,36,
3063,289,12,22,34,
3064,302,25,16,41,
3065,317,24,12,36,
3066,294,19,15,34,
3067,293,20,24,44,
3068,297,21,13,34,
3069,294,17,10,27,
3070,292,21,20,41,
3071,282,14,15,29,
3072,300,22,11,33,
3073,294,28,14,42,
3074,265,19,16,35,
3075,303,26,21,47,
3076,308,24,19,43,
3077,257,13,18,31,
3078,334,20,18,38,
3079,366,21,17,38,
3080,263,16,15,31,
3081,309,23,20,43,
3082,301,29,15,44,
3083,301,13,18,31,
3084,335,25,25,50,
3085,282,22,21,43,
3086,299,14,20,34,
3087,303,23,24,47,
3088,328,25,20,45,
3089,316,23,20,43,
3090,287,21,17,38,
3091,275,19,22,41,
3092,307,15,20,35,
3093,263,28,16,44,
3094,300,14,20,34,
3095,315,28,18,46,
3096,291,21,13,34,
3097,286,17,22,39,
3098,282,25,14,39,
3099,305,30,16,46,
3100,314,26,19,45,
3101,308,20,11,31,
3102,301,19,13,32,
3103,299,18,16,34,
3104,273,26,22,48,
3105,285,23,13,36,
3106,301,22,16,38,
3107,294,21,19,40,
3108,293,17,22,39,
3109,294,26,12,38,
3110,292,24,13,37,
3111,283,26,14,40,
3112,299,24,19,43,
3113,291,15,17,32,
3114,273,23,22,45,
3115,295,28,16,44,
3116,288,23,23,46,
3117,299,23,25,48,
3118,286,26,20,46,
3119,287,28,14,42,
3120,302,18,14,32,
3121,311,18,20,38,
3122,274,15,23,38,
3123,292,19,20,39,
3124,270,24,8,32,
3125,295,32,19,51,
3126,313,20,20,40,
3127,286,24,26,50,
3128,303,16,14,30,
3129,305,19,7,26,
3130,252,12,19,31,
3131,308,16,14,30,
3132,300,21,16,37,
3133,313,21,21,42,
3134,288,21,15,36,
3135,303,21,20,41,
3136,284,19,12,31,
3137,320,33,13,46,
3138,283,22,9,31,
3139,316,24,10,34,
3140,360,21,18,39,
3141,309,23,17,40,
3142,282,20,19,39,
3143,306,26,19,45,
3144,316,23,15,38,
3145,316,21,13,34,
3146,275,20,21,41,
3147,277,24,18,42,
3148,321,18,23,41,
3149,327,25,17,42,
3150,283,25,12,37,
3151,302,18,15,33,
3152,312,22,19,41,
3153,331,22,19,41,
3154,284,22,14,36,
3155,312,22,15,37,
3156,294,19,21,40,
3157,279,26,17,43,
3158,283,19,14,33,
3159,286,20,18,38,
3160,307,23,19,42,
3161,293,26,20,46,
3162,294,20,10,30,
3163,307,17,21,38,
3164,298,26,13,39,
3165,284,16,20,36,
3166,269,26,18,44,
3167,280,23,14,37,
3168,307,25,16,41,
3169,311,28,16,44,
3170,304,11,27,38,
3171,303,22,21,43,
3172,301,21,17,38,
3173,303,24,19,43,
3174,314,22,7,29,
3175,315,25,18,43,
3176,302,24,20,44,
3177,295,19,14,33,
3178,275,23,17,40,
3179,268,22,9,31,
3180,336,23,15,38,
3181,297,24,13,37,
3182,307,30,23,53,
3183,282,19,19,38,
3184,296,22,25,47,
3185,329,28,23,51,
3186,292,21,20,41,
3187,315,28,16,44,
3188,255,17,20,37,
3189,324,15,23,38,
3190,312,23,13,36,
3191,317,15,14,29,
3192,317,24,18,42,
3193,302,17,12,29,
3194,293,19,16,35,
3195,295,21,17,38,
3196,291,23,15,38,
3197,278,18,16,34,
3198,288,19,12,31,
3199,282,17,14,31,
3200,281,26,16,42,
3201,304,23,10,33,
3202,275,22,16,38,
3203,289,21,15,36,
3204,305,26,26,52,
3205,290,19,14,33,
3206,285,20,12,32,
3207,281,15,20,35,
3208,302,25,12,37,
3209,302,18,23,41,
3210,287,27,10,37,
3211,298,22,11,33,
3212,317,19,14,33,
3213,280,23,18,41,
3214,306,19,17,36,
3215,310,25,25,50,
3216,290,18,18,36,
3217,282,23,16,39,
3218,289,26,17,43,
3219,314,27,9,36,
3220,333,27,14,41,
3221,310,20,16,36,
3222,308,23,22,45,
3223,313,20,17,37,
3224,316,26,10,36,
3225,287,31,13,44,
3226,355,35,20,55,
3227,300,8,14,22,
3228,299,21,12,33,
3229,318,15,17,32,
3230,307,22,16,38,
3231,292,24,15,39,
3232,276,15,15,30,
3233,310,20,20,40,
3234,315,19,26,45,
3235,273,19,9,28,
3236,268,27,14,41,
3237,254,16,21,37,
3238,283,20,17,37,
3239,289,18,14,32,
3240,311,19,24,43,
3241,280,23,19,42,
3242,297,23,16,39,
3243,310,17,28,45,
3244,283,24,15,39,
3245,277,30,14,44,
3246,272,19,11,30,
3247,295,20,14,34,
3248,317,26,32,58,
3249,312,17,23,40,
3250,290,19,10,29,
3251,270,25,13,38,
3252,301,29,29,58,
3253,270,29,15,44,
3254,285,23,19,42,
3255,336,28,17,45,
3256,297,28,12,40,
3257,280,17,9,26,
3258,270,22,17,39,
3259,303,17,19,36,
3260,294,18,16,34,
3261,295,22,21,43,
3262,284,20,19,39,
3263,274,16,10,26,
3264,296,15,15,30,
3265,320,19,20,39,
3266,291,27,18,45,
3267,294,23,18,41,
3268,297,25,13,38,
3269,302,22,14,36,
3270,288,18,15,33,
3271,289,21,5,26,
3272,307,22,12,34,
3273,279,13,13,26,
3274,276,20,17,37,
3275,303,22,17,39,
3276,298,23,18,41,
3277,324,24,23,47,
3278,299,20,20,40,
3279,258,15,18,33,
3280,294,24,18,42,
3281,321,24,21,45,
3282,299,21,17,38,
3283,320,29,17,46,
3284,312,17,19,36,
3285,302,26,10,36,
3286,274,16,14,30,
3287,301,19,18,37,
3288,296,27,18,45,
3289,288,21,23,44,
3290,288,16,19,35,
3291,326,26,22,48,
3292,283,14,13,27,
3293,285,27,17,44,
3294,304,21,23,44,
3295,287,19,14,33,
3296,306,21,15,36,
3297,316,25,16,41,
3298,290,26,11,37,
3299,270,18,10,28,
3300,272,21,20,41,
3301,286,32,17,49,
3302,283,20,18,38,
3303,309,22,20,42,
3304,313,27,19,46,
3305,301,23,22,45,
3306,313,17,21,38,
3307,292,18,15,33,
3308,305,19,20,39,
3309,272,17,11,28,
3310,308,25,16,41,
3311,265,21,14,35,
3312,308,15,12,27,
3313,299,23,10,33,
3314,305,25,17,42,
3315,288,23,18,41,
3316,286,18,19,37,
3317,296,17,19,36,
3318,285,21,14,35,
3319,270,18,15,33,
3320,257,16,12,28,
3321,334,21,18,39,
3322,312,23,15,38,
3323,303,15,20,35,
3324,266,19,20,39,
3325,277,21,16,37,
3326,315,25,22,47,
3327,318,23,12,35,
3328,343,32,17,49,
3329,258,23,8,31,
3330,262,19,15,34,
3331,288,25,15,40,
3332,307,22,14,36,
3333,322,25,22,47,
3334,255,28,20,48,
3335,309,27,22,49,
3336,273,31,17,48,
3337,280,22,17,39,
3338,325,27,25,52,
3339,273,18,18,36,
3340,276,15,19,34,
3341,269,17,28,45,
3342,328,29,14,43,
3343,289,19,13,32,
3344,317,21,25,46,
3345,289,30,18,48,
3346,294,17,11,28,
3347,294,18,19,37,
3348,337,27,18,45,
3349,293,25,8,33,
3350,314,21,22,43,
3351,280,20,8,28,
3352,287,25,8,33,
3353,303,19,12,31,
3354,302,22,15,37,
3355,290,28,24,52,
3356,275,22,22,44,
3357,330,19,15,34,
3358,284,29,18,47,
3359,300,22,16,38,
3360,293,20,16,36,
3361,307,20,9,29,
3362,302,27,15,42,
3363,296,13,21,34,
3364,295,23,27,50,
3365,325,15,21,36,
3366,291,15,21,36,
3367,315,35,13,48,
3368,288,17,21,38,
3369,279,23,16,39,
3370,267,20,20,40,
3371,331,32,17,49,
3372,275,22,12,34,
3373,294,22,18,40,
3374,285,24,13,37,
3375,307,14,20,34,
3376,291,20,19,39,
3377,314,30,11,41,
3378,329,21,22,43,
3379,287,25,9,34,
3380,317,16,19,35,
3381,319,15,13,28,
3382,297,23,12,35,
3383,290,19,16,35,
3384,310,24,12,36,
3385,277,18,13,31,
3386,314,20,13,33,
3387,325,23,11,34,
3388,323,27,15,42,
3389,290,27,14,41,
3390,285,24,12,36,
3391,292,21,24,45,
3392,313,18,14,32,
3393,308,16,20,36,
3394,297,23,13,36,
3395,282,17,16,33,
3396,275,27,17,44,
3397,302,21,13,34,
3398,272,19,10,29,
3399,316,26,15,41,
3400,293,11,23,34,
3401,309,22,16,38,
3402,298,19,18,37,
3403,281,26,13,39,
3404,300,21,15,36,
3405,314,12,20,32,
3406,316,18,17,35,
3407,345,18,25,43,
3408,315,25,19,44,
3409,295,22,14,36,
3410,303,24,18,42,
3411,296,23,16,39,
3412,288,18,10,28,
3413,300,18,13,31,
3414,309,25,17,42,
3415,289,18,27,45,
3416,324,25,22,47,
3417,271,20,19,39,
3418,313,18,20,38,
3419,293,17,5,22,
3420,309,23,22,45,
3421,289,12,18,30,
3422,326,29,18,47,
3423,308,22,17,39,
3424,308,21,14,35,
3425,313,24,14,38,
3426,272,24,24,48,
3427,309,26,14,40,
3428,296,22,15,37,
3429,276,21,10,31,
3430,311,18,29,47,
3431,287,33,14,47,
3432,303,25,12,37,
3433,303,21,18,39,
3434,302,27,16,43,
3435,309,19,24,43,
3436,276,21,9,30,
3437,264,28,15,43,
3438,262,13,11,24,
3439,300,22,12,34,
3440,282,20,16,36,
3441,311,19,12,31,
3442,269,19,12,31,
3443,293,16,20,36,
3444,311,30,15,45,
3445,307,20,22,42,
3446,271,25,13,38,
3447,295,14,18,32,
3448,288,23,15,38,
3449,281,21,23,44,
3450,261,21,14,35,
3451,262,21,12,33,
3452,309,29,22,51,
3453,315,24,23,47,
3454,323,24,29,53,
3455,281,15,11,26,
3456,266,21,12,33,
3457,311,24,20,44,
3458,288,22,13,35,
3459,322,22,17,39,
3460,312,26,20,46,
3461,295,22,16,38,
3462,304,18,11,29,
3463,301,20,20,40,
3464,286,21,17,38,
3465,270,20,19,39,
3466,302,25,9,34,
3467,297,28,18,46,
3468,281,12,15,27,
3469,296,17,23,40,
3470,322,21,21,42,
3471,298,20,17,37,
3472,291,24,22,46,
3473,327,30,13,43,
3474,343,26,22,48,
3475,280,18,16,34,
3476,310,27,16,43,
3477,288,21,20,41,
3478,309,17,22,39,
3479,297,25,23,48,
3480,306,12,21,33,
3481,313,18,21,39,
3482,275,25,19,44,
3483,292,21,18,39,
3484,305,24,14,38,
3485,295,18,27,45,
3486,295,20,14,34,
3487,318,17,25,42,
3488,287,20,18,38,
3489,294,18,18,36,
3490,273,28,17,45,
3491,277,23,13,36,
3492,284,20,13,33,
3493,268,18,9,27,
3494,293,15,21,36,
3495,278,18,10,28,
3496,309,27,18,45,
3497,291,23,21,44,
3498,298,14,16,30,
3499,333,25,14,39,
3500,291,27,18,45,
3501,294,16,16,32,
3502,307,14,18,32,
3503,316,29,23,52,
3504,316,24,20,44,
3505,319,22,15,37,
3506,277,17,17,34,
3507,323,22,12,34,
3508,281,17,22,39,
3509,305,30,17,47,
3510,301,25,16,41,
3511,298,29,21,50,
3512,323,17,14,31,
3513,292,17,18,35,
3514,285,20,21,41,
3515,291,24,18,42,
3516,262,16,15,31,
3517,262,17,11,28,
3518,336,24,16,40,
3519,311,16,19,35,
3520,266,24,22,46,
3521,288,18,15,33,
3522,320,26,14,40,
3523,273,22,14,36,
3524,288,20,20,40,
3525,307,21,16,37,
3526,287,26,10,36,
3527,275,23,12,35,
3528,315,22,20,42,
3529,323,23,19,42,
3530,320,20,19,39,
3531,284,24,20,44,
3532,319,19,19,38,
3533,284,22,13,35,
3534,305,20,13,33,
3535,306,28,12,40,
3536,303,24,13,37,
3537,317,19,19,38,
3538,266,15,21,36,
3539,260,15,7,22,
3540,297,18,14,32,
3541,258,18,14,32,
3542,304,26,19,45,
3543,316,18,11,29,
3544,314,16,26,42,
3545,304,31,15,46,
3546,319,27,11,38,
3547,304,23,13,36,
3548,283,21,18,39,
3549,289,17,13,30,
3550,316,30,18,48,
3551,290,27,13,40,
3552,308,28,12,40,
3553,346,18,17,35,
3554,333,26,27,53,
3555,283,26,17,43,
3556,321,17,28,45,
3557,303,29,21,50,
3558,306,25,16,41,
3559,288,21,19,40,
3560,336,19,18,37,
3561,293,23,14,37,
3562,304,25,16,41,
3563,323,22,21,43,
3564,304,23,10,33,
3565,322,18,25,43,
3566,331,37,14,51,
3567,318,27,20,47,
3568,308,19,19,38,
3569,299,25,15,40,
3570,273,18,18,36,
3571,304,18,20,38,
3572,300,27,19,46,
3573,303,13,18,31,
3574,288,23,18,41,
3575,275,14,16,30,
3576,296,15,16,31,
3577,289,21,19,40,
3578,305,22,15,37,
3579,302,22,13,35,
3580,301,25,20,45,
3581,270,22,13,35,
3582,323,15,17,32,
3583,302,21,15,36,
3584,277,19,14,33,
3585,312,25,16,41,
3586,308,22,14,36,
3587,315,29,18,47,
3588,298,19,15,34,
3589,295,22,11,33,
3590,264,17,22,39,
3591,332,32,20,52,
3592,285,17,12,29,
3593,313,16,16,32,
3594,281,19,11,30,
3595,271,18,18,36,
3596,318,19,24,43,
3597,294,24,13,37,
3598,282,18,13,31,
3599,265,23,12,35,
3600,283,26,16,42,
3601,288,23,14,37,
3602,277,22,11,33,
3603,338,19,18,37,
3604,313,21,18,39,
3605,272,22,18,40,
3606,292,15,11,26,
3607,276,24,24,48,
3608,277,29,12,41,
3609,257,17,23,40,
3610,318,24,20,44,
3611,297,35,16,51,
3612,289,24,13,37,
3613,308,26,15,41,
3614,294,27,19,46,
3615,337,28,20,48,
3616,262,17,17,34,
3617,282,16,10,26,
3618,271,22,11,33,
3619,248,18,7,25,
3620,295,18,18,36,
3621,338,18,23,41,
3622,306,28,20,48,
3623,298,18,14,32,
3624,298,29,22,51,
3625,281,18,18,36,
3626,284,20,22,42,
3627,322,29,15,44,
3628,320,28,15,43,
3629,292,27,22,49,
3630,308,28,21,49,
3631,275,22,10,32,
3632,335,18,18,36,
3633,311,27,22,49,
3634,297,22,19,41,
3635,305,19,14,33,
3636,285,27,17,44,
3637,295,31,15,46,
3638,282,28,17,45,
3639,301,12,24,36,
3640,297,24,20,44,
3641,317,34,17,51,
3642,289,21,16,37,
3643,258,14,15,29,
3644,284,30,11,41,
3645,292,22,15,37,
3646,288,22,13,35,
3647,272,23,15,38,
3648,303,20,25,45,
3649,319,31,34,65,
3650,319,23,29,52,
3651,313,23,16,39,
3652,305,21,23,44,
3653,286,14,19,33,
3654,294,17,21,38,
3655,291,19,9,28,
3656,270,17,17,34,
3657,328,27,14,41,
3658,309,23,11,34,
3659,293,20,23,43,
3660,292,22,16,38,
3661,330,26,24,50,
3662,318,28,23,51,
3663,296,25,17,42,
3664,301,22,14,36,
3665,267,19,15,34,
3666,305,22,16,38,
3667,267,21,16,37,
3668,311,25,19,44,
3669,304,24,27,51,
3670,308,23,16,39,
3671,295,19,15,34,
3672,288,19,16,35,
3673,286,16,16,32,
3674,294,14,17,31,
3675,291,36,10,46,
3676,308,28,15,43,
3677,287,22,18,40,
3678,281,16,17,33,
3679,308,20,20,40,
3680,288,21,13,34,
3681,284,22,11,33,
3682,325,29,13,42,
3683,264,15,14,29,
3684,305,18,17,35,
3685,314,17,14,31,
3686,324,17,22,39,
3687,308,22,19,41,
3688,283,16,19,35,
3689,304,22,18,40,
3690,319,28,24,52,
3691,326,19,25,44,
3692,280,18,16,34,
3693,280,16,17,33,
3694,281,21,17,38,
3695,305,17,14,31,
3696,305,17,16,33,
3697,292,20,13,33,
3698,268,18,17,35,
3699,309,30,23,53,
3700,335,32,23,55,
3701,294,22,15,37,
3702,277,25,22,47,
3703,283,26,18,44,
3704,295,29,18,47,
3705,293,18,19,37,
3706,298,28,14,42,
3707,284,18,22,40,
3708,312,24,19,43,
3709,285,24,16,40,
3710,301,24,11,35,
3711,289,20,19,39,
3712,314,17,24,41,
3713,310,22,24,46,
3714,312,24,17,41,
3715,289,22,13,35,
3716,304,14,14,28,
3717,331,21,17,38,
3718,289,16,11,27,
3719,318,25,16,41,
3720,304,17,23,40,
3721,308,27,7,34,
3722,266,24,18,42,
3723,298,22,28,50,
3724,301,19,14,33,
3725,270,18,19,37,
3726,273,17,21,38,
3727,283,31,12,43,
3728,337,13,15,28,
3729,290,18,16,34,
3730,277,27,18,45,
3731,290,21,17,38,
3732,309,15,12,27,
3733,292,22,16,38,
3734,288,22,18,40,
3735,296,21,15,36,
3736,306,14,24,38,
3737,297,25,23,48,
3738,318,22,12,34,
3739,296,26,21,47,
3740,275,21,18,39,
3741,290,22,16,38,
3742,314,23,19,42,
3743,303,16,14,30,
3744,305,22,17,39,
3745,315,31,13,44,
3746,282,24,14,38,
3747,308,13,23,36,
3748,295,21,22,43,
3749,323,17,18,35,
3750,303,16,17,33,
3751,346,24,21,45,
3752,270,15,11,26,
3753,309,28,22,50,
3754,332,17,18,35,
3755,312,23,20,43,
3756,339,28,14,42,
3757,300,22,18,40,
3758,279,17,12,29,
3759,287,19,18,37,
3760,323,19,21,40,
3761,307,30,16,46,
3762,301,20,23,43,
3763,295,24,19,43,
3764,326,24,23,47,
3765,320,26,13,39,
3766,281,22,21,43,
3767,297,18,14,32,
3768,299,31,20,51,
3769,323,20,11,31,
3770,348,34,24,58,
3771,292,24,19,43,
3772,314,23,14,37,
3773,264,17,11,28,
3774,324,22,21,43,
3775,304,14,19,33,
3776,311,20,24,44,
3777,312,13,20,33,
3778,326,27,16,43,
3779,311,13,21,34,
3780,274,24,17,41,
3781,270,17,16,33,
3782,323,30,31,61,
3783,293,14,13,27,
3784,307,19,16,35,
3785,268,20,19,39,
3786,289,25,21,46,
3787,285,14,25,39,
3788,278,19,12,31,
3789,316,20,15,35,
3790,277,28,18,46,
3791,310,26,10,36,
3792,291,31,18,49,
3793,316,27,22,49,
3794,284,14,21,35,
3795,323,28,20,48,
3796,304,15,15,30,
3797,301,28,21,49,
3798,309,27,19,46,
3799,287,15,20,35,
3800,280,26,19,45,
3801,290,14,10,24,
3802,308,22,19,41,
3803,273,18,16,34,
3804,261,9,9,18,
3805,302,19,9,28,
3806,255,18,14,32,
3807,268,18,14,32,
3808,311,21,22,43,
3809,309,19,15,34,
3810,291,21,16,37,
3811,311,24,28,52,
3812,313,21,13,34,
3813,284,12,19,31,
3814,304,18,23,41,
3815,266,15,12,27,
3816,300,23,17,40,
3817,284,24,18,42,
3818,276,19,12,31,
3819,311,30,16,46,
3820,288,23,18,41,
3821,314,25,22,47,
3822,315,27,23,50,
3823,290,19,15,34,
3824,275,15,16,31,
3825,280,26,10,36,
3826,286,23,21,44,
3827,304,17,16,33,
3828,324,21,22,43,
3829,269,17,15,32,
3830,301,29,18,47,
3831,313,27,17,44,
3832,281,29,15,44,
3833,287,20,14,34,
3834,281,19,24,43,
3835,278,24,13,37,
3836,319,27,11,38,
3837,291,23,13,36,
3838,292,18,18,36,
3839,288,18,17,35,
3840,320,17,21,38,
3841,294,19,19,38,
3842,288,24,11,35,
3843,324,30,24,54,
3844,322,18,15,33,
3845,302,24,14,38,
3846,288,19,9,28,
3847,271,20,16,36,
3848,291,22,11,33,
3849,288,20,13,33,
3850,293,18,15,33,
3851,274,20,14,34,
3852,286,16,15,31,
3853,325,23,15,38,
3854,277,16,16,32,
3855,310,24,14,38,
3856,286,20,18,38,
3857,296,22,23,45,
3858,263,13,20,33,
3859,302,17,17,34,
3860,334,30,24,54,
3861,293,22,22,44,
3862,262,17,22,39,
3863,266,24,9,33,
3864,293,17,19,36,
3865,281,21,14,35,
3866,264,17,22,39,
3867,282,22,14,36,
3868,296,15,16,31,
3869,297,23,15,38,
3870,336,20,13,33,
3871,283,28,12,40,
3872,315,21,16,37,
3873,267,22,15,37,
3874,315,25,18,43,
3875,306,20,30,50,
3876,299,21,20,41,
3877,313,19,19,38,
3878,279,23,16,39,
3879,291,22,13,35,
3880,309,21,22,43,
3881,315,26,11,37,
3882,339,28,22,50,
3883,318,17,24,41,
3884,331,24,19,43,
3885,274,20,20,40,
3886,301,25,20,45,
3887,309,19,19,38,
3888,300,20,26,46,
3889,281,19,10,29,
3890,285,27,13,40,
3891,294,14,6,20,
3892,287,9,15,24,
3893,295,25,12,37,
3894,303,27,18,45,
3895,303,24,17,41,
3896,319,27,14,41,
3897,323,20,24,44,
3898,300,30,18,48,
3899,303,19,17,36,
3900,304,19,13,32,
3901,304,19,22,41,
3902,302,18,14,32,
3903,289,16,11,27,
3904,285,23,9,32,
3905,304,23,15,38,
3906,305,23,21,44,
3907,291,27,12,39,
3908,269,22,18,40,
3909,303,20,16,36,
3910,300,14,26,40,
3911,305,31,20,51,
3912,313,25,23,48,
3913,264,23,22,45,
3914,285,20,14,34,
3915,289,17,16,33,
3916,292,9,18,27,
3917,337,21,26,47,
3918,277,19,18,37,
3919,295,25,19,44,
3920,273,21,16,37,
3921,312,23,11,34,
3922,316,26,20,46,
3923,273,18,16,34,
3924,323,23,18,41,
3925,291,25,17,42,
3926,310,26,15,41,
3927,278,21,11,32,
3928,286,22,18,40,
3929,326,18,15,33,
3930,328,17,29,46,
3931,273,16,17,33,
3932,287,27,16,43,
3933,334,24,18,42,
3934,287,21,16,37,
3935,282,27,15,42,
3936,316,25,16,41,
3937,297,26,14,40,
3938,271,18,22,40,
3939,297,22,17,39,
3940,297,17,23,40,
3941,271,15,22,37,
3942,306,16,26,42,
3943,285,21,18,39,
3944,301,28,10,38,
3945,278,20,17,37,
3946,335,19,26,45,
3947,309,18,19,37,
3948,287,23,19,42,
3949,298,24,12,36,
3950,306,16,22,38,
3951,302,21,18,39,
3952,292,27,13,40,
3953,273,22,17,39,
3954,287,21,12,33,
3955,344,22,22,44,
3956,295,22,13,35,
3957,325,20,23,43,
3958,271,22,13,35,
3959,296,21,18,39,
3960,296,19,14,33,
3961,312,22,25,47,
3962,342,25,18,43,
3963,360,29,18,47,
3964,288,24,14,38,
3965,306,21,15,36,
3966,306,20,15,35,
3967,275,18,16,34,
3968,290,18,17,35,
3969,299,29,12,41,
3970,297,25,17,42,
3971,296,19,20,39,
3972,303,20,21,41,
3973,295,31,14,45,
3974,265,14,11,25,
3975,288,20,12,32,
3976,329,15,16,31,
3977,302,18,15,33,
3978,274,21,13,34,
3979,280,15,14,29,
3980,284,18,17,35,
3981,284,22,14,36,
3982,295,32,23,55,
3983,270,18,21,39,
3984,298,24,17,41,
3985,302,22,21,43,
3986,340,24,12,36,
3987,303,22,15,37,
3988,248,24,15,39,
3989,300,19,14,33,
3990,304,24,17,41,
3991,284,17,20,37,
3992,280,19,17,36,
3993,278,13,21,34,
3994,302,14,19,33,
3995,274,27,19,46,
3996,290,19,18,37,
3997,295,18,19,37,
3998,286,30,15,45,
3999,283,16,14,30,
4000,269,19,14,33,
4001,288,19,15,34,
4002,311,20,23,43,
4003,282,22,20,42,
4004,281,16,15,31,
4005,268,18,13,31,
4006,282,26,20,46,
4007,278,22,10,32,
4008,283,19,17,36,
4009,290,25,13,38,
4010,302,22,21,43,
4011,264,18,14,32,
4012,325,26,23,49,
4013,302,20,19,39,
4014,312,24,21,45,
4015,313,27,15,42,
4016,262,16,16,32,
4017,318,27,19,46,
4018,299,19,16,35,
4019,260,9,18,27,
4020,257,11,15,26,
4021,303,25,12,37,
4022,337,28,15,43,
4023,328,26,11,37,
4024,317,25,15,40,
4025,295,10,18,28,
4026,334,25,19,44,
4027,352,26,14,40,
4028,285,18,17,35,
4029,298,19,12,31,
4030,304,20,18,38,
4031,301,18,21,39,
4032,298,26,15,41,
4033,303,20,15,35,
4034,312,22,22,44,
4035,282,20,13,33,
4036,322,25,12,37,
4037,301,19,22,41,
4038,283,31,17,48,
4039,302,33,11,44,
4040,284,16,25,41,
4041,303,23,13,36,
4042,287,14,24,38,
4043,312,16,20,36,
4044,306,24,19,43,
4045,293,17,22,39,
4046,289,24,21,45,
4047,304,32,17,49,
4048,274,24,15,39,
4049,278,25,12,37,
4050,320,19,23,42,
4051,280,20,14,34,
4052,286,16,13,29,
4053,277,23,16,39,
4054,300,12,18,30,
4055,303,16,24,40,
4056,294,13,21,34,
4057,307,25,20,45,
4058,261,18,24,42,
4059,307,22,13,35,
4060,297,12,20,32,
4061,320,26,23,49,
4062,299,16,17,33,
4063,296,18,18,36,
4064,310,25,11,36,
4065,292,27,6,33,
4066,277,18,15,33,
4067,304,28,21,49,
4068,306,14,25,39,
4069,287,20,16,36,
4070,314,27,17,44,
4071,298,21,16,37,
4072,293,22,19,41,
4073,303,22,22,44,
4074,286,20,21,41,
4075,312,15,22,37,
4076,290,23,13,36,
4077,292,18,13,31,
4078,287,27,12,39,
4079,315,31,20,51,
4080,303,20,15,35,
4081,272,21,11,32,
4082,297,21,20,41,
4083,312,18,21,39,
4084,320,26,14,40,
4085,297,20,14,34,
4086,313,22,21,43,
4087,299,20,16,36,
4088,326,25,16,41,
4089,340,38,10,48,
4090,307,18,20,38,
4091,266,19,16,35,
4092,252,19,13,32,
4093,279,11,11,22,
4094,281,26,10,36,
4095,265,13,14,27,
4096,282,21,27,48,
4097,312,21,17,38,
4098,306,20,16,36,
4099,309,26,16,42,
4100,283,27,16,43,
4101,306,24,16,40,
4102,277,20,16,36,
4103,296,26,18,44,
4104,283,22,12,34,
4105,274,21,14,35,
4106,318,16,22,38,
4107,311,35,19,54,
4108,308,23,19,42,
4109,268,19,15,34,
4110,288,18,11,29,
4111,281,22,13,35,
4112,284,18,12,30,
4113,314,23,14,37,
4114,282,18,23,41,
4115,283,16,19,35,
4116,292,21,13,34,
4117,320,24,22,46,
4118,316,22,14,36,
4119,288,26,18,44,
4120,273,18,10,28,
4121,300,25,16,41,
4122,276,13,22,35,
4123,309,26,16,42,
4124,310,18,14,32,
4125,270,18,11,29,
4126,302,26,20,46,
4127,281,21,11,32,
4128,288,21,22,43,
4129,319,23,16,39,
4130,314,29,18,47,
4131,286,25,13,38,
4132,275,26,10,36,
4133,260,12,21,33,
4134,309,22,17,39,
4135,297,24,12,36,
4136,282,25,12,37,
4137,299,16,14,30,
4138,290,23,20,43,
4139,320,26,20,46,
4140,285,18,15,33,
4141,294,27,20,47,
4142,300,30,5,35,
4143,283,32,17,49,
4144,316,23,9,32,
4145,304,17,13,30,
4146,262,20,15,35,
4147,332,30,23,53,
4148,296,24,16,40,
4149,304,32,23,55,
4150,314,26,20,46,
4151,301,19,12,31,
4152,325,19,23,42,
4153,273,14,17,31,
4154,341,26,14,40,
4155,277,22,11,33,
4156,282,23,16,39,
4157,319,29,18,47,
4158,283,17,15,32,
4159,307,18,18,36,
4160,328,20,14,34,
4161,320,23,22,45,
4162,293,23,13,36,
4163,268,22,16,38,
4164,278,21,19,40,
4165,323,18,23,41,
4166,272,25,17,42,
4167,292,22,12,34,
4168,318,15,13,28,
4169,283,20,17,37,
4170,313,18,20,38,
4171,287,22,21,43,
4172,297,25,14,39,
4173,295,18,14,32,
4174,285,21,16,37,
4175,302,20,17,37,
4176,339,31,13,44,
4177,297,31,18,49,
4178,287,21,22,43,
4179,319,22,16,38,
4180,276,22,18,40,
4181,299,21,12,33,
4182,304,23,22,45,
4183,318,28,17,45,
4184,301,26,23,49,
4185,333,20,19,39,
4186,287,15,15,30,
4187,281,23,18,41,
4188,302,26,15,41,
4189,278,16,18,34,
4190,303,16,20,36,
4191,343,28,17,45,
4192,309,33,17,50,
4193,289,23,25,48,
4194,270,18,10,28,
4195,280,21,17,38,
4196,309,25,7,32,
4197,312,17,19,36,
4198,327,16,12,28,
4199,310,15,23,38,
4200,299,23,23,46,
4201,313,20,15,35,
4202,240,8,7,15,
4203,290,19,16,35,
4204,311,22,17,39,
4205,260,14,12,26,
4206,326,22,24,46,
4207,275,17,17,34,
4208,297,17,15,32,
4209,330,27,18,45,
4210,319,24,19,43,
4211,316,25,20,45,
4212,293,21,14,35,
4213,291,23,16,39,
4214,301,23,10,33,
4215,326,27,17,44,
4216,299,18,17,35,
4217,318,28,10,38,
4218,310,20,18,38,
4219,299,19,15,34,
4220,322,18,18,36,
4221,311,17,16,33,
4222,314,23,16,39,
4223,295,21,18,39,
4224,270,17,13,30,
4225,294,30,11,41,
4226,330,31,16,47,
4227,267,17,16,33,
4228,310,24,17,41,
4229,286,18,13,31,
4230,294,23,10,33,
4231,290,18,20,38,
4232,292,6,22,28,
4233,296,16,19,35,
4234,310,20,27,47,
4235,318,16,14,30,
4236,291,16,17,33,
4237,277,22,18,40,
4238,311,27,22,49,
4239,347,14,15,29,
4240,289,20,20,40,
4241,282,17,17,34,
4242,279,22,10,32,
4243,312,16,19,35,
4244,329,22,13,35,
4245,274,31,17,48,
4246,282,23,13,36,
4247,288,23,20,43,
4248,301,23,17,40,
4249,293,24,23,47,
4250,267,20,14,34,
4251,269,17,21,38,
4252,280,24,15,39,
4253,279,14,27,41,
4254,266,21,18,39,
4255,283,18,16,34,
4256,316,25,20,45,
4257,282,29,11,40,
4258,301,24,18,42,
4259,327,14,19,33,
4260,301,20,19,39,
4261,290,21,24,45,
4262,305,25,14,39,
4263,323,23,15,38,
4264,331,17,24,41,
4265,286,31,14,45,
4266,287,14,19,33,
4267,298,22,20,42,
4268,320,27,19,46,
4269,306,24,15,39,
4270,316,11,25,36,
4271,298,28,17,45,
4272,298,11,19,30,
4273,287,14,25,39,
4274,285,15,18,33,
4275,300,26,24,50,
4276,274,22,17,39,
4277,311,19,24,43,
4278,303,34,17,51,
4279,282,14,13,27,
4280,274,18,18,36,
4281,291,23,15,38,
4282,282,18,13,31,
4283,313,22,13,35,
4284,278,19,15,34,
4285,294,18,15,33,
4286,301,23,19,42,
4287,316,14,14,28,
4288,274,21,23,44,
4289,283,13,25,38,
4290,318,20,15,35,
4291,341,24,11,35,
4292,294,21,13,34,
4293,323,17,22,39,
4294,281,29,20,49,
4295,299,29,17,46,
4296,259,10,25,35,
4297,287,21,14,35,
4298,295,16,18,34,
4299,320,19,20,39,
4300,288,27,19,46,
4301,327,17,19,36,
4302,307,21,15,36,
4303,297,24,10,34,
4304,322,33,22,55,
4305,294,22,15,37,
4306,307,24,14,38,
4307,277,17,18,35,
4308,304,31,20,51,
4309,284,21,12,33,
4310,326,26,15,41,
4311,272,17,16,33,
4312,286,20,21,41,
4313,297,19,23,42,
4314,270,23,13,36,
4315,286,27,10,37,
4316,316,25,15,40,
4317,281,14,12,26,
4318,291,18,17,35,
4319,272,21,10,31,
4320,316,23,14,37,
4321,304,15,20,35,
4322,289,18,15,33,
4323,279,19,23,42,
4324,306,23,25,48,
4325,308,27,12,39,
4326,286,23,17,40,
4327,264,18,18,36,
4328,300,19,18,37,
4329,290,20,22,42,
4330,259,22,12,34,
4331,289,22,17,39,
4332,295,17,13,30,
4333,292,14,15,29,
4334,299,25,23,48,
4335,300,16,21,37,
4336,257,11,9,20,
4337,324,23,22,45,
4338,283,22,18,40,
4339,307,22,14,36,
4340,296,23,19,42,
4341,322,25,18,43,
4342,297,27,20,47,
4343,337,20,23,43,
4344,295,19,18,37,
4345,292,25,16,41,
4346,304,22,17,39,
4347,304,28,16,44,
4348,284,22,19,41,
4349,312,17,20,37,
4350,263,17,18,35,
4351,322,17,16,33,
4352,273,16,19,35,
4353,329,21,14,35,
4354,252,20,13,33,
4355,310,22,18,40,
4356,277,26,18,44,
4357,295,16,19,35,
4358,302,19,21,40,
4359,282,25,12,37,
4360,256,20,16,36,
4361,290,18,28,46,
4362,288,22,18,40,
4363,301,22,15,37,
4364,285,26,21,47,
4365,311,32,13,45,
4366,323,28,27,55,
4367,302,20,14,34,
4368,314,19,13,32,
4369,286,22,16,38,
4370,295,25,13,38,
4371,313,25,14,39,
4372,302,25,24,49,
4373,327,20,19,39,
4374,271,18,23,41,
4375,287,24,23,47,
4376,268,21,13,34,
4377,349,21,23,44,
4378,318,18,19,37,
4379,315,23,18,41,
4380,296,11,19,30,
4381,275,23,9,32,
4382,301,23,20,43,
4383,316,28,16,44,
4384,302,18,24,42,
4385,285,18,24,42,
4386,307,24,22,46,
4387,295,30,20,50,
4388,299,26,20,46,
4389,269,18,18,36,
4390,285,19,14,33,
4391,330,24,27,51,
4392,302,20,27,47,
4393,314,23,11,34,
4394,294,22,11,33,
4395,342,28,19,47,
4396,310,18,22,40,
4397,286,24,16,40,
4398,287,20,16,36,
4399,334,29,17,46,
4400,277,20,18,38,
4401,277,19,21,40,
4402,294,26,13,39,
4403,324,20,15,35,
4404,304,21,17,38,
4405,313,15,15,30,
4406,310,22,17,39,
4407,308,26,14,40,
4408,309,20,19,39,
4409,292,15,22,37,
4410,321,19,13,32,
4411,294,17,17,34,
4412,293,24,18,42,
4413,272,23,21,44,
4414,278,16,17,33,
4415,298,31,18,49,
4416,303,20,16,36,
4417,262,20,22,42,
4418,290,23,15,38,
4419,288,22,15,37,
4420,316,28,16,44,
4421,303,26,23,49,
4422,284,20,19,39,
4423,286,24,17,41,
4424,274,13,20,33,
4425,358,20,23,43,
4426,298,22,18,40,
4427,323,24,18,42,
4428,305,29,21,50,
4429,306,27,15,42,
4430,280,22,11,33,
4431,304,29,14,43,
4432,315,26,17,43,
4433,326,26,16,42,
4434,300,24,26,50,
4435,309,27,20,47,
4436,287,14,16,30,
4437,301,20,11,31,
4438,309,19,14,33,
4439,281,15,29,44,
4440,325,35,24,59,
4441,286,22,15,37,
4442,281,19,19,38,
4443,295,16,11,27,
4444,295,10,28,38,
4445,299,26,18,44,
4446,332,21,16,37,
4447,301,31,18,49,
4448,351,24,24,48,
4449,329,24,17,41,
4450,308,21,15,36,
4451,282,20,23,43,
4452,309,12,20,32,
4453,298,19,14,33,
4454,320,20,22,42,
4455,335,23,21,44,
4456,296,23,12,35,
4457,299,20,16,36,
4458,281,20,23,43,
4459,256,19,11,30,
4460,323,27,18,45,
4461,280,16,16,32,
4462,304,19,18,37,
4463,305,33,15,48,
4464,324,23,19,42,
4465,321,15,23,38,
4466,291,23,20,43,
4467,279,26,24,50,
4468,266,13,15,28,
4469,292,23,13,36,
4470,282,18,17,35,
4471,336,17,24,41,
4472,314,20,21,41,
4473,289,20,12,32,
4474,306,20,19,39,
4475,263,15,18,33,
4476,267,26,17,43,
4477,295,17,17,34,
4478,271,20,23,43,
4479,279,20,17,37,
4480,278,10,16,26,
4481,287,22,17,39,
4482,287,21,15,36,
4483,285,21,18,39,
4484,297,18,13,31,
4485,279,13,13,26,
4486,304,18,18,36,
4487,299,25,23,48,
4488,270,23,23,46,
4489,293,23,14,37,
4490,315,23,17,40,
4491,266,15,16,31,
4492,283,17,25,42,
4493,319,27,19,46,
4494,273,16,17,33,
4495,292,20,12,32,
4496,293,20,12,32,
4497,286,24,16,40,
4498,334,25,17,42,
4499,323,17,11,28,
4500,301,23,13,36,
4501,327,21,21,42,
4502,266,19,13,32,
4503,286,18,13,31,
4504,297,17,11,28,
4505,307,13,22,35,
4506,287,13,15,28,
4507,351,23,19,42,
4508,293,15,16,31,
4509,284,19,21,40,
4510,267,24,12,36,
4511,285,10,17,27,
4512,298,20,20,40,
4513,274,23,10,33,
4514,282,23,20,43,
4515,289,17,11,28,
4516,335,25,18,43,
4517,323,29,18,47,
4518,271,22,16,38,
4519,317,26,16,42,
4520,322,16,19,35,
4521,285,25,13,38,
4522,295,20,12,32,
4523,286,20,13,33,
4524,281,21,22,43,
4525,284,12,16,28,
4526,307,24,16,40,
4527,292,19,16,35,
4528,312,30,17,47,
4529,295,20,16,36,
4530,291,26,24,50,
4531,276,23,19,42,
4532,319,16,18,34,
4533,271,13,17,30,
4534,281,25,20,45,
4535,288,24,17,41,
4536,293,24,6,30,
4537,267,23,14,37,
4538,304,25,17,42,
4539,288,18,14,32,
4540,292,14,23,37,
4541,303,23,13,36,
4542,293,26,14,40,
4543,301,20,23,43,
4544,289,21,17,38,
4545,305,20,18,38,
4546,303,12,17,29,
4547,307,22,19,41,
4548,325,30,19,49,
4549,303,28,22,50,
4550,307,28,16,44,
4551,291,18,18,36,
4552,248,33,13,46,
4553,301,20,12,32,
4554,269,17,22,39,
4555,293,25,20,45,
4556,288,21,15,36,
4557,296,19,15,34,
4558,291,17,12,29,
4559,276,20,15,35,
4560,316,21,23,44,
4561,336,21,27,48,
4562,276,21,9,30,
4563,266,22,15,37,
4564,277,23,20,43,
4565,320,27,25,52,
4566,284,29,18,47,
4567,305,24,13,37,
4568,311,18,20,38,
4569,290,19,14,33,
4570,297,22,17,39,
4571,277,25,12,37,
4572,289,22,16,38,
4573,295,18,17,35,
4574,304,31,23,54,
4575,290,19,19,38,
4576,270,19,16,35,
4577,328,19,14,33,
4578,286,26,21,47,
4579,310,23,12,35,
4580,312,24,18,42,
4581,302,20,19,39,
4582,299,23,15,38,
4583,284,21,19,40,
4584,269,22,15,37,
4585,327,20,15,35,
4586,310,31,18,49,
4587,307,22,16,38,
4588,311,19,16,35,
4589,302,15,17,32,
4590,298,28,18,46,
4591,315,21,14,35,
4592,306,19,15,34,
4593,296,16,17,33,
4594,283,19,19,38,
4595,301,16,17,33,
4596,312,20,13,33,
4597,315,13,27,40,
4598,290,19,9,28,
4599,276,16,14,30,
4600,297,24,14,38,
4601,282,19,17,36,
4602,297,17,17,34,
4603,314,21,15,36,
4604,287,25,17,42,
4605,272,22,17,39,
4606,297,31,13,44,
4607,282,22,20,42,
4608,297,23,19,42,
4609,302,28,20,48,
4610,328,29,13,42,
4611,328,27,17,44,
4612,257,21,14,35,
4613,284,14,16,30,
4614,305,24,14,38,
4615,304,19,14,33,
4616,295,21,27,48,
4617,300,16,23,39,
4618,283,30,15,45,
4619,315,21,24,45,
4620,276,13,24,37,
4621,326,29,6,35,
4622,266,18,9,27,
4623,303,23,27,50,
4624,310,14,22,36,
4625,315,25,14,39,
4626,253,17,13,30,
4627,270,28,16,44,
4628,315,24,12,36,
4629,325,22,18,40,
4630,300,20,15,35,
4631,266,12,22,34,
4632,294,22,16,38,
4633,286,20,21,41,
4634,275,21,12,33,
4635,291,27,19,46,
4636,310,24,11,35,
4637,291,16,19,35,
4638,303,25,15,40,
4639,276,25,12,37,
4640,339,27,20,47,
4641,260,19,12,31,
4642,276,19,19,38,
4643,285,21,14,35,
4644,304,18,12,30,
4645,297,15,16,31,
4646,317,27,22,49,
4647,303,18,11,29,
4648,277,20,21,41,
4649,299,22,17,39,
4650,278,17,19,36,
4651,305,29,15,44,
4652,319,27,15,42,
4653,292,26,19,45,
4654,265,21,12,33,
4655,302,27,14,41,
4656,310,23,21,44,
4657,301,16,20,36,
4658,285,15,18,33,
4659,283,19,18,37,
4660,294,17,24,41,
4661,308,21,22,43,
4662,275,21,16,37,
4663,256,26,7,33,
4664,281,22,12,34,
4665,301,25,15,40,
4666,275,22,20,42,
4667,301,26,15,41,
4668,281,18,14,32,
4669,307,29,13,42,
4670,286,27,16,43,
4671,306,22,17,39,
4672,280,18,13,31,
4673,270,21,14,35,
4674,278,16,18,34,
4675,281,19,14,33,
4676,294,21,17,38,
4677,260,24,21,45,
4678,301,17,17,34,
4679,309,18,16,34,
4680,308,22,14,36,
4681,306,29,17,46,
4682,301,19,19,38,
4683,311,26,13,39,
4684,297,11,16,27,
4685,292,17,14,31,
4686,303,33,21,54,
4687,287,19,22,41,
4688,316,29,26,55,
4689,313,19,12,31,
4690,304,26,15,41,
4691,316,31,20,51,
4692,297,25,19,44,
4693,288,24,26,50,
4694,314,23,14,37,
4695,360,29,30,59,
4696,280,27,13,40,
4697,297,18,10,28,
4698,268,21,14,35,
4699,314,26,19,45,
4700,293,28,13,41,
4701,316,18,22,40,
4702,275,30,18,48,
4703,267,23,17,40,
4704,304,24,15,39,
4705,302,18,15,33,
4706,315,18,19,37,
4707,258,19,7,26,
4708,303,18,13,31,
4709,295,21,15,36,
4710,309,23,12,35,
4711,313,22,24,46,
4712,322,19,17,36,
4713,284,22,15,37,
4714,320,19,20,39,
4715,297,22,16,38,
4716,313,24,17,41,
4717,299,23,14,37,
4718,300,20,16,36,
4719,313,21,17,38,
4720,273,20,19,39,
4721,294,29,16,45,
4722,306,23,13,36,
4723,293,22,17,39,
4724,285,22,17,39,
4725,315,18,16,34,
4726,311,25,16,41,
4727,312,25,18,43,
4728,337,31,24,55,
4729,270,30,14,44,
4730,271,16,18,34,
4731,295,28,15,43,
4732,314,23,20,43,
4733,299,22,19,41,
4734,309,21,17,38,
4735,293,19,14,33,
4736,284,20,24,44,
4737,303,29,15,44,
4738,347,39,14,53,
4739,307,30,13,43,
4740,296,23,15,38,
4741,300,22,17,39,
4742,316,30,22,52,
4743,294,26,18,44,
4744,271,27,13,40,
4745,283,26,18,44,
4746,312,30,14,44,
4747,307,26,14,40,
4748,296,18,18,36,
4749,279,19,19,38,
4750,300,12,18,30,
4751,264,16,12,28,
4752,312,24,18,42,
4753,288,21,17,38,
4754,270,23,10,33,
4755,298,19,14,33,
4756,272,17,6,23,
4757,279,19,13,32,
4758,290,25,14,39,
4759,288,18,14,32,
4760,299,18,27,45,
4761,289,18,24,42,
4762,311,24,11,35,
4763,283,24,12,36,
4764,289,24,21,45,
4765,305,26,24,50,
4766,292,24,18,42,
4767,327,22,18,40,
4768,298,30,18,48,
4769,295,23,13,36,
4770,264,20,12,32,
4771,292,16,14,30,
4772,302,18,15,33,
4773,302,21,19,40,
4774,307,24,10,34,
4775,296,13,19,32,
4776,293,26,15,41,
4777,268,22,21,43,
4778,294,19,17,36,
4779,310,28,18,46,
4780,293,32,10,42,
4781,282,17,16,33,
4782,301,15,13,28,
4783,308,21,22,43,
4784,321,23,16,39,
4785,287,14,15,29,
4786,291,15,16,31,
4787,298,17,18,35,
4788,286,17,17,34,
4789,275,21,20,41,
4790,293,18,17,35,
4791,303,18,23,41,
4792,265,20,16,36,
4793,278,24,19,43,
4794,282,16,13,29,
4795,319,26,17,43,
4796,284,19,20,39,
4797,298,16,15,31,
4798,311,14,17,31,
4799,302,28,15,43,
4800,305,25,14,39,
4801,327,29,26,55,
4802,296,20,17,37,
4803,289,26,15,41,
4804,301,19,20,39,
4805,300,17,17,34,
4806,292,27,13,40,
4807,304,23,14,37,
4808,315,22,13,35,
4809,319,30,18,48,
4810,307,25,19,44,
4811,304,23,6,29,
4812,261,21,30,51,
4813,324,34,13,47,
4814,347,22,18,40,
4815,317,28,19,47,
4816,281,16,18,34,
4817,318,14,10,24,
4818,279,30,14,44,
4819,280,28,14,42,
4820,304,18,20,38,
4821,277,27,19,46,
4822,300,21,21,42,
4823,290,28,12,40,
4824,321,35,22,57,
4825,311,25,21,46,
4826,300,15,18,33,
4827,306,17,10,27,
4828,280,22,22,44,
4829,302,24,10,34,
4830,319,17,8,25,
4831,294,17,19,36,
4832,304,22,17,39,
4833,284,30,13,43,
4834,300,26,21,47,
4835,294,31,17,48,
4836,310,22,15,37,
4837,291,15,16,31,
4838,297,24,20,44,
4839,284,12,12,24,
4840,310,34,18,52,
4841,284,16,14,30,
4842,284,28,15,43,
4843,307,24,23,47,
4844,278,20,14,34,
4845,325,19,22,41,
4846,289,23,17,40,
4847,327,19,17,36,
4848,326,27,13,40,
4849,288,23,17,40,
4850,293,15,16,31,
4851,315,31,13,44,
4852,282,22,19,41,
4853,267,17,17,34,
4854,270,15,12,27,
4855,263,23,13,36,
4856,294,21,23,44,
4857,330,23,18,41,
4858,342,18,17,35,
4859,336,26,17,43,
4860,294,22,19,41,
4861,300,30,20,50,
4862,306,16,19,35,
4863,288,24,18,42,
4864,291,17,29,46,
4865,311,18,14,32,
4866,270,23,11,34,
4867,300,22,22,44,
4868,343,13,21,34,
4869,313,14,23,37,
4870,308,16,9,25,
4871,295,17,12,29,
4872,309,30,19,49,
4873,303,25,21,46,
4874,284,20,21,41,
4875,323,20,21,41,
4876,330,19,18,37,
4877,290,19,17,36,
4878,311,25,19,44,
4879,295,23,13,36,
4880,282,18,9,27,
4881,297,11,18,29,
4882,292,23,12,35,
4883,300,23,14,37,
4884,291,17,19,36,
4885,277,17,22,39,
4886,328,33,22,55,
4887,293,24,18,42,
4888,300,23,14,37,
4889,292,19,22,41,
4890,284,13,21,34,
4891,290,22,18,40,
4892,287,19,20,39,
4893,293,24,12,36,
4894,321,14,17,31,
4895,309,29,16,45,
4896,292,21,23,44,
4897,301,29,15,44,
4898,282,25,16,41,
4899,313,20,13,33,
4900,291,20,16,36,
4901,289,27,22,49,
4902,286,23,14,37,
4903,284,19,19,38,
4904,311,29,17,46,
4905,286,13,12,25,
4906,278,21,15,36,
4907,306,17,14,31,
4908,306,28,25,53,
4909,318,22,16,38,
4910,254,21,16,37,
4911,277,18,15,33,
4912,271,19,20,39,
4913,285,23,15,38,
4914,294,22,16,38,
4915,258,22,16,38,
4916,295,25,13,38,
4917,280,17,18,35,
4918,279,23,21,44,
4919,286,22,14,36,
4920,273,33,5,38,
4921,292,19,16,35,
4922,289,18,20,38,
4923,303,18,18,36,
4924,302,23,25,48,
4925,313,26,24,50,
4926,284,17,10,27,
4927,282,17,19,36,
4928,304,21,29,50,
4929,288,21,13,34,
4930,298,25,10,35,
4931,301,27,12,39,
4932,285,15,10,25,
4933,326,18,17,35,
4934,279,17,19,36,
4935,304,17,16,33,
4936,303,21,16,37,
4937,309,27,17,44,
4938,280,24,16,40,
4939,284,16,7,23,
4940,264,15,18,33,
4941,299,26,27,53,
4942,289,21,17,38,
4943,284,15,15,30,
4944,320,20,26,46,
4945,302,28,14,42,
4946,282,21,20,41,
4947,290,24,12,36,
4948,265,21,11,32,
4949,298,18,13,31,
4950,344,29,18,47,
4951,327,20,23,43,
4952,302,18,21,39,
4953,355,20,29,49,
4954,304,23,19,42,
4955,301,24,18,42,
4956,306,26,19,45,
4957,323,26,24,50,
4958,289,18,16,34,
4959,288,24,15,39,
4960,282,25,19,44,
4961,268,20,16,36,
4962,269,25,13,38,
4963,327,15,22,37,
4964,307,27,23,50,
4965,312,19,18,37,
4966,283,20,15,35,
4967,308,22,23,45,
4968,278,21,12,33,
4969,286,15,21,36,
4970,312,27,12,39,
4971,290,25,26,51,
4972,333,22,20,42,
4973,301,32,19,51,
4974,339,23,24,47,
4975,278,11,14,25,
4976,277,13,18,31,
4977,304,27,17,44,
4978,290,23,11,34,
4979,320,28,11,39,
4980,268,21,22,43,
4981,304,19,14,33,
4982,306,32,11,43,
4983,269,26,14,40,
4984,290,13,15,28,
4985,267,17,16,33,
4986,283,26,20,46,
4987,291,21,15,36,
4988,279,24,13,37,
4989,348,15,16,31,
4990,348,31,26,57,
4991,298,20,18,38,
4992,285,19,12,31,
4993,278,21,22,43,
4994,289,21,13,34,
4995,276,19,15,34,
4996,285,20,21,41,
4997,286,20,16,36,
4998,287,23,21,44,
4999,323,14,25,39,
5000,286,22,19,41,
5001,275,23,16,39,
5002,277,13,17,30,
5003,287,24,19,43,
5004,299,25,16,41,
5005,309,24,21,45,
5006,303,17,15,32,
5007,284,12,12,24,
5008,278,23,15,38,
5009,322,19,23,42,
5010,279,26,13,39,
5011,300,28,12,40,
5012,297,31,22,53,
5013,308,15,25,40,
5014,281,17,20,37,
5015,292,14,26,40,
5016,295,19,12,31,
5017,318,21,17,38,
5018,317,20,23,43,
5019,300,13,18,31,
5020,276,17,13,30,
5021,283,26,19,45,
5022,292,24,12,36,
5023,298,31,20,51,
5024,279,25,10,35,
5025,295,18,20,38,
5026,305,20,20,40,
5027,324,28,16,44,
5028,335,20,18,38,
5029,325,16,23,39,
5030,260,14,22,36,
5031,325,18,16,34,
5032,319,22,16,38,
5033,325,23,25,48,
5034,301,31,18,49,
5035,301,14,24,38,
5036,287,23,11,34,
5037,310,21,9,30,
5038,267,13,15,28,
5039,271,14,18,32,
5040,323,26,15,41,
5041,300,28,18,46,
5042,285,17,18,35,
5043,288,17,19,36,
5044,282,17,19,36,
5045,259,17,17,34,
5046,296,19,24,43,
5047,292,20,16,36,
5048,291,15,14,29,
5049,278,21,17,38,
5050,279,29,12,41,
5051,319,21,20,41,
5052,333,27,16,43,
5053,306,30,13,43,
5054,302,28,21,49,
5055,286,20,10,30,
5056,289,17,14,31,
5057,284,23,21,44,
5058,297,17,25,42,
5059,281,13,23,36,
5060,284,17,11,28,
5061,333,33,24,57,
5062,299,17,15,32,
5063,309,27,18,45,
5064,302,25,11,36,
5065,314,22,20,42,
5066,328,29,17,46,
5067,300,30,16,46,
5068,304,28,25,53,
5069,259,23,15,38,
5070,295,16,13,29,
5071,278,22,15,37,
5072,315,22,16,38,
5073,298,23,20,43,
5074,304,28,19,47,
5075,310,23,14,37,
5076,266,16,21,37,
5077,272,12,17,29,
5078,314,21,18,39,
5079,311,18,17,35,
5080,305,27,21,48,
5081,290,27,18,45,
5082,285,14,18,32,
5083,310,18,12,30,
5084,288,25,20,45,
5085,315,26,24,50,
5086,307,33,16,49,
5087,288,26,15,41,
5088,305,20,19,39,
5089,289,18,18,36,
5090,288,20,17,37,
5091,293,25,18,43,
5092,297,33,15,48,
5093,281,23,14,37,
5094,294,26,14,40,
5095,301,24,15,39,
5096,314,19,15,34,
5097,269,16,17,33,
5098,313,23,19,42,
5099,280,18,26,44,
5100,290,18,22,40,
5101,304,25,14,39,
5102,318,20,27,47,
5103,288,27,16,43,
5104,293,17,18,35,
5105,288,22,19,41,
5106,315,18,22,40,
5107,298,23,15,38,
5108,283,27,23,50,
5109,306,21,16,37,
5110,298,22,19,41,
5111,294,21,18,39,
5112,302,25,23,48,
5113,316,16,15,31,
5114,279,14,19,33,
5115,295,23,18,41,
5116,274,14,15,29,
5117,287,21,12,33,
5118,282,17,20,37,
5119,281,19,23,42,
5120,302,33,31,64,
5121,303,23,13,36,
5122,321,27,18,45,
5123,306,25,31,56,
5124,293,18,15,33,
5125,308,27,9,36,
5126,289,22,15,37,
5127,265,14,16,30,
5128,304,18,16,34,
5129,296,21,13,34,
5130,283,14,24,38,
5131,299,16,16,32,
5132,293,31,21,52,
5133,318,18,24,42,
5134,257,14,15,29,
5135,281,16,13,29,
5136,287,22,16,38,
5137,328,26,20,46,
5138,305,19,19,38,
5139,331,26,15,41,
5140,285,19,13,32,
5141,278,29,8,37,
5142,312,17,20,37,
5143,281,18,21,39,
5144,300,21,16,37,
5145,309,19,20,39,
5146,280,19,18,37,
5147,324,20,29,49,
5148,322,19,20,39,
5149,315,21,22,43,
5150,300,16,15,31,
5151,280,26,11,37,
5152,280,26,10,36,
5153,319,26,15,41,
5154,281,26,19,45,
5155,295,20,16,36,
5156,327,28,15,43,
5157,281,17,14,31,
5158,277,21,19,40,
5159,314,20,24,44,
5160,349,25,21,46,
5161,315,18,22,40,
5162,277,23,15,38,
5163,280,14,13,27,
5164,299,20,20,40,
5165,284,24,18,42,
5166,308,24,20,44,
5167,302,19,18,37,
5168,255,15,12,27,
5169,294,21,22,43,
5170,313,19,22,41,
5171,301,25,8,33,
5172,325,31,12,43,
5173,319,16,17,33,
5174,307,21,19,40,
5175,323,25,24,49,
5176,307,23,15,38,
5177,307,20,21,41,
5178,275,22,22,44,
5179,312,20,17,37,
5180,308,28,13,41,
5181,282,18,22,40,
5182,308,19,27,46,
5183,311,21,19,40,
5184,280,25,19,44,
5185,284,20,19,39,
5186,316,16,16,32,
5187,280,20,14,34,
5188,307,20,18,38,
5189,307,26,11,37,
5190,269,23,12,35,
5191,282,19,17,36,
5192,314,25,17,42,
5193,272,24,12,36,
5194,325,20,21,41,
5195,286,21,19,40,
5196,274,16,12,28,
5197,317,28,21,49,
5198,282,20,22,42,
5199,299,21,20,41,
5200,302,13,13,26,
5201,308,29,13,42,
5202,285,17,20,37,
5203,278,19,14,33,
5204,286,13,21,34,
5205,273,19,16,35,
5206,301,21,13,34,
5207,266,21,20,41,
5208,285,20,21,41,
5209,306,25,17,42,
5210,269,28,15,43,
5211,296,13,12,25,
5212,318,25,18,43,
5213,273,15,16,31,
5214,321,25,20,45,
5215,299,25,17,42,
5216,300,21,16,37,
5217,296,22,16,38,
5218,271,19,13,32,
5219,317,23,19,42,
5220,313,22,17,39,
5221,326,15,23,38,
5222,298,18,15,33,
5223,291,27,17,44,
5224,310,25,16,41,
5225,290,23,25,48,
5226,314,18,21,39,
5227,330,23,17,40,
5228,295,26,18,44,
5229,269,21,27,48,
5230,310,23,21,44,
5231,307,18,19,37,
5232,293,24,12,36,
5233,309,29,17,46,
5234,308,25,14,39,
5235,314,32,17,49,
5236,307,21,18,39,
5237,299,19,14,33,
5238,321,14,22,36,
5239,330,28,16,44,
5240,306,21,11,32,
5241,297,31,21,52,
5242,318,23,17,40,
5243,287,15,14,29,
5244,323,21,15,36,
5245,308,26,17,43,
5246,285,24,21,45,
5247,302,19,11,30,
5248,301,20,14,34,
5249,323,25,20,45,
5250,308,19,11,30,
5251,262,16,15,31,
5252,329,33,28,61,
5253,297,30,19,49,
5254,274,24,12,36,
5255,278,17,18,35,
5256,311,21,22,43,
5257,271,20,10,30,
5258,296,22,22,44,
5259,298,25,17,42,
5260,323,28,18,46,
5261,333,20,28,48,
5262,319,27,21,48,
5263,287,22,19,41,
5264,313,16,19,35,
5265,324,20,18,38,
5266,308,26,20,46,
5267,294,14,12,26,
5268,289,17,15,32,
5269,263,30,14,44,
5270,323,23,20,43,
5271,338,26,22,48,
5272,294,24,13,37,
5273,305,13,26,39,
5274,306,22,16,38,
5275,306,22,14,36,
5276,296,31,12,43,
5277,334,20,19,39,
5278,300,25,19,44,
5279,274,22,21,43,
5280,305,24,20,44,
5281,306,18,9,27,
5282,317,26,16,42,
5283,263,20,10,30,
5284,288,18,21,39,
5285,305,17,19,36,
5286,253,15,21,36,
5287,277,20,12,32,
5288,315,21,18,39,
5289,318,19,25,44,
5290,306,28,16,44,
5291,301,27,21,48,
5292,335,25,14,39,
5293,291,21,14,35,
5294,270,25,11,36,
5295,317,21,16,37,
5296,292,28,17,45,
5297,283,26,12,38,
5298,298,29,14,43,
5299,318,18,19,37,
5300,292,21,15,36,
5301,268,21,21,42,
5302,299,17,23,40,
5303,324,21,17,38,
5304,295,28,14,42,
5305,303,19,16,35,
5306,297,24,11,35,
5307,283,21,9,30,
5308,342,29,19,48,
5309,324,23,19,42,
5310,259,25,14,39,
5311,257,20,17,37,
5312,294,25,14,39,
5313,296,23,21,44,
5314,311,22,15,37,
5315,307,15,18,33,
5316,308,24,24,48,
5317,281,26,20,46,
5318,287,32,18,50,
5319,317,26,14,40,
5320,285,25,11,36,
5321,317,17,16,33,
5322,274,22,22,44,
5323,312,18,18,36,
5324,298,22,21,43,
5325,307,30,13,43,
5326,287,24,7,31,
5327,307,26,17,43,
5328,292,19,10,29,
5329,289,22,13,35,
5330,296,22,20,42,
5331,311,27,22,49,
5332,275,20,17,37,
5333,269,21,22,43,
5334,342,26,21,47,
5335,294,18,17,35,
5336,348,31,25,56,
5337,283,12,17,29,
5338,327,26,15,41,
5339,285,13,16,29,
5340,297,26,14,40,
5341,285,19,14,33,
5342,283,19,19,38,
5343,276,13,14,27,
5344,256,16,12,28,
5345,302,27,11,38,
5346,291,18,14,32,
5347,263,26,13,39,
5348,314,33,19,52,
5349,296,22,22,44,
5350,287,23,12,35,
5351,305,17,17,34,
5352,272,23,19,42,
5353,286,20,19,39,
5354,302,14,19,33,
5355,274,18,18,36,
5356,263,12,17,29,
5357,303,26,18,44,
5358,295,18,18,36,
5359,312,23,20,43,
5360,312,21,14,35,
5361,243,16,11,27,
5362,318,29,16,45,
5363,290,18,17,35,
5364,269,25,14,39,
5365,296,16,12,28,
5366,304,25,19,44,
5367,271,24,9,33,
5368,285,20,16,36,
5369,275,20,22,42,
5370,290,26,15,41,
5371,312,24,17,41,
5372,288,18,18,36,
5373,258,15,14,29,
5374,287,16,22,38,
5375,279,25,15,40,
5376,283,12,20,32,
5377,285,30,10,40,
5378,306,21,15,36,
5379,329,24,26,50,
5380,290,19,14,33,
5381,332,25,15,40,
5382,309,22,19,41,
5383,321,16,18,34,
5384,275,22,18,40,
5385,280,18,18,36,
5386,298,20,16,36,
5387,294,21,22,43,
5388,281,20,19,39,
5389,314,25,16,41,
5390,300,26,16,42,
5391,270,25,16,41,
5392,306,21,23,44,
5393,293,24,15,39,
5394,284,21,15,36,
5395,282,29,14,43,
5396,255,11,20,31,
5397,289,21,15,36,
5398,277,26,17,43,
5399,301,23,15,38,
5400,321,26,13,39,
5401,301,25,11,36,
5402,292,21,14,35,
5403,251,19,14,33,
5404,295,26,6,32,
5405,281,21,15,36,
5406,294,20,17,37,
5407,290,19,16,35,
5408,300,20,11,31,
5409,250,20,14,34,
5410,255,16,19,35,
5411,296,16,13,29,
5412,316,30,19,49,
5413,286,17,12,29,
5414,303,21,16,37,
5415,283,23,18,41,
5416,285,24,18,42,
5417,296,19,17,36,
5418,326,16,18,34,
5419,289,28,25,53,
5420,280,19,14,33,
5421,269,23,14,37,
5422,338,28,34,62,
5423,318,18,20,38,
5424,310,18,18,36,
5425,291,23,12,35,
5426,323,27,20,47,
5427,305,16,17,33,
5428,298,22,21,43,
5429,294,21,12,33,
5430,299,16,19,35,
5431,304,38,19,57,
5432,322,27,14,41,
5433,298,14,14,28,
5434,325,25,18,43,
5435,329,29,15,44,
5436,310,18,20,38,
5437,291,23,14,37,
5438,293,23,12,35,
5439,281,19,18,37,
5440,282,19,23,42,
5441,305,17,19,36,
5442,291,18,24,42,
5443,293,18,14,32,
5444,344,20,21,41,
5445,278,21,14,35,
5446,280,18,12,30,
5447,303,18,17,35,
5448,294,15,20,35,
5449,287,19,12,31,
5450,258,28,7,35,
5451,307,24,18,42,
5452,294,23,18,41,
5453,301,35,18,53,
5454,281,19,16,35,
5455,308,21,19,40,
5456,273,18,22,40,
5457,333,25,18,43,
5458,321,26,23,49,
5459,297,14,19,33,
5460,308,26,16,42,
5461,296,25,20,45,
5462,299,28,17,45,
5463,295,17,18,35,
5464,324,20,15,35,
5465,320,32,20,52,
5466,270,38,12,50,
5467,283,27,14,41,
5468,311,29,12,41,
5469,308,18,19,37,
5470,282,18,16,34,
5471,296,21,16,37,
5472,320,23,20,43,
5473,302,20,18,38,
5474,317,19,19,38,
5475,287,23,22,45,
5476,299,28,16,44,
5477,286,27,10,37,
5478,289,18,17,35,
5479,331,19,13,32,
5480,287,23,19,42,
5481,321,21,17,38,
5482,358,26,20,46,
5483,297,17,19,36,
5484,285,19,15,34,
5485,307,32,19,51,
5486,312,21,11,32,
5487,281,23,21,44,
5488,282,19,13,32,
5489,327,19,12,31,
5490,243,22,13,35,
5491,294,16,13,29,
5492,299,20,11,31,
5493,300,21,18,39,
5494,283,19,16,35,
5495,332,25,19,44,
5496,300,24,14,38,
5497,329,23,18,41,
5498,305,26,19,45,
5499,302,20,19,39,
5500,297,30,14,44,
5501,288,24,16,40,
5502,302,20,18,38,
5503,287,22,18,40,
5504,321,22,19,41,
5505,298,16,18,34,
5506,311,18,23,41,
5507,298,14,19,33,
5508,306,24,18,42,
5509,309,22,24,46,
5510,286,23,19,42,
5511,300,24,16,40,
5512,286,23,16,39,
5513,294,27,14,41,
5514,304,23,20,43,
5515,286,16,17,33,
5516,314,30,14,44,
5517,284,21,12,33,
5518,276,21,19,40,
5519,309,22,17,39,
5520,281,22,11,33,
5521,330,22,15,37,
5522,300,17,19,36,
5523,316,30,12,42,
5524,306,20,23,43,
5525,310,28,18,46,
5526,306,23,25,48,
5527,334,25,23,48,
5528,308,16,13,29,
5529,285,21,17,38,
5530,291,29,13,42,
5531,288,24,24,48,
5532,299,23,16,39,
5533,289,20,14,34,
5534,276,24,13,37,
5535,299,25,16,41,
5536,280,20,16,36,
5537,304,25,13,38,
5538,286,17,17,34,
5539,320,20,17,37,
5540,297,19,18,37,
5541,302,21,15,36,
5542,293,22,19,41,
5543,291,21,16,37,
5544,289,15,9,24,
5545,279,21,13,34,
5546,290,22,14,36,
5547,245,20,14,34,
5548,311,21,16,37,
5549,286,24,16,40,
5550,305,25,18,43,
5551,291,23,16,39,
5552,280,24,18,42,
5553,301,31,16,47,
5554,304,31,14,45,
5555,293,16,22,38,
5556,288,24,22,46,
5557,319,23,19,42,
5558,313,24,19,43,
5559,303,18,23,41,
5560,308,14,18,32,
5561,296,20,26,46,
5562,320,24,15,39,
5563,272,22,14,36,
5564,292,24,20,44,
5565,291,31,17,48,
5566,300,24,17,41,
5567,272,27,17,44,
5568,299,16,21,37,
5569,316,22,15,37,
5570,317,19,24,43,
5571,322,25,14,39,
5572,327,24,21,45,
5573,277,27,12,39,
5574,318,16,16,32,
5575,289,27,21,48,
5576,304,16,21,37,
5577,309,26,23,49,
5578,336,14,22,36,
5579,268,17,16,33,
5580,333,30,17,47,
5581,278,16,20,36,
5582,298,20,12,32,
5583,286,19,18,37,
5584,275,20,12,32,
5585,318,29,23,52,
5586,294,23,17,40,
5587,303,11,30,41,
5588,311,31,18,49,
5589,273,24,17,41,
5590,288,14,13,27,
5591,290,21,17,38,
5592,287,22,17,39,
5593,315,26,15,41,
5594,294,23,18,41,
5595,301,25,19,44,
5596,333,22,15,37,
5597,280,22,15,37,
5598,287,24,15,39,
5599,316,20,25,45,
5600,303,19,7,26,
5601,285,21,25,46,
5602,299,26,16,42,
5603,323,23,20,43,
5604,346,26,21,47,
5605,332,23,18,41,
5606,268,17,19,36,
5607,263,20,13,33,
5608,298,27,18,45,
5609,296,22,16,38,
5610,259,10,10,20,
5611,315,17,18,35,
5612,285,10,19,29,
5613,300,22,12,34,
5614,303,28,13,41,
5615,313,20,14,34,
5616,303,13,19,32,
5617,285,18,15,33,
5618,288,22,15,37,
5619,276,19,18,37,
5620,292,20,10,30,
5621,306,19,16,35,
5622,287,18,20,38,
5623,279,27,12,39,
5624,240,17,13,30,
5625,286,12,17,29,
5626,324,20,11,31,
5627,286,19,16,35,
5628,294,20,8,28,
5629,299,24,16,40,
5630,278,20,14,34,
5631,296,20,15,35,
5632,282,17,13,30,
5633,286,24,12,36,
5634,317,20,19,39,
5635,271,18,16,34,
5636,325,28,23,51,
5637,278,20,18,38,
5638,291,27,16,43,
5639,292,18,20,38,
5640,278,27,18,45,
5641,290,17,15,32,
5642,332,26,16,42,
5643,311,20,24,44,
5644,308,22,14,36,
5645,328,26,17,43,
5646,318,28,24,52,
5647,267,19,14,33,
5648,279,22,19,41,
5649,297,19,16,35,
5650,273,24,14,38,
5651,332,30,19,49,
5652,334,28,7,35,
5653,283,19,9,28,
5654,327,35,13,48,
5655,280,18,16,34,
5656,286,25,11,36,
5657,304,25,17,42,
5658,276,22,23,45,
5659,286,24,15,39,
5660,309,27,19,46,
5661,279,20,19,39,
5662,302,16,19,35,
5663,295,27,18,45,
5664,295,15,22,37,
5665,287,15,16,31,
5666,314,16,15,31,
5667,299,27,15,42,
5668,306,21,17,38,
5669,308,19,19,38,
5670,298,22,21,43,
5671,309,16,15,31,
5672,284,23,20,43,
5673,299,21,16,37,
5674,291,20,22,42,
5675,312,16,20,36,
5676,285,25,14,39,
5677,280,25,17,42,
5678,282,17,10,27,
5679,259,20,13,33,
5680,289,27,20,47,
5681,301,23,11,34,
5682,289,27,23,50,
5683,326,31,16,47,
5684,310,35,13,48,
5685,288,20,13,33,
5686,291,27,17,44,
5687,279,21,15,36,
5688,290,20,21,41,
5689,333,22,19,41,
5690,291,14,12,26,
5691,278,19,13,32,
5692,309,18,17,35,
5693,293,19,15,34,
5694,292,23,26,49,
5695,303,21,12,33,
5696,298,19,15,34,
5697,289,21,18,39,
5698,303,27,18,45,
5699,302,17,14,31,
5700,286,21,13,34,
5701,291,19,15,34,
5702,313,25,10,35,
5703,301,22,10,32,
5704,322,20,18,38,
5705,281,21,12,33,
5706,314,20,19,39,
5707,290,22,14,36,
5708,294,23,15,38,
5709,286,19,20,39,
5710,293,26,10,36,
5711,298,20,16,36,
5712,308,22,16,38,
5713,268,24,14,38,
5714,272,23,10,33,
5715,303,22,20,42,
5716,293,16,21,37,
5717,317,29,23,52,
5718,307,35,16,51,
5719,305,16,14,30,
5720,285,19,21,40,
5721,296,22,20,42,
5722,306,34,16,50,
5723,308,25,14,39,
5724,295,18,16,34,
5725,303,23,18,41,
5726,307,20,21,41,
5727,310,21,21,42,
5728,313,10,26,36,
5729,291,23,15,38,
5730,298,35,14,49,
5731,295,26,17,43,
5732,283,17,12,29,
5733,301,29,16,45,
5734,290,24,12,36,
5735,288,26,10,36,
5736,326,22,16,38,
5737,281,23,28,51,
5738,266,26,11,37,
5739,292,22,18,40,
5740,262,17,16,33,
5741,289,20,18,38,
5742,313,27,16,43,
5743,324,19,15,34,
5744,291,18,17,35,
5745,256,20,23,43,
5746,318,35,8,43,
5747,289,21,12,33,
5748,285,18,15,33,
5749,299,26,19,45,
5750,284,23,24,47,
5751,330,30,23,53,
5752,302,34,16,50,
5753,318,24,25,49,
5754,321,24,12,36,
5755,304,19,22,41,
5756,312,25,16,41,
5757,298,25,20,45,
5758,284,27,18,45,
5759,300,16,17,33,
5760,289,16,17,33,
5761,329,24,12,36,
5762,292,14,22,36,
5763,338,27,19,46,
5764,297,16,23,39,
5765,302,29,21,50,
5766,268,22,11,33,
5767,287,26,18,44,
5768,329,20,23,43,
5769,302,23,20,43,
5770,313,20,24,44,
5771,307,28,10,38,
5772,315,25,18,43,
5773,271,15,15,30,
5774,271,18,14,32,
5775,265,16,16,32,
5776,272,23,23,46,
5777,293,17,17,34,
5778,270,17,22,39,
5779,287,22,22,44,
5780,281,18,9,27,
5781,296,31,15,46,
5782,317,22,23,45,
5783,304,16,19,35,
5784,338,26,23,49,
5785,321,27,22,49,
5786,311,12,12,24,
5787,314,23,20,43,
5788,289,16,21,37,
5789,276,15,17,32,
5790,300,23,17,40,
5791,312,34,26,60,
5792,288,23,21,44,
5793,318,29,23,52,
5794,304,19,21,40,
5795,281,31,19,50,
5796,290,16,20,36,
5797,304,26,15,41,
5798,274,23,18,41,
5799,318,19,19,38,
5800,280,23,18,41,
5801,299,24,19,43,
5802,333,21,11,32,
5803,296,22,18,40,
5804,292,33,20,53,
5805,297,17,24,41,
5806,304,22,19,41,
5807,262,18,21,39,
5808,297,24,21,45,
5809,278,20,19,39,
5810,277,22,13,35,
5811,308,15,21,36,
5812,315,11,20,31,
5813,289,22,13,35,
5814,308,26,9,35,
5815,279,28,17,45,
5816,263,21,19,40,
5817,307,25,18,43,
5818,245,11,10,21,
5819,278,19,12,31,
5820,304,27,19,46,
5821,254,18,14,32,
5822,278,16,16,32,
5823,311,25,19,44,
5824,318,14,13,27,
5825,308,17,16,33,
5826,298,19,24,43,
5827,293,20,25,45,
5828,258,18,12,30,
5829,303,23,20,43,
5830,333,33,28,61,
5831,308,22,26,48,
5832,305,20,16,36,
5833,270,24,20,44,
5834,310,18,17,35,
5835,305,19,15,34,
5836,301,20,25,45,
5837,301,28,17,45,
5838,289,23,18,41,
5839,290,19,12,31,
5840,300,16,14,30,
5841,293,21,16,37,
5842,292,20,17,37,
5843,306,29,22,51,
5844,316,28,22,50,
5845,258,19,18,37,
5846,317,21,19,40,
5847,303,28,19,47,
5848,290,17,24,41,
5849,340,30,21,51,
5850,323,23,15,38,
5851,300,25,14,39,
5852,309,25,11,36,
5853,261,16,9,25,
5854,295,26,18,44,
5855,310,26,10,36,
5856,275,15,13,28,
5857,290,16,15,31,
5858,282,18,11,29,
5859,314,28,19,47,
5860,293,29,13,42,
5861,311,23,20,43,
5862,282,16,11,27,
5863,324,18,23,41,
5864,282,25,7,32,
5865,282,18,12,30,
5866,293,20,18,38,
5867,296,20,16,36,
5868,288,32,9,41,
5869,279,19,23,42,
5870,296,22,20,42,
5871,285,21,12,33,
5872,311,19,14,33,
5873,299,26,24,50,
5874,303,24,23,47,
5875,312,29,14,43,
5876,294,17,15,32,
5877,254,17,15,32,
5878,292,24,8,32,
5879,286,23,18,41,
5880,303,22,18,40,
5881,286,24,16,40,
5882,291,22,12,34,
5883,283,21,9,30,
5884,302,19,27,46,
5885,289,25,17,42,
5886,296,24,9,33,
5887,287,22,25,47,
5888,271,17,17,34,
5889,273,22,20,42,
5890,300,24,16,40,
5891,281,20,21,41,
5892,277,16,19,35,
5893,280,18,22,40,
5894,302,22,16,38,
5895,308,26,20,46,
5896,285,20,19,39,
5897,305,29,19,48,
5898,316,20,16,36,
5899,298,15,23,38,
5900,292,18,17,35,
5901,282,17,14,31,
5902,311,20,12,32,
5903,290,22,19,41,
5904,283,15,19,34,
5905,270,18,20,38,
5906,284,24,18,42,
5907,284,21,8,29,
5908,282,22,5,27,
5909,283,21,22,43,
5910,295,24,15,39,
5911,279,27,18,45,
5912,303,20,17,37,
5913,308,18,16,34,
5914,303,18,25,43,
5915,281,20,10,30,
5916,273,20,16,36,
5917,303,26,20,46,
5918,287,17,9,26,
5919,286,22,12,34,
5920,330,25,26,51,
5921,314,23,11,34,
5922,272,23,14,37,
5923,273,17,12,29,
5924,303,29,10,39,
5925,333,24,20,44,
5926,338,15,15,30,
5927,322,27,17,44,
5928,285,17,14,31,
5929,302,22,16,38,
5930,319,24,16,40,
5931,307,19,19,38,
5932,308,25,25,50,
5933,298,23,23,46,
5934,291,20,24,44,
5935,297,17,22,39,
5936,323,16,28,44,
5937,301,20,20,40,
5938,267,17,9,26,
5939,310,27,16,43,
5940,340,30,20,50,
5941,306,23,17,40,
5942,328,21,20,41,
5943,283,16,7,23,
5944,297,21,20,41,
5945,280,21,19,40,
5946,287,33,11,44,
5947,319,19,15,34,
5948,300,21,20,41,
5949,287,22,24,46,
5950,275,27,12,39,
5951,294,21,20,41,
5952,303,18,14,32,
5953,291,18,25,43,
5954,283,21,20,41,
5955,309,22,18,40,
5956,283,22,21,43,
5957,328,24,15,39,
5958,284,15,14,29,
5959,274,22,20,42,
5960,297,25,17,42,
5961,292,20,13,33,
5962,315,30,27,57,
5963,264,22,19,41,
5964,312,28,16,44,
5965,311,22,15,37,
5966,288,21,10,31,
5967,315,23,21,44,
5968,240,15,18,33,
5969,302,19,23,42,
5970,292,16,16,32,
5971,329,19,16,35,
5972,306,14,22,36,
5973,309,19,22,41,
5974,269,23,16,39,
5975,309,24,19,43,
5976,287,20,14,34,
5977,324,24,17,41,
5978,310,27,22,49,
5979,321,21,23,44,
5980,299,17,24,41,
5981,302,19,21,40,
5982,273,20,14,34,
5983,289,20,19,39,
5984,271,17,19,36,
5985,308,28,16,44,
5986,308,29,14,43,
5987,292,21,18,39,
5988,310,21,19,40,
5989,300,20,18,38,
5990,304,28,13,41,
5991,301,20,20,40,
5992,338,30,15,45,
5993,310,26,16,42,
5994,275,12,14,26,
5995,281,20,16,36,
5996,287,17,22,39,
5997,316,22,14,36,
5998,306,21,22,43,
5999,276,16,17,33,
6000,291,19,16,35,
6001,274,17,15,32,
6002,307,30,20,50,
6003,294,25,19,44,
6004,293,22,11,33,
6005,284,27,13,40,
6006,323,16,26,42,
6007,264,12,18,30,
6008,302,23,16,39,
6009,279,14,13,27,
6010,306,19,18,37,
6011,310,25,20,45,
6012,293,15,15,30,
6013,306,26,18,44,
6014,313,17,14,31,
6015,312,20,15,35,
6016,288,17,8,25,
6017,277,15,22,37,
6018,314,25,23,48,
6019,292,22,18,40,
6020,243,17,12,29,
6021,311,22,23,45,
6022,323,29,26,55,
6023,304,30,14,44,
6024,291,18,12,30,
6025,270,19,11,30,
6026,334,17,15,32,
6027,315,20,21,41,
6028,324,29,25,54,
6029,283,28,12,40,
6030,293,25,14,39,
6031,315,28,15,43,
6032,303,11,22,33,
6033,270,26,10,36,
6034,283,23,8,31,
6035,285,30,13,43,
6036,271,27,12,39,
6037,303,22,19,41,
6038,309,24,19,43,
6039,276,16,28,44,
6040,287,26,24,50,
6041,315,29,15,44,
6042,302,23,20,43,
6043,296,26,21,47,
6044,331,22,18,40,
6045,289,23,15,38,
6046,327,22,18,40,
6047,271,21,13,34,
6048,287,18,25,43,
6049,300,18,12,30,
6050,303,22,21,43,
6051,299,21,15,36,
6052,300,20,16,36,
6053,311,20,25,45,
6054,310,20,18,38,
6055,292,20,18,38,
6056,297,18,13,31,
6057,294,24,9,33,
6058,289,15,20,35,
6059,311,18,16,34,
6060,319,28,20,48,
6061,332,29,18,47,
6062,332,21,15,36,
6063,339,25,30,55,
6064,288,25,18,43,
6065,299,21,19,40,
6066,290,20,24,44,
6067,304,17,12,29,
6068,308,19,19,38,
6069,288,18,19,37,
6070,311,19,16,35,
6071,328,16,11,27,
6072,312,32,21,53,
6073,300,23,19,42,
6074,300,21,20,41,
6075,282,20,13,33,
6076,271,18,17,35,
6077,312,23,21,44,
6078,307,20,21,41,
6079,301,20,18,38,
6080,285,20,18,38,
6081,292,18,18,36,
6082,324,21,14,35,
6083,320,21,22,43,
6084,263,13,13,26,
6085,310,19,17,36,
6086,300,12,16,28,
6087,284,27,21,48,
6088,293,29,17,46,
6089,274,15,17,32,
6090,282,13,19,32,
6091,285,23,12,35,
6092,294,16,21,37,
6093,332,23,30,53,
6094,305,19,15,34,
6095,324,21,23,44,
6096,323,31,16,47,
6097,304,29,10,39,
6098,300,19,17,36,
6099,276,25,13,38,
6100,296,26,14,40,
6101,279,20,17,37,
6102,295,21,22,43,
6103,324,23,24,47,
6104,319,25,22,47,
6105,289,16,21,37,
6106,316,23,20,43,
6107,298,21,12,33,
6108,293,26,13,39,
6109,305,22,17,39,
6110,267,16,12,28,
6111,309,17,25,42,
6112,276,17,10,27,
6113,275,19,11,30,
6114,330,21,21,42,
6115,343,23,28,51,
6116,308,28,15,43,
6117,294,22,23,45,
6118,247,14,18,32,
6119,303,16,21,37,
6120,322,23,19,42,
6121,305,22,28,50,
6122,255,16,11,27,
6123,317,15,18,33,
6124,327,40,16,56,
6125,269,17,14,31,
6126,281,21,15,36,
6127,300,31,18,49,
6128,308,33,14,47,
6129,263,19,20,39,
6130,309,27,18,45,
6131,328,28,16,44,
6132,292,14,18,32,
6133,314,20,21,41,
6134,279,20,17,37,
6135,278,18,19,37,
6136,294,16,12,28,
6137,265,19,17,36,
6138,299,26,19,45,
6139,338,20,23,43,
6140,301,21,9,30,
6141,287,11,13,24,
6142,259,20,11,31,
6143,297,21,16,37,
6144,235,15,8,23,
6145,312,18,16,34,
6146,317,19,20,39,
6147,291,17,11,28,
6148,305,18,16,34,
6149,281,20,17,37,
6150,262,23,17,40,
6151,290,20,22,42,
6152,292,19,13,32,
6153,294,23,15,38,
6154,294,27,19,46,
6155,282,21,15,36,
6156,296,19,12,31,
6157,282,20,20,40,
6158,309,19,21,40,
6159,292,31,14,45,
6160,281,25,13,38,
6161,293,20,20,40,
6162,290,20,19,39,
6163,291,24,25,49,
6164,288,20,15,35,
6165,278,23,16,39,
6166,289,24,17,41,
6167,285,31,19,50,
6168,322,22,19,41,
6169,287,18,19,37,
6170,297,22,17,39,
6171,288,18,12,30,
6172,286,8,18,26,
6173,277,17,16,33,
6174,303,26,24,50,
6175,269,19,13,32,
6176,326,24,16,40,
6177,308,19,14,33,
6178,297,29,13,42,
6179,310,20,10,30,
6180,277,14,22,36,
6181,317,24,19,43,
6182,308,12,14,26,
6183,273,20,7,27,
6184,288,25,15,40,
6185,295,21,12,33,
6186,325,21,19,40,
6187,284,29,15,44,
6188,324,27,12,39,
6189,297,16,9,25,
6190,306,29,21,50,
6191,294,18,16,34,
6192,314,19,15,34,
6193,291,19,14,33,
6194,315,19,7,26,
6195,324,23,7,30,
6196,269,24,10,34,
6197,325,23,19,42,
6198,286,26,14,40,
6199,303,25,11,36,
6200,275,20,15,35,
6201,297,19,15,34,
6202,312,20,13,33,
6203,288,23,11,34,
6204,299,23,20,43,
6205,293,22,14,36,
6206,328,24,17,41,
6207,257,13,22,35,
6208,285,21,17,38,
6209,281,18,19,37,
6210,295,32,16,48,
6211,319,20,25,45,
6212,275,19,21,40,
6213,286,20,20,40,
6214,303,18,16,34,
6215,312,30,11,41,
6216,282,22,23,45,
6217,314,26,18,44,
6218,279,15,14,29,
6219,310,21,9,30,
6220,300,28,25,53,
6221,315,21,23,44,
6222,313,20,14,34,
6223,295,22,20,42,
6224,282,21,14,35,
6225,291,22,17,39,
6226,318,24,14,38,
6227,283,28,20,48,
6228,308,21,23,44,
6229,323,26,17,43,
6230,298,22,18,40,
6231,311,25,21,46,
6232,281,21,18,39,
6233,309,18,22,40,
6234,310,18,20,38,
6235,309,26,20,46,
6236,297,18,17,35,
6237,299,19,18,37,
6238,297,23,18,41,
6239,291,17,16,33,
6240,270,23,13,36,
6241,311,32,16,48,
6242,310,17,16,33,
6243,284,20,19,39,
6244,297,13,18,31,
6245,304,22,14,36,
6246,289,26,15,41,
6247,283,20,22,42,
6248,305,28,14,42,
6249,301,22,20,42,
6250,321,20,22,42,
6251,293,14,11,25,
6252,316,21,20,41,
6253,279,19,16,35,
6254,277,16,10,26,
6255,276,20,18,38,
6256,301,24,28,52,
6257,320,22,21,43,
6258,311,17,11,28,
6259,302,26,19,45,
6260,318,25,9,34,
6261,288,13,19,32,
6262,316,18,25,43,
6263,306,18,11,29,
6264,291,17,21,38,
6265,307,16,14,30,
6266,275,27,14,41,
6267,320,26,17,43,
6268,322,25,16,41,
6269,277,18,17,35,
6270,283,27,15,42,
6271,301,29,12,41,
6272,305,19,13,32,
6273,279,20,20,40,
6274,318,23,24,47,
6275,315,19,21,40,
6276,290,23,21,44,
6277,300,22,14,36,
6278,290,23,21,44,
6279,306,25,16,41,
6280,286,19,21,40,
6281,278,11,8,19,
6282,297,22,9,31,
6283,264,15,12,27,
6284,293,26,19,45,
6285,293,23,25,48,
6286,301,24,16,40,
6287,305,29,18,47,
6288,293,18,16,34,
6289,292,37,20,57,
6290,296,22,19,41,
6291,300,16,15,31,
6292,281,25,19,44,
6293,276,22,19,41,
6294,278,21,13,34,
6295,316,17,20,37,
6296,314,22,16,38,
6297,303,23,22,45,
6298,295,22,15,37,
6299,275,22,19,41,
6300,316,30,13,43,
6301,316,32,20,52,
6302,331,23,19,42,
6303,269,14,11,25,
6304,316,29,19,48,
6305,302,19,18,37,
6306,281,15,16,31,
6307,282,16,20,36,
6308,284,19,18,37,
6309,282,23,25,48,
6310,275,25,12,37,
6311,278,23,22,45,
6312,299,16,18,34,
6313,280,14,18,32,
6314,276,18,11,29,
6315,315,25,11,36,
6316,307,20,16,36,
6317,279,15,15,30,
6318,282,23,16,39,
6319,325,35,17,52,
6320,293,20,18,38,
6321,279,22,16,38,
6322,313,26,18,44,
6323,300,26,19,45,
6324,306,28,16,44,
6325,311,23,13,36,
6326,332,18,19,37,
6327,297,14,22,36,
6328,314,21,21,42,
6329,284,23,13,36,
6330,314,24,18,42,
6331,304,25,13,38,
6332,299,23,15,38,
6333,307,15,10,25,
6334,275,13,17,30,
6335,297,22,14,36,
6336,349,19,10,29,
6337,290,23,16,39,
6338,293,14,10,24,
6339,304,26,10,36,
6340,293,23,15,38,
6341,307,22,18,40,
6342,332,20,19,39,
6343,310,23,13,36,
6344,278,20,12,32,
6345,303,26,15,41,
6346,310,25,16,41,
6347,308,20,18,38,
6348,305,19,19,38,
6349,316,21,12,33,
6350,334,30,25,55,
6351,292,22,11,33,
6352,298,27,14,41,
6353,300,21,23,44,
6354,301,24,20,44,
6355,326,24,19,43,
6356,288,30,12,42,
6357,288,24,9,33,
6358,287,23,17,40,
6359,298,28,19,47,
6360,265,15,20,35,
6361,291,17,18,35,
6362,296,20,17,37,
6363,297,19,27,46,
6364,318,22,25,47,
6365,301,20,17,37,
6366,323,26,18,44,
6367,307,23,14,37,
6368,288,15,21,36,
6369,296,17,14,31,
6370,272,18,11,29,
6371,316,18,16,34,
6372,289,17,19,36,
6373,339,23,24,47,
6374,305,20,19,39,
6375,292,24,19,43,
6376,298,22,19,41,
6377,295,27,9,36,
6378,319,35,18,53,
6379,304,16,29,45,
6380,273,23,15,38,
6381,286,24,13,37,
6382,311,21,27,48,
6383,305,24,20,44,
6384,304,21,16,37,
6385,288,26,14,40,
6386,311,22,14,36,
6387,291,23,11,34,
6388,309,25,19,44,
6389,322,35,23,58,
6390,285,30,18,48,
6391,311,31,20,51,
6392,314,29,14,43,
6393,272,15,16,31,
6394,316,22,22,44,
6395,333,32,19,51,
6396,280,25,18,43,
6397,283,19,15,34,
6398,252,15,14,29,
6399,310,15,24,39,
6400,297,16,13,29,
6401,317,16,21,37,
6402,331,23,19,42,
6403,300,20,21,41,
6404,320,28,17,45,
6405,324,23,18,41,
6406,282,20,13,33,
6407,316,20,10,30,
6408,315,24,22,46,
6409,291,25,14,39,
6410,296,22,19,41,
6411,271,23,15,38,
6412,295,15,16,31,
6413,299,17,24,41,
6414,315,22,11,33,
6415,289,11,14,25,
6416,307,33,19,52,
6417,303,23,27,50,
6418,285,22,18,40,
6419,274,22,22,44,
6420,264,9,9,18,
6421,285,27,19,46,
6422,331,20,24,44,
6423,330,22,20,42,
6424,288,10,17,27,
6425,306,19,21,40,
6426,303,21,18,39,
6427,305,29,16,45,
6428,300,19,19,38,
6429,292,36,21,57,
6430,296,25,20,45,
6431,290,19,14,33,
6432,307,17,22,39,
6433,322,23,21,44,
6434,313,29,26,55,
6435,268,13,22,35,
6436,266,26,16,42,
6437,282,18,21,39,
6438,328,20,12,32,
6439,295,22,12,34,
6440,300,18,10,28,
6441,295,20,13,33,
6442,283,17,12,29,
6443,267,22,18,40,
6444,287,15,14,29,
6445,263,18,17,35,
6446,291,17,17,34,
6447,307,24,11,35,
6448,293,27,16,43,
6449,301,19,11,30,
6450,301,23,15,38,
6451,289,10,17,27,
6452,259,11,15,26,
6453,315,24,15,39,
6454,303,18,14,32,
6455,293,27,12,39,
6456,305,18,12,30,
6457,303,14,20,34,
6458,304,28,12,40,
6459,284,16,20,36,
6460,300,25,13,38,
6461,292,23,21,44,
6462,297,20,12,32,
6463,308,22,13,35,
6464,284,14,18,32,
6465,311,19,11,30,
6466,290,22,18,40,
6467,263,18,16,34,
6468,293,28,16,44,
6469,314,29,20,49,
6470,321,24,16,40,
6471,332,19,14,33,
6472,325,20,19,39,
6473,291,24,18,42,
6474,304,23,15,38,
6475,329,25,17,42,
6476,350,26,21,47,
6477,242,14,12,26,
6478,329,14,16,30,
6479,289,17,23,40,
6480,330,26,10,36,
6481,305,21,22,43,
6482,315,22,17,39,
6483,302,22,16,38,
6484,277,16,16,32,
6485,298,17,21,38,
6486,271,17,11,28,
6487,277,22,18,40,
6488,263,18,11,29,
6489,329,29,14,43,
6490,255,16,16,32,
6491,319,23,21,44,
6492,314,16,20,36,
6493,293,25,12,37,
6494,288,19,15,34,
6495,304,26,14,40,
6496,304,24,16,40,
6497,325,20,22,42,
6498,301,13,17,30,
6499,319,23,26,49,
6500,303,17,27,44,
6501,317,26,16,42,
6502,302,28,19,47,
6503,279,17,13,30,
6504,306,13,14,27,
6505,314,30,15,45,
6506,293,29,15,44,
6507,308,21,14,35,
6508,317,21,21,42,
6509,338,24,20,44,
6510,278,24,11,35,
6511,299,20,18,38,
6512,314,30,16,46,
6513,300,30,20,50,
6514,270,28,13,41,
6515,305,24,16,40,
6516,276,24,16,40,
6517,272,20,22,42,
6518,283,24,19,43,
6519,294,29,15,44,
6520,297,24,12,36,
6521,297,21,10,31,
6522,313,21,20,41,
6523,290,22,16,38,
6524,294,19,17,36,
6525,306,23,13,36,
6526,298,20,18,38,
6527,309,25,15,40,
6528,276,24,12,36,
6529,342,31,16,47,
6530,303,22,19,41,
6531,292,24,19,43,
6532,306,21,20,41,
6533,258,17,17,34,
6534,296,21,18,39,
6535,303,19,19,38,
6536,275,21,16,37,
6537,265,17,12,29,
6538,291,27,10,37,
6539,297,18,19,37,
6540,285,15,9,24,
6541,314,21,22,43,
6542,311,20,18,38,
6543,316,15,18,33,
6544,280,18,10,28,
6545,284,17,13,30,
6546,295,22,19,41,
6547,276,18,22,40,
6548,277,17,14,31,
6549,278,28,14,42,
6550,280,22,14,36,
6551,281,14,12,26,
6552,282,25,19,44,
6553,303,24,18,42,
6554,283,25,16,41,
6555,324,23,18,41,
6556,282,15,16,31,
6557,307,16,23,39,
6558,309,16,17,33,
6559,334,33,20,53,
6560,286,21,18,39,
6561,295,22,18,40,
6562,305,22,25,47,
6563,298,20,23,43,
6564,301,24,17,41,
6565,276,16,18,34,
6566,282,20,25,45,
6567,280,22,16,38,
6568,269,13,14,27,
6569,298,19,21,40,
6570,301,26,16,42,
6571,273,18,20,38,
6572,276,22,15,37,
6573,311,30,22,52,
6574,298,17,14,31,
6575,339,24,24,48,
6576,287,18,10,28,
6577,310,15,21,36,
6578,298,23,11,34,
6579,288,15,24,39,
6580,289,26,5,31,
6581,297,28,16,44,
6582,263,16,11,27,
6583,300,22,11,33,
6584,271,24,9,33,
6585,318,17,24,41,
6586,292,17,14,31,
6587,307,27,13,40,
6588,307,19,16,35,
6589,258,15,18,33,
6590,276,19,17,36,
6591,271,18,21,39,
6592,299,24,17,41,
6593,302,34,13,47,
6594,285,27,16,43,
6595,318,29,14,43,
6596,285,15,20,35,
6597,296,20,18,38,
6598,317,23,23,46,
6599,273,22,15,37,
6600,295,17,17,34,
6601,292,22,16,38,
6602,295,16,17,33,
6603,288,20,20,40,
6604,271,21,19,40,
6605,293,19,15,34,
6606,334,27,17,44,
6607,310,17,12,29,
6608,285,21,20,41,
6609,306,22,20,42,
6610,320,31,13,44,
6611,296,15,19,34,
6612,300,25,13,38,
6613,291,19,13,32,
6614,300,24,20,44,
6615,296,19,20,39,
6616,288,17,16,33,
6617,295,25,18,43,
6618,318,19,24,43,
6619,337,13,23,36,
6620,295,24,14,38,
6621,288,25,18,43,
6622,326,23,24,47,
6623,298,17,12,29,
6624,299,22,16,38,
6625,315,25,23,48,
6626,287,15,11,26,
6627,321,24,14,38,
6628,310,22,21,43,
6629,266,16,19,35,
6630,306,13,11,24,
6631,336,21,16,37,
6632,289,30,15,45,
6633,292,16,14,30,
6634,281,21,18,39,
6635,277,30,12,42,
6636,286,23,14,37,
6637,287,22,13,35,
6638,322,28,12,40,
6639,305,26,19,45,
6640,313,17,23,40,
6641,291,21,8,29,
6642,306,24,21,45,
6643,279,18,16,34,
6644,314,20,23,43,
6645,316,17,26,43,
6646,331,24,20,44,
6647,336,23,22,45,
6648,295,28,16,44,
6649,307,22,20,42,
6650,278,27,17,44,
6651,280,19,16,35,
6652,314,24,14,38,
6653,323,17,22,39,
6654,253,19,17,36,
6655,302,26,17,43,
6656,294,21,16,37,
6657,290,22,16,38,
6658,321,23,21,44,
6659,323,17,13,30,
6660,281,23,18,41,
6661,293,14,21,35,
6662,279,19,19,38,
6663,290,17,20,37,
6664,275,18,20,38,
6665,287,23,11,34,
6666,271,20,15,35,
6667,305,18,16,34,
6668,301,21,17,38,
6669,278,22,19,41,
6670,289,24,17,41,
6671,287,18,12,30,
6672,288,22,20,42,
6673,287,31,13,44,
6674,319,25,15,40,
6675,314,26,25,51,
6676,299,22,15,37,
6677,288,20,12,32,
6678,278,16,19,35,
6679,303,17,16,33,
6680,296,14,16,30,
6681,319,20,20,40,
6682,302,24,15,39,
6683,290,23,18,41,
6684,335,25,27,52,
6685,308,28,15,43,
6686,300,21,19,40,
6687,276,19,12,31,
6688,302,23,23,46,
6689,275,15,23,38,
6690,302,25,21,46,
6691,270,20,13,33,
6692,289,35,17,52,
6693,302,16,13,29,
6694,270,32,15,47,
6695,312,18,19,37,
6696,276,21,11,32,
6697,273,18,17,35,
6698,279,22,13,35,
6699,334,29,19,48,
6700,290,28,19,47,
6701,277,21,14,35,
6702,294,30,12,42,
6703,305,28,15,43,
6704,303,22,15,37,
6705,306,23,17,40,
6706,296,25,17,42,
6707,304,28,13,41,
6708,332,22,26,48,
6709,311,18,14,32,
6710,302,25,14,39,
6711,296,15,15,30,
6712,304,26,14,40,
6713,298,26,13,39,
6714,284,16,16,32,
6715,318,19,24,43,
6716,282,16,13,29,
6717,296,26,13,39,
6718,289,19,16,35,
6719,274,22,11,33,
6720,304,16,14,30,
6721,317,18,16,34,
6722,309,27,12,39,
6723,298,21,14,35,
6724,295,26,14,40,
6725,308,22,16,38,
6726,280,21,12,33,
6727,280,19,17,36,
6728,310,21,23,44,
6729,280,24,22,46,
6730,272,14,16,30,
6731,335,25,18,43,
6732,287,23,16,39,
6733,305,22,20,42,
6734,286,29,10,39,
6735,299,16,15,31,
6736,292,22,22,44,
6737,318,25,15,40,
6738,313,22,22,44,
6739,317,23,25,48,
6740,273,12,13,25,
6741,283,18,17,35,
6742,283,21,16,37,
6743,319,25,20,45,
6744,286,19,17,36,
6745,284,18,19,37,
6746,312,28,10,38,
6747,321,27,25,52,
6748,290,28,18,46,
6749,285,16,13,29,
6750,300,23,14,37,
6751,333,22,19,41,
6752,260,11,14,25,
6753,298,21,22,43,
6754,308,15,24,39,
6755,296,22,17,39,
6756,294,19,22,41,
6757,306,23,24,47,
6758,301,17,15,32,
6759,313,23,14,37,
6760,279,25,11,36,
6761,301,24,26,50,
6762,274,25,13,38,
6763,284,25,13,38,
6764,294,25,19,44,
6765,290,17,21,38,
6766,271,17,18,35,
6767,306,31,18,49,
6768,295,14,18,32,
6769,310,17,20,37,
6770,303,25,22,47,
6771,302,22,19,41,
6772,270,13,18,31,
6773,254,20,17,37,
6774,303,10,14,24,
6775,296,21,18,39,
6776,321,27,23,50,
6777,339,19,15,34,
6778,307,21,18,39,
6779,313,25,13,38,
6780,277,15,13,28,
6781,277,17,21,38,
6782,309,23,22,45,
6783,314,29,17,46,
6784,285,19,11,30,
6785,317,19,20,39,
6786,280,24,14,38,
6787,302,31,18,49,
6788,325,20,17,37,
6789,259,15,17,32,
6790,306,19,13,32,
6791,303,21,13,34,
6792,301,18,20,38,
6793,291,20,27,47,
6794,285,20,22,42,
6795,284,28,18,46,
6796,294,26,11,37,
6797,271,19,9,28,
6798,269,23,12,35,
6799,294,16,15,31,
6800,286,21,17,38,
6801,275,17,18,35,
6802,287,19,17,36,
6803,277,18,15,33,
6804,309,22,11,33,
6805,323,35,23,58,
6806,295,26,17,43,
6807,296,14,19,33,
6808,305,26,25,51,
6809,303,21,14,35,
6810,293,17,15,32,
6811,333,20,17,37,
6812,314,20,14,34,
6813,287,28,19,47,
6814,282,18,21,39,
6815,308,23,17,40,
6816,306,21,18,39,
6817,318,20,16,36,
6818,321,22,24,46,
6819,312,26,14,40,
6820,318,21,24,45,
6821,303,22,15,37,
6822,294,25,14,39,
6823,311,27,17,44,
6824,274,23,18,41,
6825,269,14,18,32,
6826,317,25,22,47,
6827,319,11,18,29,
6828,302,19,18,37,
6829,298,31,21,52,
6830,322,27,15,42,
6831,262,20,12,32,
6832,293,22,24,46,
6833,321,32,15,47,
6834,299,22,17,39,
6835,287,29,15,44,
6836,290,20,14,34,
6837,277,22,10,32,
6838,269,23,17,40,
6839,302,20,20,40,
6840,289,27,25,52,
6841,318,26,16,42,
6842,300,15,18,33,
6843,251,19,11,30,
6844,290,20,20,40,
6845,299,19,24,43,
6846,292,25,20,45,
6847,277,28,15,43,
6848,310,16,27,43,
6849,272,16,16,32,
6850,293,23,18,41,
6851,298,30,18,48,
6852,283,21,17,38,
6853,297,21,21,42,
6854,285,19,18,37,
6855,310,26,19,45,
6856,307,24,21,45,
6857,295,21,15,36,
6858,294,21,19,40,
6859,304,25,15,40,
6860,294,26,24,50,
6861,304,30,13,43,
6862,277,24,13,37,
6863,288,24,16,40,
6864,319,24,18,42,
6865,303,14,17,31,
6866,330,24,23,47,
6867,314,21,20,41,
6868,304,19,14,33,
6869,330,17,26,43,
6870,306,28,22,50,
6871,317,21,17,38,
6872,304,18,19,37,
6873,295,27,15,42,
6874,314,27,20,47,
6875,272,18,17,35,
6876,314,26,23,49,
6877,332,23,21,44,
6878,320,22,28,50,
6879,276,20,13,33,
6880,282,19,15,34,
6881,293,13,16,29,
6882,305,17,16,33,
6883,272,21,12,33,
6884,276,15,15,30,
6885,280,16,19,35,
6886,306,22,14,36,
6887,298,16,17,33,
6888,307,22,18,40,
6889,292,18,16,34,
6890,326,24,21,45,
6891,298,23,18,41,
6892,326,22,19,41,
6893,284,29,18,47,
6894,304,28,14,42,
6895,297,15,15,30,
6896,286,18,14,32,
6897,311,19,21,40,
6898,278,24,23,47,
6899,289,34,15,49,
6900,301,24,18,42,
6901,295,18,16,34,
6902,307,18,16,34,
6903,278,10,15,25,
6904,313,21,11,32,
6905,310,17,17,34,
6906,286,27,9,36,
6907,293,28,24,52,
6908,321,16,24,40,
6909,312,33,15,48,
6910,300,22,14,36,
6911,298,16,13,29,
6912,277,23,18,41,
6913,340,32,17,49,
6914,318,23,15,38,
6915,304,21,14,35,
6916,290,20,19,39,
6917,315,25,17,42,
6918,286,20,10,30,
6919,319,26,19,45,
6920,319,23,23,46,
6921,314,23,16,39,
6922,265,18,9,27,
6923,307,19,13,32,
6924,298,29,13,42,
6925,291,19,13,32,
6926,286,20,25,45,
6927,287,22,17,39,
6928,263,13,17,30,
6929,300,21,13,34,
6930,294,22,21,43,
6931,322,23,25,48,
6932,282,25,19,44,
6933,305,24,19,43,
6934,328,23,16,39,
6935,326,23,13,36,
6936,296,25,12,37,
6937,269,19,11,30,
6938,340,34,21,55,
6939,303,31,14,45,
6940,307,20,19,39,
6941,292,22,20,42,
6942,313,22,13,35,
6943,281,22,13,35,
6944,286,22,15,37,
6945,303,27,26,53,
6946,277,20,19,39,
6947,312,20,24,44,
6948,302,17,17,34,
6949,308,29,16,45,
6950,283,20,15,35,
6951,310,15,21,36,
6952,289,13,11,24,
6953,298,15,14,29,
6954,257,13,12,25,
6955,286,19,15,34,
6956,304,22,17,39,
6957,317,24,26,50,
6958,308,25,19,44,
6959,293,21,10,31,
6960,289,23,23,46,
6961,315,15,23,38,
6962,321,24,17,41,
6963,292,26,24,50,
6964,273,24,10,34,
6965,316,27,21,48,
6966,319,20,18,38,
6967,328,23,12,35,
6968,305,25,26,51,
6969,288,21,11,32,
6970,300,26,18,44,
6971,320,10,12,22,
6972,287,22,18,40,
6973,301,16,21,37,
6974,297,20,19,39,
6975,274,15,17,32,
6976,309,18,16,34,
6977,283,24,13,37,
6978,319,22,18,40,
6979,317,17,22,39,
6980,291,26,23,49,
6981,288,21,18,39,
6982,295,25,7,32,
6983,321,19,25,44,
6984,255,18,15,33,
6985,303,24,15,39,
6986,272,24,15,39,
6987,298,23,21,44,
6988,299,30,17,47,
6989,273,14,16,30,
6990,308,26,19,45,
6991,344,22,26,48,
6992,325,19,22,41,
6993,320,24,11,35,
6994,279,20,14,34,
6995,307,20,19,39,
6996,295,20,15,35,
6997,286,18,14,32,
6998,307,21,18,39,
6999,278,14,15,29,
7000,280,18,16,34,
7001,306,25,12,37,
7002,266,18,20,38,
7003,303,32,21,53,
7004,291,20,20,40,
7005,303,18,16,34,
7006,289,22,26,48,
7007,260,26,12,38,
7008,303,14,23,37,
7009,300,23,19,42,
7010,331,24,24,48,
7011,292,20,16,36,
7012,308,21,22,43,
7013,311,24,17,41,
7014,299,19,19,38,
7015,295,20,25,45,
7016,329,27,21,48,
7017,316,23,17,40,
7018,291,21,21,42,
7019,309,20,12,32,
7020,282,19,18,37,
7021,286,20,15,35,
7022,277,26,13,39,
7023,344,16,26,42,
7024,320,28,14,42,
7025,308,29,17,46,
7026,276,20,13,33,
7027,316,24,22,46,
7028,297,24,18,42,
7029,313,23,16,39,
7030,293,26,14,40,
7031,270,18,15,33,
7032,317,17,23,40,
7033,311,18,23,41,
7034,260,26,17,43,
7035,292,22,12,34,
7036,294,23,17,40,
7037,305,17,12,29,
7038,302,23,17,40,
7039,299,20,16,36,
7040,291,19,17,36,
7041,286,21,12,33,
7042,298,24,12,36,
7043,300,18,21,39,
7044,297,26,20,46,
7045,291,14,24,38,
7046,332,27,20,47,
7047,320,30,15,45,
7048,269,17,8,25,
7049,282,22,13,35,
7050,286,20,13,33,
7051,293,21,9,30,
7052,294,22,20,42,
7053,258,16,15,31,
7054,279,13,16,29,
7055,276,18,18,36,
7056,279,24,16,40,
7057,343,20,23,43,
7058,302,21,19,40,
7059,342,28,22,50,
7060,301,17,28,45,
7061,296,21,16,37,
7062,257,15,22,37,
7063,283,23,9,32,
7064,292,23,9,32,
7065,264,25,21,46,
7066,315,23,20,43,
7067,324,25,20,45,
7068,308,21,12,33,
7069,298,25,11,36,
7070,294,18,15,33,
7071,325,21,16,37,
7072,279,29,15,44,
7073,306,27,18,45,
7074,302,22,19,41,
7075,279,18,21,39,
7076,313,21,25,46,
7077,289,23,17,40,
7078,293,20,19,39,
7079,308,24,18,42,
7080,303,20,20,40,
7081,276,26,9,35,
7082,292,24,26,50,
7083,270,9,20,29,
7084,274,34,15,49,
7085,284,10,15,25,
7086,304,18,26,44,
7087,269,16,18,34,
7088,315,31,19,50,
7089,337,28,22,50,
7090,276,16,19,35,
7091,310,23,21,44,
7092,280,22,15,37,
7093,288,21,8,29,
7094,272,22,8,30,
7095,276,16,20,36,
7096,279,16,18,34,
7097,301,19,21,40,
7098,274,24,10,34,
7099,287,26,18,44,
7100,310,16,18,34,
7101,288,22,19,41,
7102,272,26,18,44,
7103,281,21,17,38,
7104,323,26,20,46,
7105,311,22,15,37,
7106,307,27,16,43,
7107,333,18,22,40,
7108,312,18,12,30,
7109,264,14,18,32,
7110,304,22,15,37,
7111,306,28,15,43,
7112,296,24,14,38,
7113,278,20,14,34,
7114,296,18,19,37,
7115,283,25,16,41,
7116,298,20,19,39,
7117,284,15,18,33,
7118,308,23,19,42,
7119,279,22,13,35,
7120,308,18,19,37,
7121,314,27,17,44,
7122,296,20,19,39,
7123,308,20,14,34,
7124,292,21,18,39,
7125,316,30,20,50,
7126,338,26,20,46,
7127,280,14,20,34,
7128,294,31,19,50,
7129,269,21,20,41,
7130,324,23,16,39,
7131,321,25,13,38,
7132,283,20,17,37,
7133,315,18,23,41,
7134,251,19,13,32,
7135,262,19,18,37,
7136,314,22,14,36,
7137,291,15,14,29,
7138,306,18,24,42,
7139,288,24,21,45,
7140,308,23,18,41,
7141,273,18,20,38,
7142,302,17,18,35,
7143,270,24,19,43,
7144,295,20,12,32,
7145,296,25,13,38,
7146,292,25,16,41,
7147,305,28,9,37,
7148,319,24,15,39,
7149,280,12,23,35,
7150,291,23,18,41,
7151,307,17,12,29,
7152,303,21,11,32,
7153,279,27,21,48,
7154,294,28,23,51,
7155,323,30,19,49,
7156,284,19,22,41,
7157,274,21,11,32,
7158,293,24,20,44,
7159,297,28,18,46,
7160,285,14,13,27,
7161,301,23,16,39,
7162,284,20,16,36,
7163,298,22,25,47,
7164,312,22,11,33,
7165,297,22,15,37,
7166,301,21,12,33,
7167,261,15,13,28,
7168,285,20,20,40,
7169,289,22,13,35,
7170,315,23,15,38,
7171,271,22,20,42,
7172,280,18,11,29,
7173,369,26,15,41,
7174,270,22,14,36,
7175,310,18,15,33,
7176,302,25,11,36,
7177,295,21,18,39,
7178,299,26,14,40,
7179,345,25,22,47,
7180,293,22,19,41,
7181,292,19,16,35,
7182,292,24,21,45,
7183,321,22,28,50,
7184,325,22,22,44,
7185,272,25,8,33,
7186,286,16,17,33,
7187,313,24,14,38,
7188,306,21,18,39,
7189,307,16,9,25,
7190,303,22,22,44,
7191,305,16,16,32,
7192,298,18,16,34,
7193,284,7,16,23,
7194,299,20,19,39,
7195,295,22,17,39,
7196,295,22,8,30,
7197,313,31,14,45,
7198,319,23,23,46,
7199,296,21,14,35,
7200,275,25,16,41,
7201,295,23,15,38,
7202,306,31,14,45,
7203,294,26,16,42,
7204,267,23,13,36,
7205,314,32,9,41,
7206,284,17,14,31,
7207,271,27,22,49,
7208,315,22,18,40,
7209,286,20,15,35,
7210,310,22,20,42,
7211,302,21,18,39,
7212,288,16,15,31,
7213,286,16,18,34,
7214,314,26,13,39,
7215,305,22,19,41,
7216,292,21,15,36,
7217,296,25,13,38,
7218,269,18,17,35,
7219,326,25,16,41,
7220,290,20,7,27,
7221,287,19,18,37,
7222,309,29,13,42,
7223,287,16,22,38,
7224,283,14,19,33,
7225,296,17,12,29,
7226,306,28,24,52,
7227,303,18,21,39,
7228,320,26,17,43,
7229,304,26,16,42,
7230,355,25,21,46,
7231,277,26,16,42,
7232,308,28,21,49,
7233,307,17,21,38,
7234,281,22,13,35,
7235,311,25,20,45,
7236,329,27,13,40,
7237,342,24,15,39,
7238,308,18,8,26,
7239,285,22,17,39,
7240,284,22,16,38,
7241,331,25,14,39,
7242,319,31,16,47,
7243,292,15,17,32,
7244,300,25,10,35,
7245,304,16,17,33,
7246,309,19,17,36,
7247,274,21,13,34,
7248,304,27,16,43,
7249,310,26,18,44,
7250,312,19,15,34,
7251,278,15,15,30,
7252,326,25,22,47,
7253,327,24,10,34,
7254,330,21,12,33,
7255,333,19,19,38,
7256,315,23,18,41,
7257,304,24,22,46,
7258,279,23,8,31,
7259,293,26,12,38,
7260,297,21,14,35,
7261,307,19,17,36,
7262,311,15,20,35,
7263,316,31,17,48,
7264,278,14,21,35,
7265,319,27,14,41,
7266,322,17,22,39,
7267,255,14,15,29,
7268,313,21,20,41,
7269,306,23,22,45,
7270,294,24,12,36,
7271,274,23,20,43,
7272,281,25,20,45,
7273,296,23,13,36,
7274,311,22,16,38,
7275,333,34,19,53,
7276,295,29,13,42,
7277,287,25,19,44,
7278,289,22,20,42,
7279,321,18,29,47,
7280,304,18,14,32,
7281,267,15,16,31,
7282,314,27,15,42,
7283,298,16,17,33,
7284,309,23,18,41,
7285,309,23,16,39,
7286,276,19,15,34,
7287,316,18,21,39,
7288,328,19,14,33,
7289,320,22,20,42,
7290,287,29,16,45,
7291,282,18,20,38,
7292,330,19,24,43,
7293,317,21,18,39,
7294,307,19,24,43,
7295,308,19,19,38,
7296,286,20,27,47,
7297,276,21,13,34,
7298,298,17,13,30,
7299,287,21,19,40,
7300,310,27,13,40,
7301,295,31,11,42,
7302,288,17,20,37,
7303,268,14,12,26,
7304,300,20,19,39,
7305,270,25,19,44,
7306,265,23,19,42,
7307,295,23,19,42,
7308,265,15,8,23,
7309,298,23,15,38,
7310,272,11,20,31,
7311,296,18,11,29,
7312,310,18,15,33,
7313,329,25,26,51,
7314,273,12,14,26,
7315,281,24,19,43,
7316,297,26,17,43,
7317,286,14,22,36,
7318,278,22,18,40,
7319,308,20,20,40,
7320,284,25,14,39,
7321,307,22,16,38,
7322,327,32,15,47,
7323,270,18,16,34,
7324,307,28,19,47,
7325,321,25,20,45,
7326,265,22,15,37,
7327,264,18,13,31,
7328,276,20,14,34,
7329,292,19,16,35,
7330,326,26,21,47,
7331,276,27,18,45,
7332,302,18,20,38,
7333,291,28,23,51,
7334,283,16,14,30,
7335,295,25,16,41,
7336,289,19,14,33,
7337,333,22,23,45,
7338,310,27,18,45,
7339,301,23,14,37,
7340,270,21,14,35,
7341,300,24,20,44,
7342,288,31,12,43,
7343,293,16,21,37,
7344,295,22,14,36,
7345,298,21,23,44,
7346,319,20,19,39,
7347,298,30,14,44,
7348,316,24,17,41,
7349,265,18,18,36,
7350,298,19,18,37,
7351,309,23,21,44,
7352,282,14,17,31,
7353,267,12,15,27,
7354,268,28,12,40,
7355,335,21,17,38,
7356,287,15,14,29,
7357,277,22,12,34,
7358,286,15,19,34,
7359,332,18,20,38,
7360,293,19,27,46,
7361,314,22,11,33,
7362,281,20,14,34,
7363,300,26,16,42,
7364,280,20,17,37,
7365,288,21,19,40,
7366,290,19,23,42,
7367,316,22,16,38,
7368,315,17,18,35,
7369,283,17,19,36,
7370,310,27,20,47,
7371,294,22,19,41,
7372,314,11,25,36,
7373,314,26,20,46,
7374,315,27,20,47,
7375,319,19,18,37,
7376,299,19,14,33,
7377,315,30,17,47,
7378,322,21,20,41,
7379,315,20,19,39,
7380,280,18,18,36,
7381,296,22,16,38,
7382,304,28,25,53,
7383,291,14,20,34,
7384,279,13,14,27,
7385,272,20,15,35,
7386,282,16,23,39,
7387,294,28,19,47,
7388,308,19,10,29,
7389,306,16,15,31,
7390,281,26,13,39,
7391,288,20,22,42,
7392,327,24,21,45,
7393,282,15,19,34,
7394,294,18,19,37,
7395,290,20,16,36,
7396,326,26,22,48,
7397,317,18,17,35,
7398,265,22,18,40,
7399,316,25,18,43,
7400,301,17,15,32,
7401,326,16,16,32,
7402,297,17,15,32,
7403,307,20,17,37,
7404,303,21,13,34,
7405,326,23,18,41,
7406,271,15,15,30,
7407,321,29,18,47,
7408,268,16,13,29,
7409,301,23,18,41,
7410,324,20,16,36,
7411,304,22,24,46,
7412,287,19,26,45,
7413,310,25,25,50,
7414,312,24,21,45,
7415,308,24,20,44,
7416,300,14,22,36,
7417,304,25,18,43,
7418,269,25,12,37,
7419,268,20,14,34,
7420,309,23,13,36,
7421,338,21,26,47,
7422,292,26,18,44,
7423,303,13,14,27,
7424,279,18,17,35,
7425,318,28,16,44,
7426,299,23,14,37,
7427,272,22,15,37,
7428,326,20,20,40,
7429,308,21,18,39,
7430,298,20,23,43,
7431,302,29,16,45,
7432,324,21,18,39,
7433,318,23,17,40,
7434,295,24,18,42,
7435,302,17,19,36,
7436,278,20,13,33,
7437,296,18,13,31,
7438,289,30,13,43,
7439,291,24,14,38,
7440,299,27,22,49,
7441,307,22,22,44,
7442,286,26,18,44,
7443,275,27,19,46,
7444,314,20,19,39,
7445,275,22,17,39,
7446,302,16,22,38,
7447,303,20,19,39,
7448,294,28,16,44,
7449,324,19,18,37,
7450,332,22,15,37,
7451,309,26,19,45,
7452,308,18,13,31,
7453,294,18,16,34,
7454,269,21,10,31,
7455,316,24,15,39,
7456,256,17,9,26,
7457,314,27,16,43,
7458,265,16,14,30,
7459,304,24,13,37,
7460,279,24,15,39,
7461,289,20,14,34,
7462,318,20,23,43,
7463,297,15,22,37,
7464,287,26,21,47,
7465,306,24,20,44,
7466,293,16,21,37,
7467,303,25,17,42,
7468,270,23,11,34,
7469,284,19,13,32,
7470,291,25,15,40,
7471,295,24,14,38,
7472,271,22,22,44,
7473,324,19,14,33,
7474,301,14,25,39,
7475,290,20,19,39,
7476,291,22,19,41,
7477,311,23,15,38,
7478,303,29,19,48,
7479,291,25,22,47,
7480,298,22,20,42,
7481,335,28,18,46,
7482,270,19,18,37,
7483,319,27,15,42,
7484,298,21,20,41,
7485,311,28,13,41,
7486,320,30,18,48,
7487,288,23,16,39,
7488,290,23,15,38,
7489,309,16,19,35,
7490,272,20,16,36,
7491,306,20,29,49,
7492,273,25,13,38,
7493,306,25,18,43,
7494,303,22,21,43,
7495,296,21,20,41,
7496,297,16,23,39,
7497,258,22,18,40,
7498,290,17,13,30,
7499,309,27,26,53,
7500,295,26,12,38,
7501,284,22,17,39,
7502,315,22,19,41,
7503,309,33,19,52,
7504,295,26,23,49,
7505,291,24,14,38,
7506,314,21,20,41,
7507,316,18,12,30,
7508,298,26,17,43,
7509,306,27,23,50,
7510,284,15,14,29,
7511,283,25,12,37,
7512,275,19,20,39,
7513,300,18,23,41,
7514,293,23,20,43,
7515,324,18,11,29,
7516,308,26,20,46,
7517,268,28,13,41,
7518,330,26,20,46,
7519,288,17,16,33,
7520,304,22,11,33,
7521,302,16,17,33,
7522,297,15,20,35,
7523,288,15,17,32,
7524,293,23,17,40,
7525,282,19,15,34,
7526,275,20,17,37,
7527,314,26,24,50,
7528,322,23,19,42,
7529,302,25,19,44,
7530,300,22,19,41,
7531,287,16,16,32,
7532,283,17,16,33,
7533,298,22,19,41,
7534,306,23,20,43,
7535,291,25,17,42,
7536,317,21,21,42,
7537,270,14,18,32,
7538,304,24,15,39,
7539,336,21,27,48,
7540,312,20,25,45,
7541,298,18,13,31,
7542,300,25,15,40,
7543,293,28,22,50,
7544,322,22,20,42,
7545,280,18,16,34,
7546,299,20,16,36,
7547,283,29,11,40,
7548,290,13,17,30,
7549,289,26,18,44,
7550,307,19,22,41,
7551,326,18,14,32,
7552,295,28,15,43,
7553,315,25,15,40,
7554,307,21,11,32,
7555,302,26,22,48,
7556,281,20,16,36,
7557,306,22,16,38,
7558,326,24,17,41,
7559,308,28,18,46,
7560,297,17,17,34,
7561,309,30,17,47,
7562,298,19,17,36,
7563,285,19,19,38,
7564,297,15,17,32,
7565,310,21,21,42,
7566,275,28,15,43,
7567,274,20,18,38,
7568,318,22,19,41,
7569,291,20,18,38,
7570,290,21,8,29,
7571,323,19,15,34,
7572,263,17,18,35,
7573,306,24,13,37,
7574,285,19,16,35,
7575,316,27,20,47,
7576,320,27,17,44,
7577,270,20,13,33,
7578,302,15,20,35,
7579,272,22,13,35,
7580,285,31,15,46,
7581,305,30,21,51,
7582,316,23,18,41,
7583,304,20,20,40,
7584,281,17,19,36,
7585,306,27,20,47,
7586,292,13,13,26,
7587,335,21,22,43,
7588,324,22,25,47,
7589,291,22,14,36,
7590,291,32,14,46,
7591,326,29,18,47,
7592,318,29,26,55,
7593,293,19,27,46,
7594,320,13,15,28,
7595,304,19,19,38,
7596,336,24,19,43,
7597,272,11,13,24,
7598,311,27,20,47,
7599,323,20,28,48,
7600,284,24,23,47,
7601,290,23,14,37,
7602,255,15,13,28,
7603,275,21,18,39,
7604,299,28,14,42,
7605,278,15,19,34,
7606,309,27,16,43,
7607,295,27,20,47,
7608,281,21,18,39,
7609,284,22,17,39,
7610,320,16,21,37,
7611,289,19,9,28,
7612,341,22,20,42,
7613,304,23,21,44,
7614,305,28,16,44,
7615,292,19,19,38,
7616,329,17,16,33,
7617,315,22,16,38,
7618,284,13,15,28,
7619,282,17,19,36,
7620,315,30,13,43,
7621,279,20,16,36,
7622,281,20,13,33,
7623,291,14,19,33,
7624,274,20,17,37,
7625,291,24,14,38,
7626,307,20,20,40,
7627,271,16,19,35,
7628,295,24,12,36,
7629,308,27,16,43,
7630,288,24,23,47,
7631,315,22,23,45,
7632,331,21,19,40,
7633,300,24,16,40,
7634,291,21,15,36,
7635,292,13,10,23,
7636,288,24,16,40,
7637,272,27,16,43,
7638,319,25,14,39,
7639,272,11,19,30,
7640,263,19,16,35,
7641,309,23,19,42,
7642,313,19,21,40,
7643,341,27,20,47,
7644,335,29,22,51,
7645,331,32,12,44,
7646,333,17,23,40,
7647,262,17,16,33,
7648,302,19,15,34,
7649,311,22,18,40,
7650,281,17,19,36,
7651,301,22,19,41,
7652,338,23,18,41,
7653,279,20,15,35,
7654,284,13,16,29,
7655,313,25,23,48,
7656,306,24,17,41,
7657,279,15,13,28,
7658,283,20,17,37,
7659,318,20,21,41,
7660,319,16,24,40,
7661,264,21,24,45,
7662,351,23,15,38,
7663,302,29,12,41,
7664,296,22,17,39,
7665,309,22,25,47,
7666,335,29,18,47,
7667,277,21,14,35,
7668,310,25,22,47,
7669,288,20,13,33,
7670,298,15,19,34,
7671,312,19,22,41,
7672,289,24,12,36,
7673,285,25,21,46,
7674,289,25,16,41,
7675,291,21,18,39,
7676,289,21,10,31,
7677,282,19,18,37,
7678,284,26,19,45,
7679,283,12,26,38,
7680,268,19,21,40,
7681,280,14,15,29,
7682,296,16,16,32,
7683,281,25,16,41,
7684,262,27,16,43,
7685,260,12,19,31,
7686,291,15,9,24,
7687,334,21,21,42,
7688,281,23,22,45,
7689,279,20,13,33,
7690,324,21,12,33,
7691,310,24,21,45,
7692,276,23,17,40,
7693,291,27,16,43,
7694,306,22,15,37,
7695,286,17,15,32,
7696,265,25,13,38,
7697,304,25,19,44,
7698,294,21,22,43,
7699,280,25,20,45,
7700,285,21,20,41,
7701,284,14,22,36,
7702,313,25,17,42,
7703,270,16,13,29,
7704,330,25,14,39,
7705,275,20,16,36,
7706,298,21,11,32,
7707,314,22,11,33,
7708,308,23,10,33,
7709,348,25,16,41,
7710,278,27,17,44,
7711,315,24,11,35,
7712,299,23,18,41,
7713,301,16,20,36,
7714,287,27,20,47,
7715,336,21,27,48,
7716,315,19,19,38,
7717,286,24,14,38,
7718,339,20,22,42,
7719,304,22,17,39,
7720,309,17,32,49,
7721,293,25,14,39,
7722,250,12,15,27,
7723,304,24,14,38,
7724,287,19,13,32,
7725,273,21,13,34,
7726,295,21,21,42,
7727,275,21,22,43,
7728,301,23,19,42,
7729,281,29,15,44,
7730,270,15,3,18,
7731,301,13,18,31,
7732,272,28,13,41,
7733,293,19,18,37,
7734,338,21,26,47,
7735,274,20,16,36,
7736,288,19,13,32,
7737,319,23,15,38,
7738,298,21,25,46,
7739,279,21,13,34,
7740,302,15,19,34,
7741,304,28,18,46,
7742,295,26,16,42,
7743,305,23,15,38,
7744,274,14,11,25,
7745,302,22,18,40,
7746,288,18,5,23,
7747,308,14,17,31,
7748,323,17,17,34,
7749,305,21,20,41,
7750,298,20,17,37,
7751,301,23,12,35,
7752,323,19,16,35,
7753,298,16,16,32,
7754,313,22,22,44,
7755,295,26,13,39,
7756,330,18,20,38,
7757,287,13,15,28,
7758,323,26,19,45,
7759,264,19,20,39,
7760,303,17,19,36,
7761,304,30,12,42,
7762,299,27,18,45,
7763,305,19,23,42,
7764,317,27,20,47,
7765,291,16,17,33,
7766,294,21,17,38,
7767,302,32,20,52,
7768,275,14,14,28,
7769,288,15,14,29,
7770,303,11,19,30,
7771,304,25,22,47,
7772,317,18,16,34,
7773,302,16,9,25,
7774,305,26,15,41,
7775,276,24,16,40,
7776,305,20,18,38,
7777,304,23,19,42,
7778,311,18,15,33,
7779,296,17,22,39,
7780,307,22,12,34,
7781,271,20,15,35,
7782,308,17,23,40,
7783,308,24,17,41,
7784,280,22,16,38,
7785,285,15,16,31,
7786,315,27,25,52,
7787,332,17,12,29,
7788,295,22,22,44,
7789,279,24,13,37,
7790,294,25,19,44,
7791,298,27,17,44,
7792,291,19,19,38,
7793,306,23,14,37,
7794,307,28,15,43,
7795,306,29,16,45,
7796,297,25,17,42,
7797,332,18,19,37,
7798,300,21,15,36,
7799,293,22,15,37,
7800,273,23,13,36,
7801,312,22,13,35,
7802,341,17,26,43,
7803,307,25,21,46,
7804,287,21,18,39,
7805,287,12,18,30,
7806,272,12,12,24,
7807,334,25,21,46,
7808,300,22,15,37,
7809,285,20,16,36,
7810,294,20,18,38,
7811,259,21,17,38,
7812,266,31,18,49,
7813,293,20,14,34,
7814,298,20,20,40,
7815,300,17,17,34,
7816,300,22,17,39,
7817,278,18,20,38,
7818,288,20,20,40,
7819,270,13,21,34,
7820,314,18,20,38,
7821,296,15,18,33,
7822,284,21,15,36,
7823,314,23,27,50,
7824,294,18,15,33,
7825,277,23,15,38,
7826,316,25,19,44,
7827,296,17,20,37,
7828,291,18,6,24,
7829,316,18,16,34,
7830,288,23,16,39,
7831,306,19,14,33,
7832,308,22,19,41,
7833,274,16,14,30,
7834,276,23,18,41,
7835,297,38,21,59,
7836,294,20,12,32,
7837,288,22,14,36,
7838,262,19,18,37,
7839,299,17,16,33,
7840,276,18,11,29,
7841,285,14,15,29,
7842,296,26,20,46,
7843,283,26,9,35,
7844,291,16,15,31,
7845,316,26,19,45,
7846,319,21,16,37,
7847,318,23,16,39,
7848,265,22,19,41,
7849,290,18,17,35,
7850,292,14,9,23,
7851,281,24,6,30,
7852,315,26,21,47,
7853,292,29,19,48,
7854,306,20,18,38,
7855,301,19,17,36,
7856,315,20,19,39,
7857,286,17,21,38,
7858,308,28,16,44,
7859,316,26,15,41,
7860,273,26,16,42,
7861,299,24,18,42,
7862,321,20,19,39,
7863,335,19,18,37,
7864,295,21,15,36,
7865,274,14,13,27,
7866,279,19,14,33,
7867,305,25,12,37,
7868,310,19,19,38,
7869,298,20,17,37,
7870,284,23,15,38,
7871,299,23,25,48,
7872,302,30,18,48,
7873,316,29,25,54,
7874,294,23,13,36,
7875,294,23,20,43,
7876,296,23,14,37,
7877,285,25,19,44,
7878,324,18,21,39,
7879,306,22,17,39,
7880,304,20,22,42,
7881,323,21,25,46,
7882,281,17,24,41,
7883,292,16,24,40,
7884,311,17,23,40,
7885,265,18,12,30,
7886,304,18,19,37,
7887,289,23,22,45,
7888,283,20,14,34,
7889,278,19,13,32,
7890,303,17,22,39,
7891,271,12,13,25,
7892,264,22,17,39,
7893,276,19,13,32,
7894,281,17,11,28,
7895,301,25,19,44,
7896,310,31,16,47,
7897,294,20,13,33,
7898,296,23,15,38,
7899,318,25,19,44,
7900,291,21,15,36,
7901,297,16,19,35,
7902,305,19,17,36,
7903,275,19,13,32,
7904,334,24,17,41,
7905,280,25,19,44,
7906,278,22,20,42,
7907,257,18,11,29,
7908,280,23,20,43,
7909,309,23,23,46,
7910,311,24,21,45,
7911,317,20,11,31,
7912,346,23,19,42,
7913,321,23,23,46,
7914,275,19,13,32,
7915,344,20,14,34,
7916,304,30,16,46,
7917,280,21,19,40,
7918,277,17,12,29,
7919,269,19,21,40,
7920,311,24,17,41,
7921,306,26,15,41,
7922,273,15,19,34,
7923,297,25,14,39,
7924,281,20,16,36,
7925,331,22,18,40,
7926,313,20,11,31,
7927,331,17,24,41,
7928,272,17,18,35,
7929,314,34,15,49,
7930,295,25,20,45,
7931,324,29,15,44,
7932,287,17,16,33,
7933,323,17,22,39,
7934,312,20,20,40,
7935,323,19,22,41,
7936,335,24,21,45,
7937,319,18,15,33,
7938,303,22,15,37,
7939,320,26,19,45,
7940,327,21,19,40,
7941,300,22,19,41,
7942,282,17,13,30,
7943,262,21,16,37,
7944,301,23,24,47,
7945,311,23,12,35,
7946,340,16,16,32,
7947,272,16,21,37,
7948,288,31,18,49,
7949,288,25,18,43,
7950,279,12,12,24,
7951,312,21,19,40,
7952,300,21,21,42,
7953,298,24,7,31,
7954,306,25,15,40,
7955,317,17,20,37,
7956,261,19,8,27,
7957,325,23,22,45,
7958,283,16,17,33,
7959,334,26,24,50,
7960,287,21,20,41,
7961,302,28,13,41,
7962,270,16,24,40,
7963,267,13,15,28,
7964,266,14,12,26,
7965,300,19,13,32,
7966,274,17,25,42,
7967,300,29,16,45,
7968,294,21,11,32,
7969,269,18,15,33,
7970,280,19,17,36,
7971,324,17,22,39,
7972,258,19,18,37,
7973,282,19,22,41,
7974,292,18,17,35,
7975,314,34,25,59,
7976,311,21,16,37,
7977,269,20,13,33,
7978,309,19,15,34,
7979,298,16,13,29,
7980,265,19,11,30,
7981,306,28,22,50,
7982,296,11,17,28,
7983,281,14,14,28,
7984,273,23,14,37,
7985,277,19,19,38,
7986,320,24,18,42,
7987,309,17,23,40,
7988,345,18,17,35,
7989,305,19,13,32,
7990,305,17,18,35,
7991,293,18,23,41,
7992,288,21,19,40,
7993,295,28,14,42,
7994,263,19,18,37,
7995,331,21,17,38,
7996,287,22,10,32,
7997,306,14,15,29,
7998,313,22,20,42,
7999,290,22,17,39,
8000,301,19,14,33,
8001,274,17,14,31,
8002,321,22,27,49,
8003,277,17,19,36,
8004,297,17,21,38,
8005,289,21,13,34,
8006,293,18,13,31,
8007,312,15,14,29,
8008,297,17,9,26,
8009,330,29,18,47,
8010,317,29,15,44,
8011,267,18,13,31,
8012,290,17,11,28,
8013,284,19,17,36,
8014,323,24,25,49,
8015,273,16,11,27,
8016,320,28,16,44,
8017,319,26,18,44,
8018,267,22,17,39,
8019,299,17,10,27,
8020,310,19,22,41,
8021,306,23,16,39,
8022,296,17,17,34,
8023,260,23,6,29,
8024,300,20,14,34,
8025,288,19,14,33,
8026,293,24,17,41,
8027,292,24,19,43,
8028,300,19,17,36,
8029,332,19,20,39,
8030,319,22,16,38,
8031,308,16,20,36,
8032,323,14,20,34,
8033,324,22,26,48,
8034,270,22,13,35,
8035,265,14,13,27,
8036,304,20,14,34,
8037,296,23,9,32,
8038,291,18,13,31,
8039,289,23,12,35,
8040,307,18,19,37,
8041,294,15,23,38,
8042,306,23,22,45,
8043,318,23,22,45,
8044,284,25,14,39,
8045,305,28,13,41,
8046,288,18,17,35,
8047,308,19,16,35,
8048,317,26,20,46,
8049,287,22,22,44,
8050,279,31,12,43,
8051,278,21,16,37,
8052,290,28,15,43,
8053,276,18,12,30,
8054,282,24,18,42,
8055,287,14,14,28,
8056,304,29,16,45,
8057,287,24,18,42,
8058,273,21,16,37,
8059,320,27,18,45,
8060,309,28,15,43,
8061,293,22,14,36,
8062,281,15,13,28,
8063,259,15,8,23,
8064,289,18,24,42,
8065,276,30,13,43,
8066,323,18,25,43,
8067,283,25,10,35,
8068,316,23,11,34,
8069,278,25,14,39,
8070,315,19,13,32,
8071,270,26,16,42,
8072,304,25,16,41,
8073,298,18,21,39,
8074,291,25,20,45,
8075,319,20,21,41,
8076,313,21,18,39,
8077,292,18,21,39,
8078,307,21,20,41,
8079,292,19,22,41,
8080,301,26,10,36,
8081,279,25,13,38,
8082,301,24,20,44,
8083,277,18,16,34,
8084,326,36,14,50,
8085,286,25,19,44,
8086,336,22,16,38,
8087,318,27,11,38,
8088,286,18,17,35,
8089,279,27,16,43,
8090,304,23,19,42,
8091,316,25,13,38,
8092,297,18,22,40,
8093,285,15,17,32,
8094,312,25,12,37,
8095,269,21,24,45,
8096,321,17,12,29,
8097,267,16,16,32,
8098,305,20,13,33,
8099,304,19,13,32,
8100,291,26,21,47,
8101,314,19,24,43,
8102,291,24,16,40,
8103,263,16,13,29,
8104,284,29,12,41,
8105,259,18,18,36,
8106,303,16,15,31,
8107,282,27,11,38,
8108,303,19,18,37,
8109,303,23,23,46,
8110,252,18,17,35,
8111,265,24,14,38,
8112,278,14,22,36,
8113,325,30,13,43,
8114,304,18,19,37,
8115,278,19,14,33,
8116,313,17,25,42,
8117,317,27,17,44,
8118,296,20,12,32,
8119,300,27,14,41,
8120,361,33,19,52,
8121,293,24,24,48,
8122,278,16,17,33,
8123,321,27,19,46,
8124,266,21,22,43,
8125,265,16,20,36,
8126,295,21,17,38,
8127,299,16,17,33,
8128,324,18,15,33,
8129,330,32,19,51,
8130,327,21,22,43,
8131,298,24,16,40,
8132,315,21,22,43,
8133,315,26,23,49,
8134,294,21,17,38,
8135,259,22,21,43,
8136,284,23,9,32,
8137,302,16,18,34,
8138,271,26,13,39,
8139,302,25,17,42,
8140,299,24,18,42,
8141,283,29,16,45,
8142,278,12,16,28,
8143,293,23,12,35,
8144,314,22,16,38,
8145,265,14,14,28,
8146,302,20,14,34,
8147,273,26,15,41,
8148,293,20,14,34,
8149,296,20,13,33,
8150,274,22,16,38,
8151,297,26,9,35,
8152,316,23,22,45,
8153,283,16,21,37,
8154,278,21,14,35,
8155,278,24,11,35,
8156,337,37,20,57,
8157,318,24,27,51,
8158,293,20,21,41,
8159,299,24,16,40,
8160,314,17,13,30,
8161,297,21,19,40,
8162,317,21,23,44,
8163,296,20,15,35,
8164,284,27,17,44,
8165,282,14,17,31,
8166,281,14,21,35,
8167,287,23,10,33,
8168,336,21,25,46,
8169,294,17,14,31,
8170,277,20,22,42,
8171,348,22,19,41,
8172,339,24,22,46,
8173,315,24,15,39,
8174,290,28,17,45,
8175,308,19,19,38,
8176,303,21,17,38,
8177,298,19,18,37,
8178,260,18,15,33,
8179,317,28,28,56,
8180,254,15,15,30,
8181,297,23,22,45,
8182,298,25,20,45,
8183,291,29,16,45,
8184,278,23,11,34,
8185,269,30,14,44,
8186,302,25,24,49,
8187,293,16,24,40,
8188,312,26,20,46,
8189,301,13,28,41,
8190,335,30,22,52,
8191,313,24,18,42,
8192,296,24,22,46,
8193,284,21,15,36,
8194,274,17,12,29,
8195,298,25,18,43,
8196,311,30,12,42,
8197,295,21,21,42,
8198,290,25,12,37,
8199,332,31,25,56,
8200,283,17,14,31,
8201,312,21,22,43,
8202,313,15,21,36,
8203,307,18,17,35,
8204,301,23,21,44,
8205,304,25,15,40,
8206,303,23,17,40,
8207,329,26,17,43,
8208,287,22,12,34,
8209,299,25,14,39,
8210,307,16,20,36,
8211,324,19,20,39,
8212,335,25,23,48,
8213,278,21,14,35,
8214,275,21,18,39,
8215,279,26,15,41,
8216,277,16,18,34,
8217,336,27,30,57,
8218,320,25,15,40,
8219,305,23,26,49,
8220,302,32,20,52,
8221,307,19,21,40,
8222,286,19,17,36,
8223,284,26,13,39,
8224,301,22,15,37,
8225,308,23,15,38,
8226,294,18,18,36,
8227,316,19,21,40,
8228,308,31,22,53,
8229,305,24,19,43,
8230,286,26,17,43,
8231,285,22,21,43,
8232,277,17,12,29,
8233,289,16,13,29,
8234,292,25,17,42,
8235,317,24,18,42,
8236,293,23,19,42,
8237,295,12,15,27,
8238,301,16,12,28,
8239,323,22,19,41,
8240,307,22,20,42,
8241,288,29,14,43,
8242,277,14,18,32,
8243,304,21,25,46,
8244,288,11,22,33,
8245,304,17,16,33,
8246,297,20,23,43,
8247,309,14,8,22,
8248,318,22,18,40,
8249,296,15,16,31,
8250,286,17,21,38,
8251,312,28,16,44,
8252,305,20,21,41,
8253,280,23,16,39,
8254,274,23,14,37,
8255,301,20,28,48,
8256,345,40,15,55,
8257,279,20,14,34,
8258,288,22,13,35,
8259,286,25,9,34,
8260,331,24,25,49,
8261,272,28,11,39,
8262,259,17,13,30,
8263,319,25,16,41,
8264,320,25,17,42,
8265,261,23,15,38,
8266,304,14,19,33,
8267,294,27,15,42,
8268,311,27,21,48,
8269,284,20,16,36,
8270,278,17,13,30,
8271,274,13,7,20,
8272,271,22,11,33,
8273,290,25,17,42,
8274,291,20,18,38,
8275,287,23,17,40,
8276,306,20,19,39,
8277,283,24,16,40,
8278,302,27,23,50,
8279,252,20,14,34,
8280,314,19,15,34,
8281,277,23,10,33,
8282,317,25,17,42,
8283,299,30,13,43,
8284,301,21,20,41,
8285,286,25,20,45,
8286,278,12,15,27,
8287,316,25,25,50,
8288,301,18,17,35,
8289,310,23,20,43,
8290,321,24,20,44,
8291,318,23,19,42,
8292,269,25,9,34,
8293,281,13,11,24,
8294,302,19,17,36,
8295,311,25,15,40,
8296,281,28,15,43,
8297,265,21,14,35,
8298,306,17,23,40,
8299,289,19,16,35,
8300,324,18,12,30,
8301,325,22,17,39,
8302,318,26,18,44,
8303,313,29,23,52,
8304,292,16,18,34,
8305,322,23,19,42,
8306,274,27,14,41,
8307,288,20,23,43,
8308,329,23,15,38,
8309,296,22,16,38,
8310,275,24,12,36,
8311,298,25,20,45,
8312,290,21,16,37,
8313,296,19,15,34,
8314,288,21,22,43,
8315,273,16,16,32,
8316,260,19,17,36,
8317,268,24,16,40,
8318,291,30,13,43,
8319,288,29,18,47,
8320,301,17,15,32,
8321,286,21,18,39,
8322,287,21,23,44,
8323,294,17,18,35,
8324,276,15,20,35,
8325,276,20,17,37,
8326,310,16,23,39,
8327,291,24,17,41,
8328,307,13,19,32,
8329,288,23,13,36,
8330,292,19,14,33,
8331,291,22,11,33,
8332,281,16,21,37,
8333,281,22,15,37,
8334,279,23,23,46,
8335,277,22,11,33,
8336,316,30,9,39,
8337,282,18,25,43,
8338,275,15,21,36,
8339,282,22,16,38,
8340,288,15,19,34,
8341,305,26,11,37,
8342,336,26,30,56,
8343,315,20,18,38,
8344,273,19,9,28,
8345,290,22,14,36,
8346,300,25,18,43,
8347,283,21,17,38,
8348,272,18,15,33,
8349,298,21,19,40,
8350,305,15,17,32,
8351,290,23,19,42,
8352,294,30,15,45,
8353,281,20,17,37,
8354,321,29,14,43,
8355,309,22,19,41,
8356,308,26,15,41,
8357,319,27,14,41,
8358,293,27,20,47,
8359,311,19,10,29,
8360,296,17,10,27,
8361,290,22,13,35,
8362,306,17,15,32,
8363,301,16,19,35,
8364,343,24,23,47,
8365,311,34,16,50,
8366,283,29,14,43,
8367,259,8,14,22,
8368,284,18,17,35,
8369,273,23,21,44,
8370,286,18,15,33,
8371,282,17,12,29,
8372,310,17,21,38,
8373,282,20,11,31,
8374,287,29,14,43,
8375,317,27,15,42,
8376,286,20,12,32,
8377,293,25,18,43,
8378,292,19,16,35,
8379,289,18,20,38,
8380,308,26,13,39,
8381,308,28,15,43,
8382,295,13,17,30,
8383,305,22,17,39,
8384,291,26,15,41,
8385,312,32,17,49,
8386,304,23,15,38,
8387,291,18,16,34,
8388,271,26,10,36,
8389,274,16,17,33,
8390,305,25,16,41,
8391,274,21,17,38,
8392,282,20,18,38,
8393,312,19,24,43,
8394,283,11,15,26,
8395,269,22,17,39,
8396,296,22,23,45,
8397,289,28,15,43,
8398,273,17,14,31,
8399,315,24,17,41,
8400,290,31,13,44,
8401,294,26,18,44,
8402,289,18,20,38,
8403,298,19,20,39,
8404,333,23,21,44,
8405,290,21,13,34,
8406,286,21,13,34,
8407,297,24,18,42,
8408,281,21,16,37,
8409,305,22,19,41,
8410,282,21,22,43,
8411,317,25,26,51,
8412,293,29,18,47,
8413,331,25,20,45,
8414,311,21,13,34,
8415,284,19,29,48,
8416,298,25,21,46,
8417,274,25,15,40,
8418,278,24,13,37,
8419,365,30,19,49,
8420,310,19,19,38,
8421,320,24,14,38,
8422,273,17,19,36,
8423,278,14,16,30,
8424,294,25,25,50,
8425,296,28,25,53,
8426,268,15,9,24,
8427,296,22,12,34,
8428,337,29,23,52,
8429,273,30,15,45,
8430,321,26,11,37,
8431,299,25,17,42,
8432,321,15,19,34,
8433,268,20,9,29,
8434,315,30,15,45,
8435,321,23,27,50,
8436,295,21,23,44,
8437,288,15,13,28,
8438,280,20,20,40,
8439,251,20,14,34,
8440,305,18,18,36,
8441,331,21,20,41,
8442,312,21,15,36,
8443,283,24,14,38,
8444,319,26,22,48,
8445,333,26,17,43,
8446,285,26,18,44,
8447,295,19,21,40,
8448,297,20,20,40,
8449,308,16,22,38,
8450,272,20,12,32,
8451,290,24,7,31,
8452,278,28,11,39,
8453,298,12,16,28,
8454,291,17,14,31,
8455,313,20,21,41,
8456,305,19,13,32,
8457,290,20,14,34,
8458,292,28,18,46,
8459,299,23,17,40,
8460,329,25,20,45,
8461,288,21,14,35,
8462,281,25,12,37,
8463,292,22,11,33,
8464,274,20,15,35,
8465,284,15,17,32,
8466,303,20,17,37,
8467,285,15,22,37,
8468,297,22,15,37,
8469,304,26,21,47,
8470,279,23,13,36,
8471,300,23,16,39,
8472,311,17,19,36,
8473,337,25,17,42,
8474,340,33,22,55,
8475,314,24,19,43,
8476,267,15,15,30,
8477,253,11,27,38,
8478,279,20,14,34,
8479,304,26,16,42,
8480,301,26,15,41,
8481,310,21,15,36,
8482,300,19,16,35,
8483,293,25,26,51,
8484,297,13,16,29,
8485,308,14,16,30,
8486,311,19,21,40,
8487,291,16,17,33,
8488,312,22,25,47,
8489,287,21,21,42,
8490,305,28,19,47,
8491,302,25,16,41,
8492,305,24,16,40,
8493,306,19,20,39,
8494,309,21,18,39,
8495,277,18,17,35,
8496,293,19,14,33,
8497,285,15,17,32,
8498,276,19,14,33,
8499,287,24,15,39,
8500,309,17,22,39,
8501,270,23,13,36,
8502,310,18,20,38,
8503,300,23,19,42,
8504,306,31,9,40,
8505,311,26,17,43,
8506,316,23,19,42,
8507,280,16,10,26,
8508,297,17,25,42,
8509,315,23,20,43,
8510,283,10,22,32,
8511,315,22,20,42,
8512,293,24,21,45,
8513,293,24,20,44,
8514,274,25,18,43,
8515,294,21,16,37,
8516,278,25,10,35,
8517,299,22,21,43,
8518,308,16,24,40,
8519,262,20,16,36,
8520,292,22,13,35,
8521,282,17,14,31,
8522,319,21,17,38,
8523,296,23,15,38,
8524,297,23,14,37,
8525,289,16,20,36,
8526,267,20,25,45,
8527,280,21,15,36,
8528,301,23,16,39,
8529,330,23,26,49,
8530,299,21,21,42,
8531,327,18,16,34,
8532,305,24,18,42,
8533,290,19,26,45,
8534,282,21,15,36,
8535,297,22,18,40,
8536,289,20,21,41,
8537,290,23,24,47,
8538,291,21,13,34,
8539,302,18,22,40,
8540,349,26,23,49,
8541,290,14,24,38,
8542,304,18,13,31,
8543,279,25,21,46,
8544,285,24,13,37,
8545,305,26,17,43,
8546,315,22,15,37,
8547,293,10,13,23,
8548,274,29,16,45,
8549,298,14,18,32,
8550,320,20,16,36,
8551,282,24,17,41,
8552,303,24,24,48,
8553,296,19,14,33,
8554,314,26,18,44,
8555,277,23,21,44,
8556,283,20,20,40,
8557,274,25,11,36,
8558,292,28,20,48,
8559,297,19,16,35,
8560,286,22,22,44,
8561,289,22,13,35,
8562,310,23,17,40,
8563,327,25,19,44,
8564,310,27,25,52,
8565,295,20,20,40,
8566,285,11,21,32,
8567,275,23,19,42,
8568,285,25,11,36,
8569,253,16,14,30,
8570,347,21,18,39,
8571,298,25,23,48,
8572,301,18,15,33,
8573,310,25,13,38,
8574,311,16,12,28,
8575,290,20,18,38,
8576,332,25,14,39,
8577,315,20,22,42,
8578,306,19,20,39,
8579,309,19,17,36,
8580,289,20,23,43,
8581,317,27,13,40,
8582,267,20,19,39,
8583,292,23,13,36,
8584,311,19,15,34,
8585,310,17,20,37,
8586,272,19,15,34,
8587,307,21,17,38,
8588,279,16,20,36,
8589,302,17,23,40,
8590,319,25,17,42,
8591,338,23,18,41,
8592,264,23,17,40,
8593,297,24,19,43,
8594,287,17,18,35,
8595,298,20,12,32,
8596,313,13,14,27,
8597,297,22,17,39,
8598,290,17,11,28,
8599,318,22,12,34,
8600,292,22,13,35,
8601,299,25,20,45,
8602,340,28,24,52,
8603,339,30,26,56,
8604,290,25,11,36,
8605,301,14,10,24,
8606,288,15,9,24,
8607,305,26,15,41,
8608,305,25,16,41,
8609,322,23,17,40,
8610,314,24,23,47,
8611,312,24,22,46,
8612,260,13,16,29,
8613,294,26,22,48,
8614,296,32,17,49,
8615,350,19,16,35,
8616,296,18,17,35,
8617,361,19,20,39,
8618,282,21,15,36,
8619,296,23,24,47,
8620,308,23,14,37,
8621,301,19,14,33,
8622,299,23,17,40,
8623,276,14,15,29,
8624,330,33,21,54,
8625,301,27,26,53,
8626,304,15,20,35,
8627,301,22,19,41,
8628,327,24,27,51,
8629,319,24,11,35,
8630,290,20,22,42,
8631,322,36,18,54,
8632,299,25,15,40,
8633,300,21,12,33,
8634,254,23,13,36,
8635,293,23,10,33,
8636,329,23,14,37,
8637,331,20,30,50,
8638,309,21,15,36,
8639,282,19,22,41,
8640,326,19,20,39,
8641,316,21,15,36,
8642,308,16,25,41,
8643,304,24,21,45,
8644,275,7,15,22,
8645,319,17,12,29,
8646,297,24,13,37,
8647,303,19,19,38,
8648,289,18,13,31,
8649,304,13,13,26,
8650,348,32,17,49,
8651,300,18,10,28,
8652,300,21,18,39,
8653,281,11,32,43,
8654,300,25,22,47,
8655,367,31,16,47,
8656,317,27,8,35,
8657,313,25,30,55,
8658,296,26,21,47,
8659,294,26,16,42,
8660,311,22,21,43,
8661,287,24,18,42,
8662,292,16,8,24,
8663,293,23,13,36,
8664,300,27,19,46,
8665,276,19,17,36,
8666,291,19,21,40,
8667,288,25,14,39,
8668,282,13,20,33,
8669,304,21,15,36,
8670,309,16,26,42,
8671,289,25,17,42,
8672,274,17,18,35,
8673,304,23,23,46,
8674,301,34,16,50,
8675,289,22,22,44,
8676,283,17,19,36,
8677,336,24,27,51,
8678,287,21,17,38,
8679,301,16,19,35,
8680,276,22,16,38,
8681,288,16,20,36,
8682,308,27,13,40,
8683,284,20,7,27,
8684,297,29,20,49,
8685,283,20,13,33,
8686,297,22,22,44,
8687,294,20,16,36,
8688,303,19,15,34,
8689,298,16,12,28,
8690,312,24,14,38,
8691,287,22,13,35,
8692,299,13,20,33,
8693,303,21,18,39,
8694,276,17,13,30,
8695,261,23,16,39,
8696,329,15,27,42,
8697,330,21,21,42,
8698,283,18,18,36,
8699,279,19,24,43,
8700,307,24,17,41,
8701,294,24,15,39,
8702,299,24,16,40,
8703,304,22,19,41,
8704,307,28,22,50,
8705,274,24,19,43,
8706,261,25,16,41,
8707,282,16,14,30,
8708,279,22,17,39,
8709,325,22,23,45,
8710,317,16,14,30,
8711,297,24,20,44,
8712,250,17,11,28,
8713,312,26,13,39,
8714,278,14,11,25,
8715,315,30,18,48,
8716,298,30,12,42,
8717,284,26,14,40,
8718,311,24,13,37,
8719,331,22,18,40,
8720,320,28,24,52,
8721,339,27,15,42,
8722,296,23,21,44,
8723,273,22,13,35,
8724,290,24,16,40,
8725,303,23,16,39,
8726,320,16,25,41,
8727,313,20,16,36,
8728,331,17,21,38,
8729,294,17,22,39,
8730,293,23,10,33,
8731,283,21,17,38,
8732,292,25,20,45,
8733,283,26,8,34,
8734,317,18,13,31,
8735,273,21,11,32,
8736,309,20,14,34,
8737,282,26,19,45,
8738,344,18,23,41,
8739,292,22,17,39,
8740,306,22,21,43,
8741,298,17,21,38,
8742,268,22,10,32,
8743,296,24,13,37,
8744,291,17,19,36,
8745,327,27,19,46,
8746,295,21,23,44,
8747,311,16,20,36,
8748,273,17,10,27,
8749,303,20,16,36,
8750,290,28,15,43,
8751,283,29,15,44,
8752,300,16,17,33,
8753,328,19,14,33,
8754,298,26,19,45,
8755,317,23,15,38,
8756,303,27,18,45,
8757,275,20,12,32,
8758,331,22,22,44,
8759,287,20,16,36,
8760,278,20,19,39,
8761,288,18,22,40,
8762,282,22,21,43,
8763,300,14,28,42,
8764,325,17,24,41,
8765,306,18,18,36,
8766,290,28,13,41,
8767,314,16,17,33,
8768,317,23,17,40,
8769,292,23,12,35,
8770,278,21,20,41,
8771,268,23,16,39,
8772,279,20,15,35,
8773,285,18,18,36,
8774,275,13,11,24,
8775,280,21,13,34,
8776,274,25,13,38,
8777,305,23,16,39,
8778,262,20,20,40,
8779,322,21,11,32,
8780,309,23,23,46,
8781,312,22,18,40,
8782,302,24,11,35,
8783,320,16,21,37,
8784,327,26,30,56,
8785,270,16,18,34,
8786,295,20,21,41,
8787,317,29,20,49,
8788,306,21,21,42,
8789,301,21,16,37,
8790,290,21,12,33,
8791,324,26,14,40,
8792,329,26,22,48,
8793,306,21,22,43,
8794,335,25,18,43,
8795,316,27,23,50,
8796,290,24,9,33,
8797,292,24,12,36,
8798,273,27,19,46,
8799,269,20,17,37,
8800,270,19,14,33,
8801,292,24,12,36,
8802,309,32,27,59,
8803,273,15,11,26,
8804,280,25,12,37,
8805,291,20,19,39,
8806,317,23,18,41,
8807,277,22,16,38,
8808,311,24,25,49,
8809,306,22,15,37,
8810,299,26,12,38,
8811,275,19,13,32,
8812,315,22,14,36,
8813,315,26,18,44,
8814,305,24,15,39,
8815,295,27,15,42,
8816,295,22,21,43,
8817,290,24,21,45,
8818,295,19,15,34,
8819,274,15,15,30,
8820,278,19,18,37,
8821,318,19,23,42,
8822,314,16,13,29,
8823,319,29,19,48,
8824,292,23,13,36,
8825,312,25,18,43,
8826,277,24,23,47,
8827,288,18,12,30,
8828,285,17,17,34,
8829,286,18,17,35,
8830,284,17,9,26,
8831,289,19,10,29,
8832,327,28,17,45,
8833,304,31,15,46,
8834,287,22,14,36,
8835,287,20,15,35,
8836,286,23,24,47,
8837,318,20,30,50,
8838,301,32,14,46,
8839,310,24,20,44,
8840,294,18,13,31,
8841,290,28,7,35,
8842,327,26,18,44,
8843,332,23,19,42,
8844,308,19,18,37,
8845,333,22,17,39,
8846,284,26,19,45,
8847,295,34,17,51,
8848,298,32,24,56,
8849,286,20,19,39,
8850,307,32,11,43,
8851,351,24,23,47,
8852,289,30,18,48,
8853,284,14,24,38,
8854,317,18,20,38,
8855,298,19,18,37,
8856,298,24,16,40,
8857,335,34,20,54,
8858,291,26,16,42,
8859,313,21,17,38,
8860,304,21,17,38,
8861,269,26,12,38,
8862,291,19,12,31,
8863,275,19,17,36,
8864,318,21,27,48,
8865,292,18,27,45,
8866,320,20,16,36,
8867,286,19,15,34,
8868,303,19,18,37,
8869,311,24,17,41,
8870,304,18,20,38,
8871,315,22,15,37,
8872,301,18,20,38,
8873,277,16,19,35,
8874,325,19,12,31,
8875,305,26,16,42,
8876,340,26,23,49,
8877,316,21,23,44,
8878,301,24,14,38,
8879,259,23,12,35,
8880,327,38,18,56,
8881,287,23,13,36,
8882,309,21,12,33,
8883,320,29,23,52,
8884,301,24,21,45,
8885,309,38,14,52,
8886,271,20,15,35,
8887,335,28,23,51,
8888,289,23,15,38,
8889,318,20,13,33,
8890,301,24,11,35,
8891,314,25,23,48,
8892,306,27,22,49,
8893,303,20,17,37,
8894,289,21,6,27,
8895,252,22,20,42,
8896,290,24,22,46,
8897,265,17,18,35,
8898,321,27,12,39,
8899,286,26,14,40,
8900,269,20,14,34,
8901,283,22,11,33,
8902,297,30,13,43,
8903,312,22,26,48,
8904,287,20,15,35,
8905,292,18,28,46,
8906,300,20,16,36,
8907,321,16,17,33,
8908,325,24,12,36,
8909,261,14,19,33,
8910,303,20,13,33,
8911,313,20,19,39,
8912,269,27,16,43,
8913,314,18,19,37,
8914,281,24,13,37,
8915,298,18,14,32,
8916,276,21,17,38,
8917,322,28,20,48,
8918,281,20,13,33,
8919,298,23,20,43,
8920,308,23,21,44,
8921,301,28,26,54,
8922,299,25,23,48,
8923,289,18,14,32,
8924,286,14,15,29,
8925,288,18,14,32,
8926,339,22,22,44,
8927,283,20,16,36,
8928,307,22,18,40,
8929,313,23,15,38,
8930,295,22,16,38,
8931,273,23,17,40,
8932,261,22,11,33,
8933,297,14,17,31,
8934,295,20,16,36,
8935,307,22,18,40,
8936,283,23,11,34,
8937,274,16,14,30,
8938,312,27,15,42,
8939,308,18,33,51,
8940,284,15,22,37,
8941,301,26,13,39,
8942,291,21,16,37,
8943,254,16,28,44,
8944,303,19,17,36,
8945,286,18,17,35,
8946,278,15,14,29,
8947,301,18,19,37,
8948,295,26,13,39,
8949,302,28,11,39,
8950,285,21,12,33,
8951,305,16,22,38,
8952,307,23,20,43,
8953,311,19,16,35,
8954,319,21,11,32,
8955,328,18,17,35,
8956,323,22,21,43,
8957,303,12,17,29,
8958,331,23,17,40,
8959,283,20,14,34,
8960,309,25,25,50,
8961,288,26,17,43,
8962,283,21,22,43,
8963,305,29,19,48,
8964,318,16,17,33,
8965,286,23,15,38,
8966,301,19,22,41,
8967,300,25,13,38,
8968,298,22,20,42,
8969,293,20,13,33,
8970,315,23,12,35,
8971,291,21,14,35,
8972,293,19,26,45,
8973,275,22,10,32,
8974,276,14,9,23,
8975,287,22,12,34,
8976,321,21,24,45,
8977,312,17,22,39,
8978,287,22,21,43,
8979,285,18,13,31,
8980,282,21,20,41,
8981,325,19,17,36,
8982,299,27,18,45,
8983,301,21,13,34,
8984,277,20,15,35,
8985,326,26,12,38,
8986,280,16,16,32,
8987,290,18,7,25,
8988,284,23,15,38,
8989,280,21,20,41,
8990,303,15,16,31,
8991,310,18,15,33,
8992,316,19,23,42,
8993,300,21,20,41,
8994,300,19,20,39,
8995,305,15,13,28,
8996,274,19,17,36,
8997,307,16,13,29,
8998,320,21,23,44,
8999,306,19,21,40,
9000,310,21,22,43,
9001,314,27,24,51,
9002,309,24,16,40,
9003,312,30,13,43,
9004,319,25,19,44,
9005,312,27,19,46,
9006,300,23,15,38,
9007,303,16,21,37,
9008,313,21,15,36,
9009,298,28,13,41,
9010,287,21,15,36,
9011,285,28,14,42,
9012,300,18,21,39,
9013,303,30,11,41,
9014,280,20,13,33,
9015,284,27,20,47,
9016,270,13,17,30,
9017,276,17,18,35,
9018,294,17,10,27,
9019,290,19,23,42,
9020,294,31,15,46,
9021,300,24,18,42,
9022,300,17,21,38,
9023,304,19,20,39,
9024,302,15,20,35,
9025,298,20,17,37,
9026,318,27,15,42,
9027,299,23,20,43,
9028,307,27,24,51,
9029,324,16,21,37,
9030,302,19,11,30,
9031,288,30,16,46,
9032,297,16,12,28,
9033,312,18,19,37,
9034,303,21,9,30,
9035,287,16,16,32,
9036,291,22,13,35,
9037,287,27,19,46,
9038,341,25,25,50,
9039,284,22,14,36,
9040,303,20,21,41,
9041,279,22,18,40,
9042,283,15,16,31,
9043,286,20,16,36,
9044,316,19,25,44,
9045,328,25,28,53,
9046,296,24,20,44,
9047,325,20,28,48,
9048,320,21,24,45,
9049,278,18,17,35,
9050,284,17,12,29,
9051,342,17,22,39,
9052,312,16,22,38,
9053,319,27,20,47,
9054,303,26,15,41,
9055,306,25,20,45,
9056,327,16,24,40,
9057,299,20,18,38,
9058,292,23,12,35,
9059,286,29,14,43,
9060,320,22,25,47,
9061,264,21,7,28,
9062,304,21,22,43,
9063,308,30,19,49,
9064,305,23,17,40,
9065,291,21,14,35,
9066,298,23,16,39,
9067,303,26,15,41,
9068,301,27,15,42,
9069,297,18,13,31,
9070,287,24,22,46,
9071,282,18,9,27,
9072,304,24,17,41,
9073,309,21,19,40,
9074,319,22,19,41,
9075,305,24,12,36,
9076,286,31,11,42,
9077,303,26,17,43,
9078,294,20,23,43,
9079,303,24,19,43,
9080,279,18,6,24,
9081,298,29,13,42,
9082,306,19,15,34,
9083,327,38,20,58,
9084,315,27,19,46,
9085,293,17,17,34,
9086,304,21,18,39,
9087,305,32,27,59,
9088,269,29,12,41,
9089,300,20,20,40,
9090,301,24,22,46,
9091,301,26,16,42,
9092,326,20,15,35,
9093,302,32,19,51,
9094,306,26,17,43,
9095,281,20,11,31,
9096,296,23,17,40,
9097,308,18,20,38,
9098,310,26,20,46,
9099,281,28,16,44,
9100,293,13,15,28,
9101,314,17,24,41,
9102,300,10,20,30,
9103,278,24,24,48,
9104,269,21,14,35,
9105,288,21,16,37,
9106,270,19,21,40,
9107,292,22,13,35,
9108,291,21,19,40,
9109,293,15,20,35,
9110,328,24,26,50,
9111,332,21,23,44,
9112,303,20,11,31,
9113,311,23,19,42,
9114,313,19,19,38,
9115,282,24,6,30,
9116,303,22,20,42,
9117,332,19,21,40,
9118,308,16,15,31,
9119,275,16,16,32,
9120,311,21,13,34,
9121,292,23,19,42,
9122,307,19,17,36,
9123,312,18,22,40,
9124,294,23,12,35,
9125,311,24,15,39,
9126,303,23,18,41,
9127,300,22,18,40,
9128,310,29,16,45,
9129,282,16,17,33,
9130,321,25,19,44,
9131,304,28,16,44,
9132,307,16,14,30,
9133,309,21,17,38,
9134,295,18,19,37,
9135,322,16,17,33,
9136,284,26,15,41,
9137,299,28,21,49,
9138,309,20,24,44,
9139,283,27,22,49,
9140,303,25,24,49,
9141,281,15,25,40,
9142,317,15,16,31,
9143,307,16,22,38,
9144,304,24,21,45,
9145,312,20,20,40,
9146,276,14,18,32,
9147,309,21,14,35,
9148,300,18,16,34,
9149,289,18,17,35,
9150,289,19,14,33,
9151,307,25,18,43,
9152,267,22,18,40,
9153,286,20,14,34,
9154,316,21,27,48,
9155,294,20,19,39,
9156,297,22,15,37,
9157,309,21,14,35,
9158,306,22,27,49,
9159,323,24,17,41,
9160,321,24,18,42,
9161,320,29,24,53,
9162,345,19,22,41,
9163,304,31,14,45,
9164,292,12,15,27,
9165,295,31,10,41,
9166,303,20,14,34,
9167,315,21,18,39,
9168,272,22,17,39,
9169,300,23,20,43,
9170,299,24,18,42,
9171,298,23,25,48,
9172,294,23,28,51,
9173,289,15,10,25,
9174,301,12,22,34,
9175,319,15,13,28,
9176,319,26,17,43,
9177,281,19,15,34,
9178,360,38,29,67,
9179,284,25,18,43,
9180,289,24,16,40,
9181,303,29,18,47,
9182,278,20,17,37,
9183,270,16,22,38,
9184,272,20,16,36,
9185,319,21,17,38,
9186,318,15,16,31,
9187,327,23,18,41,
9188,288,13,19,32,
9189,305,13,10,23,
9190,303,18,13,31,
9191,282,21,13,34,
9192,315,29,16,45,
9193,304,15,13,28,
9194,307,15,10,25,
9195,291,17,15,32,
9196,283,21,14,35,
9197,310,17,15,32,
9198,293,17,18,35,
9199,284,21,13,34,
9200,304,19,16,35,
9201,279,23,23,46,
9202,279,26,17,43,
9203,335,27,18,45,
9204,298,21,24,45,
9205,277,22,16,38,
9206,281,22,23,45,
9207,279,26,11,37,
9208,293,25,13,38,
9209,297,18,22,40,
9210,273,25,20,45,
9211,291,20,17,37,
9212,292,17,20,37,
9213,276,19,15,34,
9214,331,20,15,35,
9215,299,24,14,38,
9216,270,36,15,51,
9217,274,19,8,27,
9218,311,25,19,44,
9219,290,23,17,40,
9220,300,16,19,35,
9221,262,18,21,39,
9222,302,25,13,38,
9223,288,20,21,41,
9224,303,25,17,42,
9225,301,28,22,50,
9226,304,23,20,43,
9227,259,21,21,42,
9228,270,17,14,31,
9229,274,17,18,35,
9230,292,18,15,33,
9231,281,22,20,42,
9232,295,19,11,30,
9233,289,21,17,38,
9234,289,16,17,33,
9235,278,16,17,33,
9236,335,21,17,38,
9237,310,26,8,34,
9238,307,11,20,31,
9239,280,15,20,35,
9240,294,19,22,41,
9241,295,23,13,36,
9242,297,28,17,45,
9243,301,15,15,30,
9244,292,27,17,44,
9245,297,22,10,32,
9246,297,28,13,41,
9247,332,17,16,33,
9248,281,22,18,40,
9249,329,26,20,46,
9250,330,24,17,41,
9251,293,23,13,36,
9252,288,25,20,45,
9253,309,24,15,39,
9254,261,23,10,33,
9255,285,17,20,37,
9256,282,20,11,31,
9257,289,15,14,29,
9258,293,22,15,37,
9259,264,20,19,39,
9260,326,25,15,40,
9261,300,24,16,40,
9262,295,20,14,34,
9263,295,18,19,37,
9264,300,25,24,49,
9265,333,19,19,38,
9266,368,27,24,51,
9267,302,17,11,28,
9268,310,25,20,45,
9269,288,22,14,36,
9270,267,16,12,28,
9271,285,18,18,36,
9272,294,10,15,25,
9273,319,22,27,49,
9274,288,19,15,34,
9275,307,14,17,31,
9276,293,24,21,45,
9277,307,28,19,47,
9278,319,33,19,52,
9279,298,20,22,42,
9280,314,23,11,34,
9281,323,17,18,35,
9282,301,24,14,38,
9283,285,20,21,41,
9284,319,22,26,48,
9285,299,24,15,39,
9286,293,16,21,37,
9287,327,25,15,40,
9288,264,16,17,33,
9289,300,25,18,43,
9290,287,20,15,35,
9291,310,25,19,44,
9292,314,23,17,40,
9293,305,26,22,48,
9294,343,24,14,38,
9295,251,15,20,35,
9296,287,16,17,33,
9297,271,13,18,31,
9298,307,17,26,43,
9299,310,22,18,40,
9300,316,27,17,44,
9301,303,28,24,52,
9302,290,25,17,42,
9303,305,18,16,34,
9304,295,22,17,39,
9305,304,29,20,49,
9306,285,17,24,41,
9307,291,18,19,37,
9308,340,23,20,43,
9309,329,24,19,43,
9310,306,21,19,40,
9311,271,17,15,32,
9312,296,22,19,41,
9313,292,23,12,35,
9314,269,18,14,32,
9315,324,29,14,43,
9316,291,16,13,29,
9317,294,21,23,44,
9318,306,20,11,31,
9319,288,21,21,42,
9320,290,31,10,41,
9321,261,16,15,31,
9322,279,14,15,29,
9323,301,24,12,36,
9324,310,22,18,40,
9325,274,18,17,35,
9326,294,23,13,36,
9327,280,31,13,44,
9328,298,25,15,40,
9329,267,23,16,39,
9330,293,18,11,29,
9331,292,21,18,39,
9332,313,15,19,34,
9333,300,26,23,49,
9334,296,25,18,43,
9335,268,20,16,36,
9336,316,31,16,47,
9337,285,22,16,38,
9338,319,30,20,50,
9339,296,12,20,32,
9340,278,29,13,42,
9341,302,23,26,49,
9342,325,24,16,40,
9343,321,25,24,49,
9344,307,23,20,43,
9345,265,18,14,32,
9346,284,20,14,34,
9347,305,27,23,50,
9348,323,23,22,45,
9349,269,21,23,44,
9350,315,19,18,37,
9351,300,25,11,36,
9352,308,19,11,30,
9353,315,23,18,41,
9354,273,15,21,36,
9355,319,21,18,39,
9356,289,16,18,34,
9357,298,16,19,35,
9358,261,13,16,29,
9359,319,18,20,38,
9360,302,21,17,38,
9361,277,16,19,35,
9362,300,24,13,37,
9363,292,23,14,37,
9364,297,24,16,40,
9365,311,18,16,34,
9366,320,27,18,45,
9367,297,18,15,33,
9368,285,17,13,30,
9369,290,25,19,44,
9370,277,24,11,35,
9371,281,14,20,34,
9372,279,31,21,52,
9373,352,24,24,48,
9374,280,15,14,29,
9375,306,32,10,42,
9376,297,21,20,41,
9377,298,25,14,39,
9378,298,19,15,34,
9379,314,27,23,50,
9380,295,22,21,43,
9381,304,22,18,40,
9382,321,23,19,42,
9383,304,28,14,42,
9384,279,22,13,35,
9385,288,23,20,43,
9386,308,26,13,39,
9387,311,20,16,36,
9388,292,18,19,37,
9389,325,27,15,42,
9390,324,26,18,44,
9391,300,21,18,39,
9392,303,28,17,45,
9393,327,15,24,39,
9394,274,25,12,37,
9395,282,28,17,45,
9396,308,22,14,36,
9397,325,18,19,37,
9398,297,22,17,39,
9399,297,19,23,42,
9400,289,22,16,38,
9401,288,27,17,44,
9402,287,20,8,28,
9403,308,24,21,45,
9404,312,15,22,37,
9405,311,14,20,34,
9406,287,18,17,35,
9407,308,15,29,44,
9408,311,22,19,41,
9409,271,18,16,34,
9410,313,26,15,41,
9411,297,22,19,41,
9412,296,10,27,37,
9413,304,13,15,28,
9414,316,25,12,37,
9415,288,27,19,46,
9416,298,16,14,30,
9417,310,21,26,47,
9418,297,17,14,31,
9419,307,20,14,34,
9420,288,20,18,38,
9421,283,30,19,49,
9422,319,19,15,34,
9423,295,23,21,44,
9424,323,32,10,42,
9425,323,19,16,35,
9426,306,27,26,53,
9427,309,15,15,30,
9428,297,19,17,36,
9429,282,21,22,43,
9430,310,23,15,38,
9431,322,20,17,37,
9432,302,22,19,41,
9433,293,21,19,40,
9434,284,28,15,43,
9435,270,17,16,33,
9436,296,19,34,53,
9437,285,24,17,41,
9438,326,26,17,43,
9439,308,26,14,40,
9440,293,24,24,48,
9441,287,19,18,37,
9442,313,30,17,47,
9443,287,22,11,33,
9444,284,17,22,39,
9445,311,30,14,44,
9446,299,18,17,35,
9447,293,28,21,49,
9448,299,26,16,42,
9449,251,18,10,28,
9450,310,28,19,47,
9451,285,16,23,39,
9452,310,21,22,43,
9453,299,26,18,44,
9454,317,25,16,41,
9455,302,19,7,26,
9456,289,24,26,50,
9457,314,27,20,47,
9458,299,23,13,36,
9459,295,19,13,32,
9460,267,18,12,30,
9461,296,19,17,36,
9462,314,31,18,49,
9463,257,17,15,32,
9464,321,27,21,48,
9465,283,26,13,39,
9466,317,26,12,38,
9467,298,21,12,33,
9468,288,16,23,39,
9469,284,14,15,29,
9470,280,20,7,27,
9471,293,17,15,32,
9472,299,24,16,40,
9473,293,28,13,41,
9474,270,13,15,28,
9475,284,14,17,31,
9476,321,23,26,49,
9477,298,23,16,39,
9478,305,21,17,38,
9479,285,16,17,33,
9480,323,21,24,45,
9481,306,24,17,41,
9482,293,20,16,36,
9483,296,17,20,37,
9484,295,19,18,37,
9485,280,22,10,32,
9486,295,21,14,35,
9487,266,20,24,44,
9488,305,20,15,35,
9489,282,19,21,40,
9490,286,15,16,31,
9491,301,22,19,41,
9492,297,27,21,48,
9493,306,24,18,42,
9494,303,19,14,33,
9495,305,20,15,35,
9496,316,32,12,44,
9497,311,21,16,37,
9498,307,24,16,40,
9499,288,32,14,46,
9500,295,21,18,39,
9501,306,20,19,39,
9502,289,21,19,40,
9503,330,28,23,51,
9504,317,20,21,41,
9505,269,17,20,37,
9506,275,14,15,29,
9507,297,20,20,40,
9508,336,29,17,46,
9509,275,15,11,26,
9510,288,15,14,29,
9511,310,28,16,44,
9512,309,21,18,39,
9513,271,15,10,25,
9514,315,20,20,40,
9515,292,22,14,36,
9516,311,15,15,30,
9517,275,10,15,25,
9518,330,24,16,40,
9519,291,28,19,47,
9520,294,18,20,38,
9521,269,17,15,32,
9522,288,23,18,41,
9523,313,27,17,44,
9524,306,20,11,31,
9525,285,18,18,36,
9526,305,24,19,43,
9527,264,15,11,26,
9528,288,23,14,37,
9529,311,14,22,36,
9530,267,18,12,30,
9531,305,13,21,34,
9532,303,27,24,51,
9533,313,26,14,40,
9534,277,17,21,38,
9535,288,14,21,35,
9536,297,21,16,37,
9537,288,26,17,43,
9538,303,29,26,55,
9539,281,20,14,34,
9540,287,18,14,32,
9541,321,26,11,37,
9542,301,25,17,42,
9543,320,19,23,42,
9544,329,28,7,35,
9545,300,15,14,29,
9546,291,27,13,40,
9547,278,14,11,25,
9548,305,27,18,45,
9549,315,23,17,40,
9550,310,25,15,40,
9551,299,19,16,35,
9552,309,23,17,40,
9553,302,26,21,47,
9554,272,12,21,33,
9555,247,11,15,26,
9556,309,28,22,50,
9557,312,23,17,40,
9558,301,19,13,32,
9559,287,21,13,34,
9560,288,24,15,39,
9561,295,18,13,31,
9562,286,28,14,42,
9563,296,19,13,32,
9564,315,24,19,43,
9565,309,12,26,38,
9566,285,23,17,40,
9567,312,19,14,33,
9568,288,14,15,29,
9569,301,25,15,40,
9570,301,30,15,45,
9571,285,18,19,37,
9572,322,17,15,32,
9573,312,28,17,45,
9574,305,15,21,36,
9575,302,22,20,42,
9576,321,23,16,39,
9577,275,16,15,31,
9578,280,19,18,37,
9579,270,24,14,38,
9580,286,21,20,41,
9581,296,18,28,46,
9582,289,22,16,38,
9583,272,26,23,49,
9584,314,24,13,37,
9585,319,21,17,38,
9586,299,33,20,53,
9587,299,23,18,41,
9588,282,22,19,41,
9589,295,21,15,36,
9590,286,22,12,34,
9591,329,20,23,43,
9592,286,15,12,27,
9593,280,21,22,43,
9594,337,34,28,62,
9595,306,21,18,39,
9596,296,24,16,40,
9597,291,18,22,40,
9598,279,27,16,43,
9599,282,19,16,35,
9600,261,19,19,38,
9601,322,19,26,45,
9602,296,22,12,34,
9603,311,19,34,53,
9604,309,13,22,35,
9605,279,23,21,44,
9606,266,17,22,39,
9607,295,26,12,38,
9608,269,16,16,32,
9609,291,11,14,25,
9610,275,18,15,33,
9611,295,21,14,35,
9612,293,25,14,39,
9613,299,31,9,40,
9614,315,19,19,38,
9615,286,22,16,38,
9616,303,15,18,33,
9617,312,20,14,34,
9618,297,31,23,54,
9619,333,22,18,40,
9620,332,23,27,50,
9621,265,19,18,37,
9622,318,22,19,41,
9623,309,19,19,38,
9624,311,26,10,36,
9625,297,17,16,33,
9626,279,19,18,37,
9627,297,24,15,39,
9628,294,15,17,32,
9629,298,22,14,36,
9630,308,19,12,31,
9631,291,19,15,34,
9632,336,37,21,58,
9633,275,23,17,40,
9634,316,25,16,41,
9635,320,31,15,46,
9636,275,14,20,34,
9637,301,28,22,50,
9638,313,18,18,36,
9639,322,24,20,44,
9640,285,25,15,40,
9641,276,21,15,36,
9642,283,21,15,36,
9643,252,19,14,33,
9644,295,26,16,42,
9645,276,24,20,44,
9646,280,27,12,39,
9647,312,31,22,53,
9648,309,28,17,45,
9649,289,25,16,41,
9650,321,24,20,44,
9651,294,33,21,54,
9652,284,14,15,29,
9653,284,25,17,42,
9654,290,21,7,28,
9655,288,20,21,41,
9656,293,22,22,44,
9657,333,26,23,49,
9658,348,34,22,56,
9659,307,14,23,37,
9660,312,19,16,35,
9661,294,20,15,35,
9662,261,20,13,33,
9663,297,18,19,37,
9664,267,18,12,30,
9665,282,24,14,38,
9666,290,16,21,37,
9667,269,17,12,29,
9668,303,20,15,35,
9669,320,24,27,51,
9670,329,24,25,49,
9671,329,24,18,42,
9672,287,25,24,49,
9673,314,23,18,41,
9674,292,12,19,31,
9675,338,31,25,56,
9676,282,27,18,45,
9677,304,24,19,43,
9678,313,18,17,35,
9679,319,23,15,38,
9680,267,13,14,27,
9681,292,13,17,30,
9682,267,21,9,30,
9683,309,18,22,40,
9684,288,20,13,33,
9685,264,17,15,32,
9686,280,15,18,33,
9687,254,18,17,35,
9688,290,22,15,37,
9689,286,22,13,35,
9690,265,18,14,32,
9691,273,20,18,38,
9692,320,27,23,50,
9693,269,20,18,38,
9694,289,17,16,33,
9695,319,19,18,37,
9696,294,21,22,43,
9697,311,14,20,34,
9698,303,19,22,41,
9699,318,31,17,48,
9700,300,18,19,37,
9701,305,14,15,29,
9702,280,16,14,30,
9703,305,25,23,48,
9704,293,23,22,45,
9705,325,28,19,47,
9706,306,24,17,41,
9707,309,18,22,40,
9708,254,16,20,36,
9709,332,25,21,46,
9710,310,29,27,56,
9711,287,25,15,40,
9712,308,17,19,36,
9713,325,26,26,52,
9714,298,19,9,28,
9715,310,27,18,45,
9716,274,27,14,41,
9717,278,27,20,47,
9718,314,25,17,42,
9719,287,17,14,31,
9720,294,24,17,41,
9721,276,26,17,43,
9722,287,14,21,35,
9723,335,27,16,43,
9724,291,11,17,28,
9725,281,20,21,41,
9726,264,20,10,30,
9727,323,17,17,34,
9728,301,19,21,40,
9729,294,12,17,29,
9730,310,26,11,37,
9731,329,31,29,60,
9732,290,14,21,35,
9733,317,23,20,43,
9734,315,22,22,44,
9735,311,22,11,33,
9736,299,19,14,33,
9737,293,22,14,36,
9738,321,27,20,47,
9739,331,23,24,47,
9740,309,20,19,39,
9741,304,25,16,41,
9742,302,22,16,38,
9743,286,25,9,34,
9744,322,19,25,44,
9745,317,16,21,37,
9746,263,25,18,43,
9747,301,27,16,43,
9748,295,14,18,32,
9749,266,18,15,33,
9750,294,16,16,32,
9751,265,15,21,36,
9752,291,25,13,38,
9753,298,18,15,33,
9754,291,25,12,37,
9755,314,15,19,34,
9756,311,26,18,44,
9757,292,24,20,44,
9758,288,29,17,46,
9759,259,16,15,31,
9760,298,26,17,43,
9761,318,18,23,41,
9762,330,31,16,47,
9763,296,20,8,28,
9764,301,26,9,35,
9765,296,17,10,27,
9766,307,20,15,35,
9767,292,24,17,41,
9768,301,26,14,40,
9769,299,18,9,27,
9770,320,25,20,45,
9771,268,15,17,32,
9772,327,19,15,34,
9773,293,23,10,33,
9774,264,17,22,39,
9775,287,19,21,40,
9776,305,26,13,39,
9777,265,12,23,35,
9778,302,18,26,44,
9779,296,26,14,40,
9780,334,21,13,34,
9781,313,29,21,50,
9782,282,18,17,35,
9783,307,27,20,47,
9784,332,26,16,42,
9785,286,24,19,43,
9786,281,21,12,33,
9787,322,24,17,41,
9788,294,17,15,32,
9789,301,26,17,43,
9790,325,25,19,44,
9791,305,20,15,35,
9792,291,17,21,38,
9793,291,23,16,39,
9794,312,20,15,35,
9795,284,25,19,44,
9796,288,27,17,44,
9797,285,17,15,32,
9798,306,19,16,35,
9799,314,19,16,35,
9800,320,19,16,35,
9801,285,23,12,35,
9802,295,27,22,49,
9803,313,25,19,44,
9804,301,21,16,37,
9805,296,26,13,39,
9806,300,18,16,34,
9807,353,26,25,51,
9808,305,18,17,35,
9809,294,14,16,30,
9810,297,24,15,39,
9811,297,19,19,38,
9812,285,24,11,35,
9813,295,23,20,43,
9814,336,28,23,51,
9815,293,21,19,40,
9816,293,24,15,39,
9817,291,23,21,44,
9818,290,21,17,38,
9819,317,20,18,38,
9820,286,18,15,33,
9821,268,25,17,42,
9822,317,23,12,35,
9823,291,29,16,45,
9824,290,22,11,33,
9825,313,22,25,47,
9826,310,28,22,50,
9827,302,15,23,38,
9828,322,28,23,51,
9829,298,20,18,38,
9830,309,24,21,45,
9831,319,16,26,42,
9832,321,23,19,42,
9833,292,16,16,32,
9834,343,30,25,55,
9835,303,19,24,43,
9836,300,18,16,34,
9837,304,22,22,44,
9838,273,21,12,33,
9839,308,16,24,40,
9840,304,22,8,30,
9841,260,18,13,31,
9842,282,21,21,42,
9843,318,21,16,37,
9844,320,24,15,39,
9845,287,18,24,42,
9846,328,25,22,47,
9847,293,26,11,37,
9848,300,28,11,39,
9849,288,23,18,41,
9850,311,21,11,32,
9851,292,12,22,34,
9852,314,28,17,45,
9853,278,21,13,34,
9854,295,21,17,38,
9855,272,20,19,39,
9856,318,15,29,44,
9857,312,31,18,49,
9858,333,29,21,50,
9859,280,32,21,53,
9860,301,17,20,37,
9861,287,28,10,38,
9862,297,24,11,35,
9863,314,29,11,40,
9864,318,25,14,39,
9865,315,24,19,43,
9866,277,26,12,38,
9867,280,17,11,28,
9868,276,12,14,26,
9869,356,23,28,51,
9870,316,29,18,47,
9871,304,18,13,31,
9872,313,25,28,53,
9873,286,18,18,36,
9874,275,19,17,36,
9875,282,22,16,38,
9876,368,31,20,51,
9877,289,13,17,30,
9878,240,18,9,27,
9879,254,17,14,31,
9880,268,22,18,40,
9881,286,18,20,38,
9882,301,18,14,32,
9883,313,22,15,37,
9884,322,11,20,31,
9885,289,21,19,40,
9886,335,24,21,45,
9887,323,29,19,48,
9888,277,10,21,31,
9889,311,20,21,41,
9890,296,25,18,43,
9891,285,21,14,35,
9892,287,25,14,39,
9893,302,24,12,36,
9894,308,20,19,39,
9895,280,20,15,35,
9896,287,21,19,40,
9897,310,19,23,42,
9898,311,14,14,28,
9899,300,24,14,38,
9900,299,25,22,47,
9901,263,18,15,33,
9902,284,18,10,28,
9903,276,25,10,35,
9904,281,21,15,36,
9905,314,15,14,29,
9906,316,16,14,30,
9907,332,21,19,40,
9908,283,24,15,39,
9909,292,25,27,52,
9910,286,28,13,41,
9911,291,17,13,30,
9912,294,16,13,29,
9913,287,18,12,30,
9914,300,23,19,42,
9915,334,29,26,55,
9916,310,23,17,40,
9917,326,17,20,37,
9918,313,21,17,38,
9919,278,17,18,35,
9920,298,17,13,30,
9921,292,27,18,45,
9922,269,20,17,37,
9923,315,28,12,40,
9924,291,17,23,40,
9925,295,17,17,34,
9926,281,22,16,38,
9927,319,28,25,53,
9928,298,26,21,47,
9929,309,27,16,43,
9930,293,25,15,40,
9931,320,12,18,30,
9932,260,22,16,38,
9933,322,21,18,39,
9934,289,22,14,36,
9935,295,21,14,35,
9936,306,18,13,31,
9937,291,15,18,33,
9938,272,17,16,33,
9939,306,17,21,38,
9940,265,18,9,27,
9941,305,24,17,41,
9942,311,21,22,43,
9943,273,15,16,31,
9944,308,27,7,34,
9945,300,32,19,51,
9946,292,32,9,41,
9947,288,19,14,33,
9948,281,13,19,32,
9949,326,34,10,44,
9950,273,21,15,36,
9951,272,25,15,40,
9952,273,16,17,33,
9953,284,18,16,34,
9954,285,26,16,42,
9955,285,16,20,36,
9956,305,19,11,30,
9957,305,21,20,41,
9958,298,23,22,45,
9959,327,27,12,39,
9960,265,18,22,40,
9961,275,23,14,37,
9962,307,15,20,35,
9963,290,24,14,38,
9964,286,25,14,39,
9965,278,23,13,36,
9966,273,22,16,38,
9967,316,19,10,29,
9968,302,19,22,41,
9969,310,26,14,40,
9970,316,22,18,40,
9971,299,25,21,46,
9972,318,32,19,51,
9973,291,18,13,31,
9974,314,29,20,49,
9975,271,23,17,40,
9976,312,20,16,36,
9977,320,23,18,41,
9978,290,25,15,40,
9979,266,18,16,34,
9980,320,23,18,41,
9981,321,25,22,47,
9982,274,17,15,32,
9983,288,23,23,46,
9984,299,23,16,39,
9985,274,26,8,34,
9986,304,14,23,37,
9987,310,19,19,38,
9988,303,35,16,51,
9989,297,22,11,33,
9990,295,22,15,37,
9991,302,20,17,37,
9992,281,22,12,34,
9993,293,20,18,38,
9994,297,22,22,44,
9995,300,13,19,32,
9996,290,21,20,41,
9997,274,21,9,30,
9998,279,25,11,36,
9999,274,20,16,36,
